season_id,team_id_home,team_abbreviation_home,team_name_home,game_id,game_date,matchup_home,pts_home,plus_minus_home,team_id_away,team_abbreviation_away,team_name_away,matchup_away,pts_away,plus_minus_away,season_type
22017,1610612750,MIN,Minnesota Timberwolves,0021700548,2018-01-01T00:00:00Z,MIN vs. LAL,114,18,1610612747,LAL,Los Angeles Lakers,LAL @ MIN,96,-18,Regular Season
22017,1610612741,CHI,Chicago Bulls,0021700547,2018-01-01T00:00:00Z,CHI vs. POR,120,-4,1610612757,POR,Portland Trail Blazers,POR @ CHI,124,4,Regular Season
22017,1610612761,TOR,Toronto Raptors,0021700546,2018-01-01T00:00:00Z,TOR vs. MIL,131,4,1610612749,MIL,Milwaukee Bucks,MIL @ TOR,127,-4,Regular Season
22017,1610612751,BKN,Brooklyn Nets,0021700545,2018-01-01T00:00:00Z,BKN vs. ORL,98,3,1610612753,ORL,Orlando Magic,ORL @ BKN,95,-3,Regular Season
22017,1610612752,NYK,New York Knicks,0021700550,2018-01-02T00:00:00Z,NYK vs. SAS,91,-9,1610612759,SAS,San Antonio Spurs,SAS @ NYK,100,9,Regular Season
22017,1610612758,SAC,Sacramento Kings,0021700552,2018-01-02T00:00:00Z,SAC vs. CHA,111,-20,1610612766,CHA,Charlotte Hornets,CHA @ SAC,131,20,Regular Season
22017,1610612746,LAC,LA Clippers,0021700553,2018-01-02T00:00:00Z,LAC vs. MEM,113,8,1610612763,MEM,Memphis Grizzlies,MEM @ LAC,105,-8,Regular Season
22017,1610612756,PHX,Phoenix Suns,0021700551,2018-01-02T00:00:00Z,PHX vs. ATL,104,1,1610612737,ATL,Atlanta Hawks,ATL @ PHX,103,-1,Regular Season
22017,1610612739,CLE,Cleveland Cavaliers,0021700549,2018-01-02T00:00:00Z,CLE vs. POR,127,17,1610612757,POR,Portland Trail Blazers,POR @ CLE,110,-17,Regular Season
22017,1610612738,BOS,Boston Celtics,0021700559,2018-01-03T00:00:00Z,BOS vs. CLE,102,14,1610612739,CLE,Cleveland Cavaliers,CLE @ BOS,88,-14,Regular Season
22017,1610612751,BKN,Brooklyn Nets,0021700557,2018-01-03T00:00:00Z,BKN vs. MIN,98,1,1610612750,MIN,Minnesota Timberwolves,MIN @ BKN,97,-1,Regular Season
22017,1610612742,DAL,Dallas Mavericks,0021700562,2018-01-03T00:00:00Z,DAL vs. GSW,122,-3,1610612744,GSW,Golden State Warriors,GSW @ DAL,125,3,Regular Season
22017,1610612741,CHI,Chicago Bulls,0021700560,2018-01-03T00:00:00Z,CHI vs. TOR,115,-9,1610612761,TOR,Toronto Raptors,TOR @ CHI,124,9,Regular Season
22017,1610612762,UTA,Utah Jazz,0021700564,2018-01-03T00:00:00Z,UTA vs. NOP,98,-10,1610612740,NOP,New Orleans Pelicans,NOP @ UTA,108,10,Regular Season
22017,1610612764,WAS,Washington Wizards,0021700556,2018-01-03T00:00:00Z,WAS vs. NYK,121,18,1610612752,NYK,New York Knicks,NYK @ WAS,103,-18,Regular Season
22017,1610612743,DEN,Denver Nuggets,0021700563,2018-01-03T00:00:00Z,DEN vs. PHX,134,23,1610612756,PHX,Phoenix Suns,PHX @ DEN,111,-23,Regular Season
22017,1610612755,PHI,Philadelphia 76ers,0021700555,2018-01-03T00:00:00Z,PHI vs. SAS,112,6,1610612759,SAS,San Antonio Spurs,SAS @ PHI,106,-6,Regular Season
22017,1610612753,ORL,Orlando Magic,0021700554,2018-01-03T00:00:00Z,ORL vs. HOU,98,-18,1610612745,HOU,Houston Rockets,HOU @ ORL,116,18,Regular Season
22017,1610612747,LAL,Los Angeles Lakers,0021700565,2018-01-03T00:00:00Z,LAL vs. OKC,96,-37,1610612760,OKC,Oklahoma City Thunder,OKC @ LAL,133,37,Regular Season
22017,1610612749,MIL,Milwaukee Bucks,0021700561,2018-01-03T00:00:00Z,MIL vs. IND,122,21,1610612754,IND,Indiana Pacers,IND @ MIL,101,-21,Regular Season
22017,1610612748,MIA,Miami Heat,0021700558,2018-01-03T00:00:00Z,MIA vs. DET,111,7,1610612765,DET,Detroit Pistons,DET @ MIA,104,-7,Regular Season
22017,1610612746,LAC,LA Clippers,0021700567,2018-01-04T00:00:00Z,LAC vs. OKC,117,-10,1610612760,OKC,Oklahoma City Thunder,OKC @ LAC,127,10,Regular Season
22017,1610612745,HOU,Houston Rockets,0021700566,2018-01-04T00:00:00Z,HOU vs. GSW,114,-10,1610612744,GSW,Golden State Warriors,GSW @ HOU,124,10,Regular Season
22017,1610612755,PHI,Philadelphia 76ers,0021700569,2018-01-05T00:00:00Z,PHI vs. DET,114,36,1610612765,DET,Detroit Pistons,DET @ PHI,78,-36,Regular Season
22017,1610612742,DAL,Dallas Mavericks,0021700572,2018-01-05T00:00:00Z,DAL vs. CHI,124,-3,1610612741,CHI,Chicago Bulls,CHI @ DAL,127,3,Regular Season
22017,1610612749,MIL,Milwaukee Bucks,0021700571,2018-01-05T00:00:00Z,MIL vs. TOR,110,-19,1610612761,TOR,Toronto Raptors,TOR @ MIL,129,19,Regular Season
22017,1610612757,POR,Portland Trail Blazers,0021700576,2018-01-05T00:00:00Z,POR vs. ATL,110,21,1610612737,ATL,Atlanta Hawks,ATL @ POR,89,-21,Regular Season
22017,1610612747,LAL,Los Angeles Lakers,0021700577,2018-01-05T00:00:00Z,LAL vs. CHA,94,-14,1610612766,CHA,Charlotte Hornets,CHA @ LAL,108,14,Regular Season
22017,1610612748,MIA,Miami Heat,0021700568,2018-01-05T00:00:00Z,MIA vs. NYK,107,4,1610612752,NYK,New York Knicks,NYK @ MIA,103,-4,Regular Season
22017,1610612763,MEM,Memphis Grizzlies,0021700575,2018-01-05T00:00:00Z,MEM vs. WAS,100,-2,1610612764,WAS,Washington Wizards,WAS @ MEM,102,2,Regular Season
22017,1610612743,DEN,Denver Nuggets,0021700574,2018-01-05T00:00:00Z,DEN vs. UTA,99,8,1610612762,UTA,Utah Jazz,UTA @ DEN,91,-8,Regular Season
22017,1610612738,BOS,Boston Celtics,0021700570,2018-01-05T00:00:00Z,BOS vs. MIN,91,7,1610612750,MIN,Minnesota Timberwolves,MIN @ BOS,84,-7,Regular Season
22017,1610612759,SAS,San Antonio Spurs,0021700573,2018-01-05T00:00:00Z,SAS vs. PHX,103,14,1610612756,PHX,Phoenix Suns,PHX @ SAS,89,-14,Regular Season
22017,1610612751,BKN,Brooklyn Nets,0021700579,2018-01-06T00:00:00Z,BKN vs. BOS,85,-2,1610612738,BOS,Boston Celtics,BOS @ BKN,87,2,Regular Season
22017,1610612764,WAS,Washington Wizards,0021700583,2018-01-06T00:00:00Z,WAS vs. MIL,103,-7,1610612749,MIL,Milwaukee Bucks,MIL @ WAS,110,7,Regular Season
22017,1610612765,DET,Detroit Pistons,0021700580,2018-01-06T00:00:00Z,DET vs. HOU,108,7,1610612745,HOU,Houston Rockets,HOU @ DET,101,-7,Regular Season
22017,1610612746,LAC,LA Clippers,0021700578,2018-01-06T00:00:00Z,LAC vs. GSW,105,-16,1610612744,GSW,Golden State Warriors,GSW @ LAC,121,16,Regular Season
22017,1610612754,IND,Indiana Pacers,0021700581,2018-01-06T00:00:00Z,IND vs. CHI,125,39,1610612741,CHI,Chicago Bulls,CHI @ IND,86,-39,Regular Season
22017,1610612753,ORL,Orlando Magic,0021700582,2018-01-06T00:00:00Z,ORL vs. CLE,127,-4,1610612739,CLE,Cleveland Cavaliers,CLE @ ORL,131,4,Regular Season
22017,1610612758,SAC,Sacramento Kings,0021700585,2018-01-06T00:00:00Z,SAC vs. DEN,106,8,1610612743,DEN,Denver Nuggets,DEN @ SAC,98,-8,Regular Season
22017,1610612750,MIN,Minnesota Timberwolves,0021700584,2018-01-06T00:00:00Z,MIN vs. NOP,116,18,1610612740,NOP,New Orleans Pelicans,NOP @ MIN,98,-18,Regular Season
22017,1610612742,DAL,Dallas Mavericks,0021700587,2018-01-07T00:00:00Z,DAL vs. NYK,96,-4,1610612752,NYK,New York Knicks,NYK @ DAL,100,4,Regular Season
22017,1610612747,LAL,Los Angeles Lakers,0021700590,2018-01-07T00:00:00Z,LAL vs. ATL,132,19,1610612737,ATL,Atlanta Hawks,ATL @ LAL,113,-19,Regular Season
22017,1610612757,POR,Portland Trail Blazers,0021700589,2018-01-07T00:00:00Z,POR vs. SAS,111,1,1610612759,SAS,San Antonio Spurs,SAS @ POR,110,-1,Regular Season
22017,1610612748,MIA,Miami Heat,0021700586,2018-01-07T00:00:00Z,MIA vs. UTA,103,1,1610612762,UTA,Utah Jazz,UTA @ MIA,102,-1,Regular Season
22017,1610612756,PHX,Phoenix Suns,0021700588,2018-01-07T00:00:00Z,PHX vs. OKC,114,14,1610612760,OKC,Oklahoma City Thunder,OKC @ PHX,100,-14,Regular Season
22017,1610612751,BKN,Brooklyn Nets,0021700592,2018-01-08T00:00:00Z,BKN vs. TOR,113,-1,1610612761,TOR,Toronto Raptors,TOR @ BKN,114,1,Regular Season
22017,1610612741,CHI,Chicago Bulls,0021700593,2018-01-08T00:00:00Z,CHI vs. HOU,107,-9,1610612745,HOU,Houston Rockets,HOU @ CHI,116,9,Regular Season
22017,1610612758,SAC,Sacramento Kings,0021700596,2018-01-08T00:00:00Z,SAC vs. SAS,100,-7,1610612759,SAS,San Antonio Spurs,SAS @ SAC,107,7,Regular Season
22017,1610612754,IND,Indiana Pacers,0021700591,2018-01-08T00:00:00Z,IND vs. MIL,109,13,1610612749,MIL,Milwaukee Bucks,MIL @ IND,96,-13,Regular Season
22017,1610612740,NOP,New Orleans Pelicans,0021700595,2018-01-08T00:00:00Z,NOP vs. DET,112,3,1610612765,DET,Detroit Pistons,DET @ NOP,109,-3,Regular Season
22017,1610612750,MIN,Minnesota Timberwolves,0021700594,2018-01-08T00:00:00Z,MIN vs. CLE,127,28,1610612739,CLE,Cleveland Cavaliers,CLE @ MIN,99,-28,Regular Season
22017,1610612744,GSW,Golden State Warriors,0021700597,2018-01-08T00:00:00Z,GSW vs. DEN,124,10,1610612743,DEN,Denver Nuggets,DEN @ GSW,114,-10,Regular Season
22017,1610612746,LAC,LA Clippers,0021700598,2018-01-08T00:00:00Z,LAC vs. ATL,108,1,1610612737,ATL,Atlanta Hawks,ATL @ LAC,107,-1,Regular Season
22017,1610612742,DAL,Dallas Mavericks,0021700601,2018-01-09T00:00:00Z,DAL vs. ORL,114,15,1610612753,ORL,Orlando Magic,ORL @ DAL,99,-15,Regular Season
22017,1610612761,TOR,Toronto Raptors,0021700599,2018-01-09T00:00:00Z,TOR vs. MIA,89,-1,1610612748,MIA,Miami Heat,MIA @ TOR,90,1,Regular Season
22017,1610612747,LAL,Los Angeles Lakers,0021700602,2018-01-09T00:00:00Z,LAL vs. SAC,99,13,1610612758,SAC,Sacramento Kings,SAC @ LAL,86,-13,Regular Season
22017,1610612760,OKC,Oklahoma City Thunder,0021700600,2018-01-09T00:00:00Z,OKC vs. POR,106,-11,1610612757,POR,Portland Trail Blazers,POR @ OKC,117,11,Regular Season
22017,1610612743,DEN,Denver Nuggets,0021700612,2018-01-10T00:00:00Z,DEN vs. ATL,97,-13,1610612737,ATL,Atlanta Hawks,ATL @ DEN,110,13,Regular Season
22017,1610612749,MIL,Milwaukee Bucks,0021700610,2018-01-10T00:00:00Z,MIL vs. ORL,110,7,1610612753,ORL,Orlando Magic,ORL @ MIL,103,-7,Regular Season
22017,1610612751,BKN,Brooklyn Nets,0021700606,2018-01-10T00:00:00Z,BKN vs. DET,80,-34,1610612765,DET,Detroit Pistons,DET @ BKN,114,34,Regular Season
22017,1610612763,MEM,Memphis Grizzlies,0021700609,2018-01-10T00:00:00Z,MEM vs. NOP,105,3,1610612740,NOP,New Orleans Pelicans,NOP @ MEM,102,-3,Regular Season
22017,1610612744,GSW,Golden State Warriors,0021700613,2018-01-10T00:00:00Z,GSW vs. LAC,106,-19,1610612746,LAC,LA Clippers,LAC @ GSW,125,19,Regular Season
22017,1610612752,NYK,New York Knicks,0021700607,2018-01-10T00:00:00Z,NYK vs. CHI,119,-3,1610612741,CHI,Chicago Bulls,CHI @ NYK,122,3,Regular Season
22017,1610612764,WAS,Washington Wizards,0021700605,2018-01-10T00:00:00Z,WAS vs. UTA,104,-3,1610612762,UTA,Utah Jazz,UTA @ WAS,107,3,Regular Season
22017,1610612754,IND,Indiana Pacers,0021700604,2018-01-10T00:00:00Z,IND vs. MIA,106,-8,1610612748,MIA,Miami Heat,MIA @ IND,114,8,Regular Season
22017,1610612750,MIN,Minnesota Timberwolves,0021700611,2018-01-10T00:00:00Z,MIN vs. OKC,104,16,1610612760,OKC,Oklahoma City Thunder,OKC @ MIN,88,-16,Regular Season
22017,1610612745,HOU,Houston Rockets,0021700608,2018-01-10T00:00:00Z,HOU vs. POR,121,9,1610612757,POR,Portland Trail Blazers,POR @ HOU,112,-9,Regular Season
22017,1610612766,CHA,Charlotte Hornets,0021700603,2018-01-10T00:00:00Z,CHA vs. DAL,111,-4,1610612742,DAL,Dallas Mavericks,DAL @ CHA,115,4,Regular Season
22017,1610612747,LAL,Los Angeles Lakers,0021700617,2018-01-11T00:00:00Z,LAL vs. SAS,93,12,1610612759,SAS,San Antonio Spurs,SAS @ LAL,81,-12,Regular Season
22017,1610612755,PHI,Philadelphia 76ers,0021700614,2018-01-11T00:00:00Z,PHI vs. BOS,103,-11,1610612738,BOS,Boston Celtics,BOS @ PHI,114,11,Regular Season
22017,1610612758,SAC,Sacramento Kings,0021700616,2018-01-11T00:00:00Z,SAC vs. LAC,115,-6,1610612746,LAC,LA Clippers,LAC @ SAC,121,6,Regular Season
22017,1610612761,TOR,Toronto Raptors,0021700615,2018-01-11T00:00:00Z,TOR vs. CLE,133,34,1610612739,CLE,Cleveland Cavaliers,CLE @ TOR,99,-34,Regular Season
22017,1610612749,MIL,Milwaukee Bucks,0021700622,2018-01-12T00:00:00Z,MIL vs. GSW,94,-14,1610612744,GSW,Golden State Warriors,GSW @ MIL,108,14,Regular Season
22017,1610612750,MIN,Minnesota Timberwolves,0021700623,2018-01-12T00:00:00Z,MIN vs. NYK,118,10,1610612752,NYK,New York Knicks,NYK @ MIN,108,-10,Regular Season
22017,1610612737,ATL,Atlanta Hawks,0021700621,2018-01-12T00:00:00Z,ATL vs. BKN,105,-5,1610612751,BKN,Brooklyn Nets,BKN @ ATL,110,5,Regular Season
22017,1610612740,NOP,New Orleans Pelicans,0021700624,2018-01-12T00:00:00Z,NOP vs. POR,119,6,1610612757,POR,Portland Trail Blazers,POR @ NOP,113,-6,Regular Season
22017,1610612754,IND,Indiana Pacers,0021700619,2018-01-12T00:00:00Z,IND vs. CLE,97,2,1610612739,CLE,Cleveland Cavaliers,CLE @ IND,95,-2,Regular Season
22017,1610612766,CHA,Charlotte Hornets,0021700618,2018-01-12T00:00:00Z,CHA vs. UTA,99,11,1610612762,UTA,Utah Jazz,UTA @ CHA,88,-11,Regular Season
22017,1610612764,WAS,Washington Wizards,0021700620,2018-01-12T00:00:00Z,WAS vs. ORL,125,6,1610612753,ORL,Orlando Magic,ORL @ WAS,119,-6,Regular Season
22017,1610612743,DEN,Denver Nuggets,0021700625,2018-01-12T00:00:00Z,DEN vs. MEM,87,9,1610612763,MEM,Memphis Grizzlies,MEM @ DEN,78,-9,Regular Season
22017,1610612756,PHX,Phoenix Suns,0021700626,2018-01-12T00:00:00Z,PHX vs. HOU,95,-17,1610612745,HOU,Houston Rockets,HOU @ PHX,112,17,Regular Season
22017,1610612761,TOR,Toronto Raptors,0021700631,2018-01-13T00:00:00Z,TOR vs. GSW,125,-2,1610612744,GSW,Golden State Warriors,GSW @ TOR,127,2,Regular Season
22017,1610612741,CHI,Chicago Bulls,0021700632,2018-01-13T00:00:00Z,CHI vs. DET,107,2,1610612765,DET,Detroit Pistons,DET @ CHI,105,-2,Regular Season
22017,1610612766,CHA,Charlotte Hornets,0021700629,2018-01-13T00:00:00Z,CHA vs. OKC,91,-10,1610612760,OKC,Oklahoma City Thunder,OKC @ CHA,101,10,Regular Season
22017,1610612746,LAC,LA Clippers,0021700628,2018-01-13T00:00:00Z,LAC vs. SAC,126,21,1610612758,SAC,Sacramento Kings,SAC @ LAC,105,-21,Regular Season
22017,1610612764,WAS,Washington Wizards,0021700630,2018-01-13T00:00:00Z,WAS vs. BKN,119,6,1610612751,BKN,Brooklyn Nets,BKN @ WAS,113,-6,Regular Season
22017,1610612742,DAL,Dallas Mavericks,0021700627,2018-01-13T00:00:00Z,DAL vs. LAL,101,-6,1610612747,LAL,Los Angeles Lakers,LAL @ DAL,107,6,Regular Season
22017,1610612759,SAS,San Antonio Spurs,0021700633,2018-01-13T00:00:00Z,SAS vs. DEN,112,32,1610612743,DEN,Denver Nuggets,DEN @ SAS,80,-32,Regular Season
22017,1610612748,MIA,Miami Heat,0021700634,2018-01-14T00:00:00Z,MIA vs. MIL,97,18,1610612749,MIL,Milwaukee Bucks,MIL @ MIA,79,-18,Regular Season
22017,1610612750,MIN,Minnesota Timberwolves,0021700637,2018-01-14T00:00:00Z,MIN vs. POR,120,17,1610612757,POR,Portland Trail Blazers,POR @ MIN,103,-17,Regular Season
22017,1610612756,PHX,Phoenix Suns,0021700636,2018-01-14T00:00:00Z,PHX vs. IND,97,-23,1610612754,IND,Indiana Pacers,IND @ PHX,120,23,Regular Season
22017,1610612752,NYK,New York Knicks,0021700635,2018-01-14T00:00:00Z,NYK vs. NOP,118,-5,1610612740,NOP,New Orleans Pelicans,NOP @ NYK,123,5,Regular Season
22017,1610612737,ATL,Atlanta Hawks,0021700641,2018-01-15T00:00:00Z,ATL vs. SAS,102,3,1610612759,SAS,San Antonio Spurs,SAS @ ATL,99,-3,Regular Season
22017,1610612760,OKC,Oklahoma City Thunder,0021700643,2018-01-15T00:00:00Z,OKC vs. SAC,95,7,1610612758,SAC,Sacramento Kings,SAC @ OKC,88,-7,Regular Season
22017,1610612746,LAC,LA Clippers,0021700648,2018-01-15T00:00:00Z,LAC vs. HOU,113,11,1610612745,HOU,Houston Rockets,HOU @ LAC,102,-11,Regular Season
22017,1610612755,PHI,Philadelphia 76ers,0021700639,2018-01-15T00:00:00Z,PHI vs. TOR,117,6,1610612761,TOR,Toronto Raptors,TOR @ PHI,111,-6,Regular Season
22017,1610612762,UTA,Utah Jazz,0021700647,2018-01-15T00:00:00Z,UTA vs. IND,94,-15,1610612754,IND,Indiana Pacers,IND @ UTA,109,15,Regular Season
22017,1610612764,WAS,Washington Wizards,0021700640,2018-01-15T00:00:00Z,WAS vs. MIL,95,-9,1610612749,MIL,Milwaukee Bucks,MIL @ WAS,104,9,Regular Season
22017,1610612765,DET,Detroit Pistons,0021700638,2018-01-15T00:00:00Z,DET vs. CHA,107,-11,1610612766,CHA,Charlotte Hornets,CHA @ DET,118,11,Regular Season
22017,1610612739,CLE,Cleveland Cavaliers,0021700646,2018-01-15T00:00:00Z,CLE vs. GSW,108,-10,1610612744,GSW,Golden State Warriors,GSW @ CLE,118,10,Regular Season
22017,1610612751,BKN,Brooklyn Nets,0021700642,2018-01-15T00:00:00Z,BKN vs. NYK,104,-15,1610612752,NYK,New York Knicks,NYK @ BKN,119,15,Regular Season
22017,1610612763,MEM,Memphis Grizzlies,0021700645,2018-01-15T00:00:00Z,MEM vs. LAL,123,9,1610612747,LAL,Los Angeles Lakers,LAL @ MEM,114,-9,Regular Season
22017,1610612741,CHI,Chicago Bulls,0021700644,2018-01-15T00:00:00Z,CHI vs. MIA,119,8,1610612748,MIA,Miami Heat,MIA @ CHI,111,-8,Regular Season
22017,1610612738,BOS,Boston Celtics,0021700650,2018-01-16T00:00:00Z,BOS vs. NOP,113,-3,1610612740,NOP,New Orleans Pelicans,NOP @ BOS,116,3,Regular Season
22017,1610612757,POR,Portland Trail Blazers,0021700652,2018-01-16T00:00:00Z,POR vs. PHX,118,7,1610612756,PHX,Phoenix Suns,PHX @ POR,111,-7,Regular Season
22017,1610612753,ORL,Orlando Magic,0021700649,2018-01-16T00:00:00Z,ORL vs. MIN,108,6,1610612750,MIN,Minnesota Timberwolves,MIN @ ORL,102,-6,Regular Season
22017,1610612743,DEN,Denver Nuggets,0021700651,2018-01-16T00:00:00Z,DEN vs. DAL,105,3,1610612742,DAL,Dallas Mavericks,DAL @ DEN,102,-3,Regular Season
22017,1610612746,LAC,LA Clippers,0021700662,2018-01-17T00:00:00Z,LAC vs. DEN,109,5,1610612743,DEN,Denver Nuggets,DEN @ LAC,104,-5,Regular Season
22017,1610612763,MEM,Memphis Grizzlies,0021700658,2018-01-17T00:00:00Z,MEM vs. NYK,105,6,1610612752,NYK,New York Knicks,NYK @ MEM,99,-6,Regular Season
22017,1610612751,BKN,Brooklyn Nets,0021700655,2018-01-17T00:00:00Z,BKN vs. SAS,95,-5,1610612759,SAS,San Antonio Spurs,SAS @ BKN,100,5,Regular Season
22017,1610612741,CHI,Chicago Bulls,0021700657,2018-01-17T00:00:00Z,CHI vs. GSW,112,-7,1610612744,GSW,Golden State Warriors,GSW @ CHI,119,7,Regular Season
22017,1610612761,TOR,Toronto Raptors,0021700656,2018-01-17T00:00:00Z,TOR vs. DET,96,5,1610612765,DET,Detroit Pistons,DET @ TOR,91,-5,Regular Season
22017,1610612758,SAC,Sacramento Kings,0021700661,2018-01-17T00:00:00Z,SAC vs. UTA,105,-15,1610612762,UTA,Utah Jazz,UTA @ SAC,120,15,Regular Season
22017,1610612766,CHA,Charlotte Hornets,0021700653,2018-01-17T00:00:00Z,CHA vs. WAS,133,24,1610612764,WAS,Washington Wizards,WAS @ CHA,109,-24,Regular Season
22017,1610612737,ATL,Atlanta Hawks,0021700654,2018-01-17T00:00:00Z,ATL vs. NOP,94,1,1610612740,NOP,New Orleans Pelicans,NOP @ ATL,93,-1,Regular Season
22017,1610612760,OKC,Oklahoma City Thunder,0021700660,2018-01-17T00:00:00Z,OKC vs. LAL,114,24,1610612747,LAL,Los Angeles Lakers,LAL @ OKC,90,-24,Regular Season
22017,1610612749,MIL,Milwaukee Bucks,0021700659,2018-01-17T00:00:00Z,MIL vs. MIA,101,-5,1610612748,MIA,Miami Heat,MIA @ MIL,106,5,Regular Season
22017,1610612757,POR,Portland Trail Blazers,0021700666,2018-01-18T00:00:00Z,POR vs. IND,100,14,1610612754,IND,Indiana Pacers,IND @ POR,86,-14,Regular Season
22017,1610612739,CLE,Cleveland Cavaliers,0021700664,2018-01-18T00:00:00Z,CLE vs. ORL,104,1,1610612753,ORL,Orlando Magic,ORL @ CLE,103,-1,Regular Season
22017,1610612738,BOS,Boston Celtics,0021700663,2018-01-18T00:00:00Z,BOS vs. PHI,80,-9,1610612755,PHI,Philadelphia 76ers,PHI @ BOS,89,9,Regular Season
22017,1610612745,HOU,Houston Rockets,0021700665,2018-01-18T00:00:00Z,HOU vs. MIN,116,18,1610612750,MIN,Minnesota Timberwolves,MIN @ HOU,98,-18,Regular Season
22017,1610612751,BKN,Brooklyn Nets,0021700668,2018-01-19T00:00:00Z,BKN vs. MIA,101,6,1610612748,MIA,Miami Heat,MIA @ BKN,95,-6,Regular Season
22017,1610612763,MEM,Memphis Grizzlies,0021700670,2018-01-19T00:00:00Z,MEM vs. SAC,106,18,1610612758,SAC,Sacramento Kings,SAC @ MEM,88,-18,Regular Season
22017,1610612765,DET,Detroit Pistons,0021700669,2018-01-19T00:00:00Z,DET vs. WAS,112,-10,1610612764,WAS,Washington Wizards,WAS @ DET,122,10,Regular Season
22017,1610612762,UTA,Utah Jazz,0021700672,2018-01-19T00:00:00Z,UTA vs. NYK,115,-2,1610612752,NYK,New York Knicks,NYK @ UTA,117,2,Regular Season
22017,1610612743,DEN,Denver Nuggets,0021700671,2018-01-19T00:00:00Z,DEN vs. PHX,100,-8,1610612756,PHX,Phoenix Suns,PHX @ DEN,108,8,Regular Season
22017,1610612747,LAL,Los Angeles Lakers,0021700673,2018-01-19T00:00:00Z,LAL vs. IND,99,13,1610612754,IND,Indiana Pacers,IND @ LAL,86,-13,Regular Season
22017,1610612761,TOR,Toronto Raptors,0021700667,2018-01-19T00:00:00Z,TOR vs. SAS,86,3,1610612759,SAS,San Antonio Spurs,SAS @ TOR,83,-3,Regular Season
22017,1610612755,PHI,Philadelphia 76ers,0021700678,2018-01-20T00:00:00Z,PHI vs. MIL,116,22,1610612749,MIL,Milwaukee Bucks,MIL @ PHI,94,-22,Regular Season
22017,1610612740,NOP,New Orleans Pelicans,0021700677,2018-01-20T00:00:00Z,NOP vs. MEM,111,7,1610612763,MEM,Memphis Grizzlies,MEM @ NOP,104,-7,Regular Season
22017,1610612739,CLE,Cleveland Cavaliers,0021700674,2018-01-20T00:00:00Z,CLE vs. OKC,124,-24,1610612760,OKC,Oklahoma City Thunder,OKC @ CLE,148,24,Regular Season
22017,1610612750,MIN,Minnesota Timberwolves,0021700680,2018-01-20T00:00:00Z,MIN vs. TOR,115,6,1610612761,TOR,Toronto Raptors,TOR @ MIN,109,-6,Regular Season
22017,1610612766,CHA,Charlotte Hornets,0021700676,2018-01-20T00:00:00Z,CHA vs. MIA,105,-1,1610612748,MIA,Miami Heat,MIA @ CHA,106,1,Regular Season
22017,1610612745,HOU,Houston Rockets,0021700679,2018-01-20T00:00:00Z,HOU vs. GSW,116,8,1610612744,GSW,Golden State Warriors,GSW @ HOU,108,-8,Regular Season
22017,1610612757,POR,Portland Trail Blazers,0021700682,2018-01-20T00:00:00Z,POR vs. DAL,117,9,1610612742,DAL,Dallas Mavericks,DAL @ POR,108,-9,Regular Season
22017,1610612737,ATL,Atlanta Hawks,0021700675,2018-01-20T00:00:00Z,ATL vs. CHI,97,-16,1610612741,CHI,Chicago Bulls,CHI @ ATL,113,16,Regular Season
22017,1610612762,UTA,Utah Jazz,0021700681,2018-01-20T00:00:00Z,UTA vs. LAC,125,12,1610612746,LAC,LA Clippers,LAC @ UTA,113,-12,Regular Season
22017,1610612747,LAL,Los Angeles Lakers,0021700684,2018-01-21T00:00:00Z,LAL vs. NYK,127,20,1610612752,NYK,New York Knicks,NYK @ LAL,107,-20,Regular Season
22017,1610612765,DET,Detroit Pistons,0021700685,2018-01-21T00:00:00Z,DET vs. BKN,100,-1,1610612751,BKN,Brooklyn Nets,BKN @ DET,101,1,Regular Season
22017,1610612759,SAS,San Antonio Spurs,0021700686,2018-01-21T00:00:00Z,SAS vs. IND,86,-8,1610612754,IND,Indiana Pacers,IND @ SAS,94,8,Regular Season
22017,1610612738,BOS,Boston Celtics,0021700683,2018-01-21T00:00:00Z,BOS vs. ORL,95,-8,1610612753,ORL,Orlando Magic,ORL @ BOS,103,8,Regular Season
22017,1610612740,NOP,New Orleans Pelicans,0021700692,2018-01-22T00:00:00Z,NOP vs. CHI,132,4,1610612741,CHI,Chicago Bulls,CHI @ NOP,128,-4,Regular Season
22017,1610612749,MIL,Milwaukee Bucks,0021700691,2018-01-22T00:00:00Z,MIL vs. PHX,109,4,1610612756,PHX,Phoenix Suns,PHX @ MIL,105,-4,Regular Season
22017,1610612742,DAL,Dallas Mavericks,0021700693,2018-01-22T00:00:00Z,DAL vs. WAS,98,23,1610612764,WAS,Washington Wizards,WAS @ DAL,75,-23,Regular Season
22017,1610612743,DEN,Denver Nuggets,0021700694,2018-01-22T00:00:00Z,DEN vs. POR,104,3,1610612757,POR,Portland Trail Blazers,POR @ DEN,101,-3,Regular Season
22017,1610612763,MEM,Memphis Grizzlies,0021700690,2018-01-22T00:00:00Z,MEM vs. PHI,105,4,1610612755,PHI,Philadelphia 76ers,PHI @ MEM,101,-4,Regular Season
22017,1610612745,HOU,Houston Rockets,0021700689,2018-01-22T00:00:00Z,HOU vs. MIA,99,9,1610612748,MIA,Miami Heat,MIA @ HOU,90,-9,Regular Season
22017,1610612737,ATL,Atlanta Hawks,0021700688,2018-01-22T00:00:00Z,ATL vs. UTA,104,14,1610612762,UTA,Utah Jazz,UTA @ ATL,90,-14,Regular Season
22017,1610612766,CHA,Charlotte Hornets,0021700687,2018-01-22T00:00:00Z,CHA vs. SAC,112,5,1610612758,SAC,Sacramento Kings,SAC @ CHA,107,-5,Regular Season
22017,1610612746,LAC,LA Clippers,0021700695,2018-01-22T00:00:00Z,LAC vs. MIN,118,-8,1610612750,MIN,Minnesota Timberwolves,MIN @ LAC,126,8,Regular Season
22017,1610612760,OKC,Oklahoma City Thunder,0021700697,2018-01-23T00:00:00Z,OKC vs. BKN,109,1,1610612751,BKN,Brooklyn Nets,BKN @ OKC,108,-1,Regular Season
22017,1610612744,GSW,Golden State Warriors,0021700699,2018-01-23T00:00:00Z,GSW vs. NYK,123,11,1610612752,NYK,New York Knicks,NYK @ GSW,112,-11,Regular Season
22017,1610612747,LAL,Los Angeles Lakers,0021700700,2018-01-23T00:00:00Z,LAL vs. BOS,108,1,1610612738,BOS,Boston Celtics,BOS @ LAL,107,-1,Regular Season
22017,1610612759,SAS,San Antonio Spurs,0021700698,2018-01-23T00:00:00Z,SAS vs. CLE,114,12,1610612739,CLE,Cleveland Cavaliers,CLE @ SAS,102,-12,Regular Season
22017,1610612753,ORL,Orlando Magic,0021700696,2018-01-23T00:00:00Z,ORL vs. SAC,99,-6,1610612758,SAC,Sacramento Kings,SAC @ ORL,105,6,Regular Season
22017,1610612763,MEM,Memphis Grizzlies,0021700707,2018-01-24T00:00:00Z,MEM vs. SAS,85,-23,1610612759,SAS,San Antonio Spurs,SAS @ MEM,108,23,Regular Season
22017,1610612754,IND,Indiana Pacers,0021700703,2018-01-24T00:00:00Z,IND vs. PHX,116,15,1610612756,PHX,Phoenix Suns,PHX @ IND,101,-15,Regular Season
22017,1610612757,POR,Portland Trail Blazers,0021700708,2018-01-24T00:00:00Z,POR vs. MIN,123,9,1610612750,MIN,Minnesota Timberwolves,MIN @ POR,114,-9,Regular Season
22017,1610612742,DAL,Dallas Mavericks,0021700706,2018-01-24T00:00:00Z,DAL vs. HOU,97,-7,1610612745,HOU,Houston Rockets,HOU @ DAL,104,7,Regular Season
22017,1610612755,PHI,Philadelphia 76ers,0021700704,2018-01-24T00:00:00Z,PHI vs. CHI,115,14,1610612741,CHI,Chicago Bulls,CHI @ PHI,101,-14,Regular Season
22017,1610612746,LAC,LA Clippers,0021700709,2018-01-24T00:00:00Z,LAC vs. BOS,102,-11,1610612738,BOS,Boston Celtics,BOS @ LAC,113,11,Regular Season
22017,1610612766,CHA,Charlotte Hornets,0021700701,2018-01-24T00:00:00Z,CHA vs. NOP,96,-5,1610612740,NOP,New Orleans Pelicans,NOP @ CHA,101,5,Regular Season
22017,1610612737,ATL,Atlanta Hawks,0021700705,2018-01-24T00:00:00Z,ATL vs. TOR,93,-15,1610612761,TOR,Toronto Raptors,TOR @ ATL,108,15,Regular Season
22017,1610612765,DET,Detroit Pistons,0021700702,2018-01-24T00:00:00Z,DET vs. UTA,95,-3,1610612762,UTA,Utah Jazz,UTA @ DET,98,3,Regular Season
22017,1610612748,MIA,Miami Heat,0021700710,2018-01-25T00:00:00Z,MIA vs. SAC,88,-1,1610612758,SAC,Sacramento Kings,SAC @ MIA,89,1,Regular Season
22017,1610612744,GSW,Golden State Warriors,0021700713,2018-01-25T00:00:00Z,GSW vs. MIN,126,13,1610612750,MIN,Minnesota Timberwolves,MIN @ GSW,113,-13,Regular Season
22017,1610612760,OKC,Oklahoma City Thunder,0021700711,2018-01-25T00:00:00Z,OKC vs. WAS,121,9,1610612764,WAS,Washington Wizards,WAS @ OKC,112,-9,Regular Season
22017,1610612743,DEN,Denver Nuggets,0021700712,2018-01-25T00:00:00Z,DEN vs. NYK,130,12,1610612752,NYK,New York Knicks,NYK @ DEN,118,-12,Regular Season
22017,1610612763,MEM,Memphis Grizzlies,0021700718,2018-01-26T00:00:00Z,MEM vs. LAC,100,-9,1610612746,LAC,LA Clippers,LAC @ MEM,109,9,Regular Season
22017,1610612756,PHX,Phoenix Suns,0021700723,2018-01-26T00:00:00Z,PHX vs. NYK,85,-22,1610612752,NYK,New York Knicks,NYK @ PHX,107,22,Regular Season
22017,1610612759,SAS,San Antonio Spurs,0021700722,2018-01-26T00:00:00Z,SAS vs. PHI,78,-19,1610612755,PHI,Philadelphia 76ers,PHI @ SAS,97,19,Regular Season
22017,1610612739,CLE,Cleveland Cavaliers,0021700715,2018-01-26T00:00:00Z,CLE vs. IND,115,7,1610612754,IND,Indiana Pacers,IND @ CLE,108,-7,Regular Season
22017,1610612740,NOP,New Orleans Pelicans,0021700720,2018-01-26T00:00:00Z,NOP vs. HOU,115,2,1610612745,HOU,Houston Rockets,HOU @ NOP,113,-2,Regular Season
22017,1610612741,CHI,Chicago Bulls,0021700717,2018-01-26T00:00:00Z,CHI vs. LAL,103,-5,1610612747,LAL,Los Angeles Lakers,LAL @ CHI,108,5,Regular Season
22017,1610612749,MIL,Milwaukee Bucks,0021700719,2018-01-26T00:00:00Z,MIL vs. BKN,116,25,1610612751,BKN,Brooklyn Nets,BKN @ MIL,91,-25,Regular Season
22017,1610612761,TOR,Toronto Raptors,0021700716,2018-01-26T00:00:00Z,TOR vs. UTA,93,-4,1610612762,UTA,Utah Jazz,UTA @ TOR,97,4,Regular Season
22017,1610612742,DAL,Dallas Mavericks,0021700721,2018-01-26T00:00:00Z,DAL vs. POR,93,-14,1610612757,POR,Portland Trail Blazers,POR @ DAL,107,14,Regular Season
22017,1610612766,CHA,Charlotte Hornets,0021700714,2018-01-26T00:00:00Z,CHA vs. ATL,121,11,1610612737,ATL,Atlanta Hawks,ATL @ CHA,110,-11,Regular Season
22017,1610612754,IND,Indiana Pacers,0021700725,2018-01-27T00:00:00Z,IND vs. ORL,114,2,1610612753,ORL,Orlando Magic,ORL @ IND,112,-2,Regular Season
22017,1610612743,DEN,Denver Nuggets,0021700730,2018-01-27T00:00:00Z,DEN vs. DAL,91,2,1610612742,DAL,Dallas Mavericks,DAL @ DEN,89,-2,Regular Season
22017,1610612765,DET,Detroit Pistons,0021700724,2018-01-27T00:00:00Z,DET vs. OKC,108,-13,1610612760,OKC,Oklahoma City Thunder,OKC @ DET,121,13,Regular Season
22017,1610612737,ATL,Atlanta Hawks,0021700726,2018-01-27T00:00:00Z,ATL vs. WAS,104,-25,1610612764,WAS,Washington Wizards,WAS @ ATL,129,25,Regular Season
22017,1610612744,GSW,Golden State Warriors,0021700728,2018-01-27T00:00:00Z,GSW vs. BOS,109,4,1610612738,BOS,Boston Celtics,BOS @ GSW,105,-4,Regular Season
22017,1610612750,MIN,Minnesota Timberwolves,0021700729,2018-01-27T00:00:00Z,MIN vs. BKN,111,14,1610612751,BKN,Brooklyn Nets,BKN @ MIN,97,-14,Regular Season
22017,1610612748,MIA,Miami Heat,0021700727,2018-01-27T00:00:00Z,MIA vs. CHA,95,4,1610612766,CHA,Charlotte Hornets,CHA @ MIA,91,-4,Regular Season
22017,1610612760,OKC,Oklahoma City Thunder,0021700736,2018-01-28T00:00:00Z,OKC vs. PHI,122,10,1610612755,PHI,Philadelphia 76ers,PHI @ OKC,112,-10,Regular Season
22017,1610612761,TOR,Toronto Raptors,0021700735,2018-01-28T00:00:00Z,TOR vs. LAL,123,12,1610612747,LAL,Los Angeles Lakers,LAL @ TOR,111,-12,Regular Season
22017,1610612745,HOU,Houston Rockets,0021700732,2018-01-28T00:00:00Z,HOU vs. PHX,113,11,1610612756,PHX,Phoenix Suns,PHX @ HOU,102,-11,Regular Season
22017,1610612759,SAS,San Antonio Spurs,0021700737,2018-01-28T00:00:00Z,SAS vs. SAC,113,15,1610612758,SAC,Sacramento Kings,SAC @ SAS,98,-15,Regular Season
22017,1610612741,CHI,Chicago Bulls,0021700731,2018-01-28T00:00:00Z,CHI vs. MIL,96,-14,1610612749,MIL,Milwaukee Bucks,MIL @ CHI,110,14,Regular Season
22017,1610612739,CLE,Cleveland Cavaliers,0021700734,2018-01-28T00:00:00Z,CLE vs. DET,121,17,1610612765,DET,Detroit Pistons,DET @ CLE,104,-17,Regular Season
22017,1610612740,NOP,New Orleans Pelicans,0021700733,2018-01-28T00:00:00Z,NOP vs. LAC,103,-9,1610612746,LAC,LA Clippers,LAC @ NOP,112,9,Regular Season
22017,1610612742,DAL,Dallas Mavericks,0021700742,2018-01-29T00:00:00Z,DAL vs. MIA,88,-7,1610612748,MIA,Miami Heat,MIA @ DAL,95,7,Regular Season
22017,1610612763,MEM,Memphis Grizzlies,0021700740,2018-01-29T00:00:00Z,MEM vs. PHX,120,11,1610612756,PHX,Phoenix Suns,PHX @ MEM,109,-11,Regular Season
22017,1610612737,ATL,Atlanta Hawks,0021700739,2018-01-29T00:00:00Z,ATL vs. MIN,105,5,1610612750,MIN,Minnesota Timberwolves,MIN @ ATL,100,-5,Regular Season
22017,1610612743,DEN,Denver Nuggets,0021700743,2018-01-29T00:00:00Z,DEN vs. BOS,110,-1,1610612738,BOS,Boston Celtics,BOS @ DEN,111,1,Regular Season
22017,1610612749,MIL,Milwaukee Bucks,0021700741,2018-01-29T00:00:00Z,MIL vs. PHI,107,12,1610612755,PHI,Philadelphia 76ers,PHI @ MIL,95,-12,Regular Season
22017,1610612754,IND,Indiana Pacers,0021700738,2018-01-29T00:00:00Z,IND vs. CHA,105,9,1610612766,CHA,Charlotte Hornets,CHA @ IND,96,-9,Regular Season
22017,1610612745,HOU,Houston Rockets,0021700748,2018-01-30T00:00:00Z,HOU vs. ORL,114,7,1610612753,ORL,Orlando Magic,ORL @ HOU,107,-7,Regular Season
22017,1610612762,UTA,Utah Jazz,0021700751,2018-01-30T00:00:00Z,UTA vs. GSW,129,30,1610612744,GSW,Golden State Warriors,GSW @ UTA,99,-30,Regular Season
22017,1610612765,DET,Detroit Pistons,0021700747,2018-01-30T00:00:00Z,DET vs. CLE,125,11,1610612739,CLE,Cleveland Cavaliers,CLE @ DET,114,-11,Regular Season
22017,1610612752,NYK,New York Knicks,0021700745,2018-01-30T00:00:00Z,NYK vs. BKN,111,16,1610612751,BKN,Brooklyn Nets,BKN @ NYK,95,-16,Regular Season
22017,1610612746,LAC,LA Clippers,0021700752,2018-01-30T00:00:00Z,LAC vs. POR,96,-8,1610612757,POR,Portland Trail Blazers,POR @ LAC,104,8,Regular Season
22017,1610612759,SAS,San Antonio Spurs,0021700750,2018-01-30T00:00:00Z,SAS vs. DEN,106,2,1610612743,DEN,Denver Nuggets,DEN @ SAS,104,-2,Regular Season
22017,1610612740,NOP,New Orleans Pelicans,0021700749,2018-01-30T00:00:00Z,NOP vs. SAC,103,-11,1610612758,SAC,Sacramento Kings,SAC @ NOP,114,11,Regular Season
22017,1610612761,TOR,Toronto Raptors,0021700746,2018-01-30T00:00:00Z,TOR vs. MIN,109,5,1610612750,MIN,Minnesota Timberwolves,MIN @ TOR,104,-5,Regular Season
22017,1610612764,WAS,Washington Wizards,0021700744,2018-01-30T00:00:00Z,WAS vs. OKC,102,6,1610612760,OKC,Oklahoma City Thunder,OKC @ WAS,96,-6,Regular Season
22017,1610612756,PHX,Phoenix Suns,0021700760,2018-01-31T00:00:00Z,PHX vs. DAL,102,14,1610612742,DAL,Dallas Mavericks,DAL @ PHX,88,-14,Regular Season
22017,1610612738,BOS,Boston Celtics,0021700758,2018-01-31T00:00:00Z,BOS vs. NYK,103,30,1610612752,NYK,New York Knicks,NYK @ BOS,73,-30,Regular Season
22017,1610612737,ATL,Atlanta Hawks,0021700755,2018-01-31T00:00:00Z,ATL vs. CHA,110,-13,1610612766,CHA,Charlotte Hornets,CHA @ ATL,123,13,Regular Season
22017,1610612754,IND,Indiana Pacers,0021700753,2018-01-31T00:00:00Z,IND vs. MEM,105,4,1610612763,MEM,Memphis Grizzlies,MEM @ IND,101,-4,Regular Season
22017,1610612753,ORL,Orlando Magic,0021700754,2018-01-31T00:00:00Z,ORL vs. LAL,127,22,1610612747,LAL,Los Angeles Lakers,LAL @ ORL,105,-22,Regular Season
22017,1610612739,CLE,Cleveland Cavaliers,0021700757,2018-01-31T00:00:00Z,CLE vs. MIA,91,2,1610612748,MIA,Miami Heat,MIA @ CLE,89,-2,Regular Season
22017,1610612757,POR,Portland Trail Blazers,0021700759,2018-01-31T00:00:00Z,POR vs. CHI,124,16,1610612741,CHI,Chicago Bulls,CHI @ POR,108,-16,Regular Season
22017,1610612751,BKN,Brooklyn Nets,0021700756,2018-01-31T00:00:00Z,BKN vs. PHI,116,8,1610612755,PHI,Philadelphia 76ers,PHI @ BKN,108,-8,Regular Season
22017,1610612743,DEN,Denver Nuggets,0021700765,2018-02-01T00:00:00Z,DEN vs. OKC,127,3,1610612760,OKC,Oklahoma City Thunder,OKC @ DEN,124,-3,Regular Season
22017,1610612759,SAS,San Antonio Spurs,0021700764,2018-02-01T00:00:00Z,SAS vs. HOU,91,-11,1610612745,HOU,Houston Rockets,HOU @ SAS,102,11,Regular Season
22017,1610612764,WAS,Washington Wizards,0021700762,2018-02-01T00:00:00Z,WAS vs. TOR,122,3,1610612761,TOR,Toronto Raptors,TOR @ WAS,119,-3,Regular Season
22017,1610612765,DET,Detroit Pistons,0021700761,2018-02-01T00:00:00Z,DET vs. MEM,104,2,1610612763,MEM,Memphis Grizzlies,MEM @ DET,102,-2,Regular Season
22017,1610612750,MIN,Minnesota Timberwolves,0021700763,2018-02-01T00:00:00Z,MIN vs. MIL,108,19,1610612749,MIL,Milwaukee Bucks,MIL @ MIN,89,-19,Regular Season
22017,1610612738,BOS,Boston Celtics,0021700767,2018-02-02T00:00:00Z,BOS vs. ATL,119,9,1610612737,ATL,Atlanta Hawks,ATL @ BOS,110,-9,Regular Season
22017,1610612751,BKN,Brooklyn Nets,0021700768,2018-02-02T00:00:00Z,BKN vs. LAL,99,-3,1610612747,LAL,Los Angeles Lakers,LAL @ BKN,102,3,Regular Season
22017,1610612756,PHX,Phoenix Suns,0021700773,2018-02-02T00:00:00Z,PHX vs. UTA,97,-32,1610612762,UTA,Utah Jazz,UTA @ PHX,129,32,Regular Season
22017,1610612755,PHI,Philadelphia 76ers,0021700770,2018-02-02T00:00:00Z,PHI vs. MIA,103,6,1610612748,MIA,Miami Heat,MIA @ PHI,97,-6,Regular Season
22017,1610612749,MIL,Milwaukee Bucks,0021700771,2018-02-02T00:00:00Z,MIL vs. NYK,92,2,1610612752,NYK,New York Knicks,NYK @ MIL,90,-2,Regular Season
22017,1610612766,CHA,Charlotte Hornets,0021700766,2018-02-02T00:00:00Z,CHA vs. IND,133,7,1610612754,IND,Indiana Pacers,IND @ CHA,126,-7,Regular Season
22017,1610612758,SAC,Sacramento Kings,0021700774,2018-02-02T00:00:00Z,SAC vs. GSW,104,-15,1610612744,GSW,Golden State Warriors,GSW @ SAC,119,15,Regular Season
22017,1610612760,OKC,Oklahoma City Thunder,0021700772,2018-02-02T00:00:00Z,OKC vs. NOP,100,-14,1610612740,NOP,New Orleans Pelicans,NOP @ OKC,114,14,Regular Season
22017,1610612761,TOR,Toronto Raptors,0021700769,2018-02-02T00:00:00Z,TOR vs. POR,130,25,1610612757,POR,Portland Trail Blazers,POR @ TOR,105,-25,Regular Season
22017,1610612765,DET,Detroit Pistons,0021700776,2018-02-03T00:00:00Z,DET vs. MIA,111,4,1610612748,MIA,Miami Heat,MIA @ DET,107,-4,Regular Season
22017,1610612754,IND,Indiana Pacers,0021700777,2018-02-03T00:00:00Z,IND vs. PHI,100,8,1610612755,PHI,Philadelphia 76ers,PHI @ IND,92,-8,Regular Season
22017,1610612739,CLE,Cleveland Cavaliers,0021700779,2018-02-03T00:00:00Z,CLE vs. HOU,88,-32,1610612745,HOU,Houston Rockets,HOU @ CLE,120,32,Regular Season
22017,1610612743,DEN,Denver Nuggets,0021700782,2018-02-03T00:00:00Z,DEN vs. GSW,115,7,1610612744,GSW,Golden State Warriors,GSW @ DEN,108,-7,Regular Season
22017,1610612750,MIN,Minnesota Timberwolves,0021700780,2018-02-03T00:00:00Z,MIN vs. NOP,118,11,1610612740,NOP,New Orleans Pelicans,NOP @ MIN,107,-11,Regular Season
22017,1610612758,SAC,Sacramento Kings,0021700783,2018-02-03T00:00:00Z,SAC vs. DAL,99,-7,1610612742,DAL,Dallas Mavericks,DAL @ SAC,106,7,Regular Season
22017,1610612753,ORL,Orlando Magic,0021700778,2018-02-03T00:00:00Z,ORL vs. WAS,98,-17,1610612764,WAS,Washington Wizards,WAS @ ORL,115,17,Regular Season
22017,1610612759,SAS,San Antonio Spurs,0021700781,2018-02-03T00:00:00Z,SAS vs. UTA,111,-9,1610612762,UTA,Utah Jazz,UTA @ SAS,120,9,Regular Season
22017,1610612746,LAC,LA Clippers,0021700775,2018-02-03T00:00:00Z,LAC vs. CHI,113,10,1610612741,CHI,Chicago Bulls,CHI @ LAC,103,-10,Regular Season
22017,1610612751,BKN,Brooklyn Nets,0021700785,2018-02-04T00:00:00Z,BKN vs. MIL,94,-15,1610612749,MIL,Milwaukee Bucks,MIL @ BKN,109,15,Regular Season
22017,1610612761,TOR,Toronto Raptors,0021700787,2018-02-04T00:00:00Z,TOR vs. MEM,101,15,1610612763,MEM,Memphis Grizzlies,MEM @ TOR,86,-15,Regular Season
22017,1610612752,NYK,New York Knicks,0021700786,2018-02-04T00:00:00Z,NYK vs. ATL,96,-3,1610612737,ATL,Atlanta Hawks,ATL @ NYK,99,3,Regular Season
22017,1610612760,OKC,Oklahoma City Thunder,0021700788,2018-02-04T00:00:00Z,OKC vs. LAL,104,-4,1610612747,LAL,Los Angeles Lakers,LAL @ OKC,108,4,Regular Season
22017,1610612756,PHX,Phoenix Suns,0021700789,2018-02-04T00:00:00Z,PHX vs. CHA,110,-5,1610612766,CHA,Charlotte Hornets,CHA @ PHX,115,5,Regular Season
22017,1610612738,BOS,Boston Celtics,0021700784,2018-02-04T00:00:00Z,BOS vs. POR,97,1,1610612757,POR,Portland Trail Blazers,POR @ BOS,96,-1,Regular Season
22017,1610612765,DET,Detroit Pistons,0021700790,2018-02-05T00:00:00Z,DET vs. POR,111,20,1610612757,POR,Portland Trail Blazers,POR @ DET,91,-20,Regular Season
22017,1610612748,MIA,Miami Heat,0021700792,2018-02-05T00:00:00Z,MIA vs. ORL,109,-2,1610612753,ORL,Orlando Magic,ORL @ MIA,111,2,Regular Season
22017,1610612746,LAC,LA Clippers,0021700796,2018-02-05T00:00:00Z,LAC vs. DAL,104,3,1610612742,DAL,Dallas Mavericks,DAL @ LAC,101,-3,Regular Season
22017,1610612743,DEN,Denver Nuggets,0021700794,2018-02-05T00:00:00Z,DEN vs. CHA,121,17,1610612766,CHA,Charlotte Hornets,CHA @ DEN,104,-17,Regular Season
22017,1610612758,SAC,Sacramento Kings,0021700795,2018-02-05T00:00:00Z,SAC vs. CHI,104,6,1610612741,CHI,Chicago Bulls,CHI @ SAC,98,-6,Regular Season
22017,1610612754,IND,Indiana Pacers,0021700791,2018-02-05T00:00:00Z,IND vs. WAS,102,-9,1610612764,WAS,Washington Wizards,WAS @ IND,111,9,Regular Season
22017,1610612740,NOP,New Orleans Pelicans,0021700793,2018-02-05T00:00:00Z,NOP vs. UTA,109,-24,1610612762,UTA,Utah Jazz,UTA @ NOP,133,24,Regular Season
22017,1610612753,ORL,Orlando Magic,0021700797,2018-02-06T00:00:00Z,ORL vs. CLE,116,18,1610612739,CLE,Cleveland Cavaliers,CLE @ ORL,98,-18,Regular Season
22017,1610612761,TOR,Toronto Raptors,0021700798,2018-02-06T00:00:00Z,TOR vs. BOS,111,20,1610612738,BOS,Boston Celtics,BOS @ TOR,91,-20,Regular Season
22017,1610612751,BKN,Brooklyn Nets,0021700800,2018-02-06T00:00:00Z,BKN vs. HOU,113,-10,1610612745,HOU,Houston Rockets,HOU @ BKN,123,10,Regular Season
22017,1610612755,PHI,Philadelphia 76ers,0021700802,2018-02-06T00:00:00Z,PHI vs. WAS,115,13,1610612764,WAS,Washington Wizards,WAS @ PHI,102,-13,Regular Season
22017,1610612747,LAL,Los Angeles Lakers,0021700804,2018-02-06T00:00:00Z,LAL vs. PHX,112,19,1610612756,PHX,Phoenix Suns,PHX @ LAL,93,-19,Regular Season
22017,1610612752,NYK,New York Knicks,0021700801,2018-02-06T00:00:00Z,NYK vs. MIL,89,-14,1610612749,MIL,Milwaukee Bucks,MIL @ NYK,103,14,Regular Season
22017,1610612744,GSW,Golden State Warriors,0021700803,2018-02-06T00:00:00Z,GSW vs. OKC,105,-20,1610612760,OKC,Oklahoma City Thunder,OKC @ GSW,125,20,Regular Season
22017,1610612737,ATL,Atlanta Hawks,0021700799,2018-02-06T00:00:00Z,ATL vs. MEM,108,26,1610612763,MEM,Memphis Grizzlies,MEM @ ATL,82,-26,Regular Season
22017,1610612763,MEM,Memphis Grizzlies,0021700808,2018-02-07T00:00:00Z,MEM vs. UTA,88,-4,1610612762,UTA,Utah Jazz,UTA @ MEM,92,4,Regular Season
22017,1610612765,DET,Detroit Pistons,0021700805,2018-02-07T00:00:00Z,DET vs. BKN,115,9,1610612751,BKN,Brooklyn Nets,BKN @ DET,106,-9,Regular Season
22017,1610612739,CLE,Cleveland Cavaliers,0021700807,2018-02-07T00:00:00Z,CLE vs. MIN,140,2,1610612750,MIN,Minnesota Timberwolves,MIN @ CLE,138,-2,Regular Season
22017,1610612748,MIA,Miami Heat,0021700806,2018-02-07T00:00:00Z,MIA vs. HOU,101,-8,1610612745,HOU,Houston Rockets,HOU @ MIA,109,8,Regular Season
22017,1610612756,PHX,Phoenix Suns,0021700810,2018-02-07T00:00:00Z,PHX vs. SAS,81,-48,1610612759,SAS,San Antonio Spurs,SAS @ PHX,129,48,Regular Season
22017,1610612744,GSW,Golden State Warriors,0021700815,2018-02-08T00:00:00Z,GSW vs. DAL,121,18,1610612742,DAL,Dallas Mavericks,DAL @ GSW,103,-18,Regular Season
22017,1610612761,TOR,Toronto Raptors,0021700812,2018-02-08T00:00:00Z,TOR vs. NYK,113,25,1610612752,NYK,New York Knicks,NYK @ TOR,88,-25,Regular Season
22017,1610612753,ORL,Orlando Magic,0021700811,2018-02-08T00:00:00Z,ORL vs. ATL,100,2,1610612737,ATL,Atlanta Hawks,ATL @ ORL,98,-2,Regular Season
22017,1610612757,POR,Portland Trail Blazers,0021700814,2018-02-08T00:00:00Z,POR vs. CHA,109,6,1610612766,CHA,Charlotte Hornets,CHA @ POR,103,-6,Regular Season
22017,1610612764,WAS,Washington Wizards,0021700813,2018-02-08T00:00:00Z,WAS vs. BOS,104,-6,1610612738,BOS,Boston Celtics,BOS @ WAS,110,6,Regular Season
22017,1610612747,LAL,Los Angeles Lakers,0021700816,2018-02-08T00:00:00Z,LAL vs. OKC,106,25,1610612760,OKC,Oklahoma City Thunder,OKC @ LAL,81,-25,Regular Season
22017,1610612745,HOU,Houston Rockets,0021700823,2018-02-09T00:00:00Z,HOU vs. DEN,130,26,1610612743,DEN,Denver Nuggets,DEN @ HOU,104,-26,Regular Season
22017,1610612765,DET,Detroit Pistons,0021700817,2018-02-09T00:00:00Z,DET vs. LAC,95,-13,1610612746,LAC,LA Clippers,LAC @ DET,108,13,Regular Season
22017,1610612755,PHI,Philadelphia 76ers,0021700818,2018-02-09T00:00:00Z,PHI vs. NOP,100,18,1610612740,NOP,New Orleans Pelicans,NOP @ PHI,82,-18,Regular Season
22017,1610612738,BOS,Boston Celtics,0021700820,2018-02-09T00:00:00Z,BOS vs. IND,91,-6,1610612754,IND,Indiana Pacers,IND @ BOS,97,6,Regular Season
22017,1610612737,ATL,Atlanta Hawks,0021700819,2018-02-09T00:00:00Z,ATL vs. CLE,107,-16,1610612739,CLE,Cleveland Cavaliers,CLE @ ATL,123,16,Regular Season
22017,1610612762,UTA,Utah Jazz,0021700824,2018-02-09T00:00:00Z,UTA vs. CHA,106,12,1610612766,CHA,Charlotte Hornets,CHA @ UTA,94,-12,Regular Season
22017,1610612741,CHI,Chicago Bulls,0021700822,2018-02-09T00:00:00Z,CHI vs. MIN,114,1,1610612750,MIN,Minnesota Timberwolves,MIN @ CHI,113,-1,Regular Season
22017,1610612748,MIA,Miami Heat,0021700821,2018-02-09T00:00:00Z,MIA vs. MIL,91,6,1610612749,MIL,Milwaukee Bucks,MIL @ MIA,85,-6,Regular Season
22017,1610612758,SAC,Sacramento Kings,0021700825,2018-02-09T00:00:00Z,SAC vs. POR,100,-18,1610612757,POR,Portland Trail Blazers,POR @ SAC,118,18,Regular Season
22017,1610612751,BKN,Brooklyn Nets,0021700826,2018-02-10T00:00:00Z,BKN vs. NOP,128,-10,1610612740,NOP,New Orleans Pelicans,NOP @ BKN,138,10,Regular Season
22017,1610612744,GSW,Golden State Warriors,0021700831,2018-02-10T00:00:00Z,GSW vs. SAS,122,17,1610612759,SAS,San Antonio Spurs,SAS @ GSW,105,-17,Regular Season
22017,1610612756,PHX,Phoenix Suns,0021700832,2018-02-10T00:00:00Z,PHX vs. DEN,113,-10,1610612743,DEN,Denver Nuggets,DEN @ PHX,123,10,Regular Season
22017,1610612742,DAL,Dallas Mavericks,0021700830,2018-02-10T00:00:00Z,DAL vs. LAL,130,7,1610612747,LAL,Los Angeles Lakers,LAL @ DAL,123,-7,Regular Season
22017,1610612741,CHI,Chicago Bulls,0021700829,2018-02-10T00:00:00Z,CHI vs. WAS,90,-11,1610612764,WAS,Washington Wizards,WAS @ CHI,101,11,Regular Season
22017,1610612755,PHI,Philadelphia 76ers,0021700828,2018-02-10T00:00:00Z,PHI vs. LAC,112,14,1610612746,LAC,LA Clippers,LAC @ PHI,98,-14,Regular Season
22017,1610612753,ORL,Orlando Magic,0021700827,2018-02-10T00:00:00Z,ORL vs. MIL,104,-7,1610612749,MIL,Milwaukee Bucks,MIL @ ORL,111,7,Regular Season
22017,1610612745,HOU,Houston Rockets,0021700837,2018-02-11T00:00:00Z,HOU vs. DAL,104,7,1610612742,DAL,Dallas Mavericks,DAL @ HOU,97,-7,Regular Season
22017,1610612750,MIN,Minnesota Timberwolves,0021700838,2018-02-11T00:00:00Z,MIN vs. SAC,111,5,1610612758,SAC,Sacramento Kings,SAC @ MIN,106,-5,Regular Season
22017,1610612754,IND,Indiana Pacers,0021700836,2018-02-11T00:00:00Z,IND vs. NYK,121,8,1610612752,NYK,New York Knicks,NYK @ IND,113,-8,Regular Season
22017,1610612760,OKC,Oklahoma City Thunder,0021700839,2018-02-11T00:00:00Z,OKC vs. MEM,110,18,1610612763,MEM,Memphis Grizzlies,MEM @ OKC,92,-18,Regular Season
22017,1610612738,BOS,Boston Celtics,0021700835,2018-02-11T00:00:00Z,BOS vs. CLE,99,-22,1610612739,CLE,Cleveland Cavaliers,CLE @ BOS,121,22,Regular Season
22017,1610612766,CHA,Charlotte Hornets,0021700833,2018-02-11T00:00:00Z,CHA vs. TOR,103,-20,1610612761,TOR,Toronto Raptors,TOR @ CHA,123,20,Regular Season
22017,1610612737,ATL,Atlanta Hawks,0021700834,2018-02-11T00:00:00Z,ATL vs. DET,118,3,1610612765,DET,Detroit Pistons,DET @ ATL,115,-3,Regular Season
22017,1610612757,POR,Portland Trail Blazers,0021700840,2018-02-11T00:00:00Z,POR vs. UTA,96,-19,1610612762,UTA,Utah Jazz,UTA @ POR,115,19,Regular Season
22017,1610612751,BKN,Brooklyn Nets,0021700843,2018-02-12T00:00:00Z,BKN vs. LAC,101,-13,1610612746,LAC,LA Clippers,LAC @ BKN,114,13,Regular Season
22017,1610612755,PHI,Philadelphia 76ers,0021700842,2018-02-12T00:00:00Z,PHI vs. NYK,108,16,1610612752,NYK,New York Knicks,NYK @ PHI,92,-16,Regular Season
22017,1610612741,CHI,Chicago Bulls,0021700844,2018-02-12T00:00:00Z,CHI vs. ORL,105,4,1610612753,ORL,Orlando Magic,ORL @ CHI,101,-4,Regular Season
22017,1610612744,GSW,Golden State Warriors,0021700846,2018-02-12T00:00:00Z,GSW vs. PHX,129,46,1610612756,PHX,Phoenix Suns,PHX @ GSW,83,-46,Regular Season
22017,1610612765,DET,Detroit Pistons,0021700841,2018-02-12T00:00:00Z,DET vs. NOP,103,-15,1610612740,NOP,New Orleans Pelicans,NOP @ DET,118,15,Regular Season
22017,1610612762,UTA,Utah Jazz,0021700845,2018-02-12T00:00:00Z,UTA vs. SAS,101,2,1610612759,SAS,San Antonio Spurs,SAS @ UTA,99,-2,Regular Season
22017,1610612749,MIL,Milwaukee Bucks,0021700848,2018-02-13T00:00:00Z,MIL vs. ATL,97,5,1610612737,ATL,Atlanta Hawks,ATL @ MIL,92,-5,Regular Season
22017,1610612761,TOR,Toronto Raptors,0021700847,2018-02-13T00:00:00Z,TOR vs. MIA,115,3,1610612748,MIA,Miami Heat,MIA @ TOR,112,-3,Regular Season
22017,1610612742,DAL,Dallas Mavericks,0021700851,2018-02-13T00:00:00Z,DAL vs. SAC,109,-5,1610612758,SAC,Sacramento Kings,SAC @ DAL,114,5,Regular Season
22017,1610612743,DEN,Denver Nuggets,0021700852,2018-02-13T00:00:00Z,DEN vs. SAS,117,8,1610612759,SAS,San Antonio Spurs,SAS @ DEN,109,-8,Regular Season
22017,1610612750,MIN,Minnesota Timberwolves,0021700849,2018-02-13T00:00:00Z,MIN vs. HOU,108,-18,1610612745,HOU,Houston Rockets,HOU @ MIN,126,18,Regular Season
22017,1610612760,OKC,Oklahoma City Thunder,0021700850,2018-02-13T00:00:00Z,OKC vs. CLE,112,-8,1610612739,CLE,Cleveland Cavaliers,CLE @ OKC,120,8,Regular Season
22017,1610612757,POR,Portland Trail Blazers,0021700864,2018-02-14T00:00:00Z,POR vs. GSW,123,6,1610612744,GSW,Golden State Warriors,GSW @ POR,117,-6,Regular Season
22017,1610612738,BOS,Boston Celtics,0021700858,2018-02-14T00:00:00Z,BOS vs. LAC,119,-10,1610612746,LAC,LA Clippers,LAC @ BOS,129,10,Regular Season
22017,1610612762,UTA,Utah Jazz,0021700863,2018-02-14T00:00:00Z,UTA vs. PHX,107,10,1610612756,PHX,Phoenix Suns,PHX @ UTA,97,-10,Regular Season
22017,1610612765,DET,Detroit Pistons,0021700853,2018-02-14T00:00:00Z,DET vs. ATL,104,6,1610612737,ATL,Atlanta Hawks,ATL @ DET,98,-6,Regular Season
22017,1610612745,HOU,Houston Rockets,0021700860,2018-02-14T00:00:00Z,HOU vs. SAC,100,9,1610612758,SAC,Sacramento Kings,SAC @ HOU,91,-9,Regular Season
22017,1610612763,MEM,Memphis Grizzlies,0021700861,2018-02-14T00:00:00Z,MEM vs. OKC,114,-7,1610612760,OKC,Oklahoma City Thunder,OKC @ MEM,121,7,Regular Season
22017,1610612741,CHI,Chicago Bulls,0021700859,2018-02-14T00:00:00Z,CHI vs. TOR,98,-24,1610612761,TOR,Toronto Raptors,TOR @ CHI,122,24,Regular Season
22017,1610612740,NOP,New Orleans Pelicans,0021700862,2018-02-14T00:00:00Z,NOP vs. LAL,139,22,1610612747,LAL,Los Angeles Lakers,LAL @ NOP,117,-22,Regular Season
22017,1610612752,NYK,New York Knicks,0021700857,2018-02-14T00:00:00Z,NYK vs. WAS,113,-5,1610612764,WAS,Washington Wizards,WAS @ NYK,118,5,Regular Season
22017,1610612755,PHI,Philadelphia 76ers,0021700855,2018-02-14T00:00:00Z,PHI vs. MIA,104,2,1610612748,MIA,Miami Heat,MIA @ PHI,102,-2,Regular Season
22017,1610612753,ORL,Orlando Magic,0021700854,2018-02-14T00:00:00Z,ORL vs. CHA,102,-2,1610612766,CHA,Charlotte Hornets,CHA @ ORL,104,2,Regular Season
22017,1610612751,BKN,Brooklyn Nets,0021700856,2018-02-14T00:00:00Z,BKN vs. IND,103,-5,1610612754,IND,Indiana Pacers,IND @ BKN,108,5,Regular Season
22017,1610612750,MIN,Minnesota Timberwolves,0021700866,2018-02-15T00:00:00Z,MIN vs. LAL,119,8,1610612747,LAL,Los Angeles Lakers,LAL @ MIN,111,-8,Regular Season
22017,1610612749,MIL,Milwaukee Bucks,0021700865,2018-02-15T00:00:00Z,MIL vs. DEN,123,-11,1610612743,DEN,Denver Nuggets,DEN @ MIL,134,11,Regular Season
22017,1610612753,ORL,Orlando Magic,0021700868,2018-02-22T00:00:00Z,ORL vs. NYK,113,-7,1610612752,NYK,New York Knicks,NYK @ ORL,120,7,Regular Season
22017,1610612744,GSW,Golden State Warriors,0021700872,2018-02-22T00:00:00Z,GSW vs. LAC,134,7,1610612746,LAC,LA Clippers,LAC @ GSW,127,-7,Regular Season
22017,1610612739,CLE,Cleveland Cavaliers,0021700869,2018-02-22T00:00:00Z,CLE vs. WAS,103,-7,1610612764,WAS,Washington Wizards,WAS @ CLE,110,7,Regular Season
22017,1610612758,SAC,Sacramento Kings,0021700871,2018-02-22T00:00:00Z,SAC vs. OKC,107,-3,1610612760,OKC,Oklahoma City Thunder,OKC @ SAC,110,3,Regular Season
22017,1610612766,CHA,Charlotte Hornets,0021700867,2018-02-22T00:00:00Z,CHA vs. BKN,111,15,1610612751,BKN,Brooklyn Nets,BKN @ CHA,96,-15,Regular Season
22017,1610612741,CHI,Chicago Bulls,0021700870,2018-02-22T00:00:00Z,CHI vs. PHI,115,-1,1610612755,PHI,Philadelphia 76ers,PHI @ CHI,116,1,Regular Season
22017,1610612745,HOU,Houston Rockets,0021700877,2018-02-23T00:00:00Z,HOU vs. MIN,120,18,1610612750,MIN,Minnesota Timberwolves,MIN @ HOU,102,-18,Regular Season
22017,1610612756,PHX,Phoenix Suns,0021700881,2018-02-23T00:00:00Z,PHX vs. LAC,117,-11,1610612746,LAC,LA Clippers,LAC @ PHX,128,11,Regular Season
22017,1610612764,WAS,Washington Wizards,0021700875,2018-02-23T00:00:00Z,WAS vs. CHA,105,-17,1610612766,CHA,Charlotte Hornets,CHA @ WAS,122,17,Regular Season
22017,1610612765,DET,Detroit Pistons,0021700873,2018-02-23T00:00:00Z,DET vs. BOS,98,-12,1610612738,BOS,Boston Celtics,BOS @ DET,110,12,Regular Season
22017,1610612762,UTA,Utah Jazz,0021700882,2018-02-23T00:00:00Z,UTA vs. POR,81,-19,1610612757,POR,Portland Trail Blazers,POR @ UTA,100,19,Regular Season
22017,1610612743,DEN,Denver Nuggets,0021700880,2018-02-23T00:00:00Z,DEN vs. SAS,122,3,1610612759,SAS,San Antonio Spurs,SAS @ DEN,119,-3,Regular Season
22017,1610612740,NOP,New Orleans Pelicans,0021700879,2018-02-23T00:00:00Z,NOP vs. MIA,124,1,1610612748,MIA,Miami Heat,MIA @ NOP,123,-1,Regular Season
22017,1610612754,IND,Indiana Pacers,0021700874,2018-02-23T00:00:00Z,IND vs. ATL,116,23,1610612737,ATL,Atlanta Hawks,ATL @ IND,93,-23,Regular Season
22017,1610612761,TOR,Toronto Raptors,0021700876,2018-02-23T00:00:00Z,TOR vs. MIL,119,-3,1610612749,MIL,Milwaukee Bucks,MIL @ TOR,122,3,Regular Season
22017,1610612763,MEM,Memphis Grizzlies,0021700878,2018-02-23T00:00:00Z,MEM vs. CLE,89,-23,1610612739,CLE,Cleveland Cavaliers,CLE @ MEM,112,23,Regular Season
22017,1610612747,LAL,Los Angeles Lakers,0021700883,2018-02-23T00:00:00Z,LAL vs. DAL,124,22,1610612742,DAL,Dallas Mavericks,DAL @ LAL,102,-22,Regular Season
22017,1610612756,PHX,Phoenix Suns,0021700889,2018-02-24T00:00:00Z,PHX vs. POR,104,-2,1610612757,POR,Portland Trail Blazers,POR @ PHX,106,2,Regular Season
22017,1610612752,NYK,New York Knicks,0021700886,2018-02-24T00:00:00Z,NYK vs. BOS,112,-9,1610612738,BOS,Boston Celtics,BOS @ NYK,121,9,Regular Season
22017,1610612744,GSW,Golden State Warriors,0021700887,2018-02-24T00:00:00Z,GSW vs. OKC,112,32,1610612760,OKC,Oklahoma City Thunder,OKC @ GSW,80,-32,Regular Season
22017,1610612755,PHI,Philadelphia 76ers,0021700884,2018-02-24T00:00:00Z,PHI vs. ORL,116,11,1610612753,ORL,Orlando Magic,ORL @ PHI,105,-11,Regular Season
22017,1610612758,SAC,Sacramento Kings,0021700891,2018-02-24T00:00:00Z,SAC vs. LAL,108,-5,1610612747,LAL,Los Angeles Lakers,LAL @ SAC,113,5,Regular Season
22017,1610612750,MIN,Minnesota Timberwolves,0021700888,2018-02-24T00:00:00Z,MIN vs. CHI,122,18,1610612741,CHI,Chicago Bulls,CHI @ MIN,104,-18,Regular Season
22017,1610612748,MIA,Miami Heat,0021700885,2018-02-24T00:00:00Z,MIA vs. MEM,115,26,1610612763,MEM,Memphis Grizzlies,MEM @ MIA,89,-26,Regular Season
22017,1610612762,UTA,Utah Jazz,0021700890,2018-02-24T00:00:00Z,UTA vs. DAL,97,7,1610612742,DAL,Dallas Mavericks,DAL @ UTA,90,-7,Regular Season
22017,1610612766,CHA,Charlotte Hornets,0021700892,2018-02-25T00:00:00Z,CHA vs. DET,114,16,1610612765,DET,Detroit Pistons,DET @ CHA,98,-16,Regular Season
22017,1610612764,WAS,Washington Wizards,0021700895,2018-02-25T00:00:00Z,WAS vs. PHI,109,15,1610612755,PHI,Philadelphia 76ers,PHI @ WAS,94,-15,Regular Season
22017,1610612739,CLE,Cleveland Cavaliers,0021700894,2018-02-25T00:00:00Z,CLE vs. SAS,94,-16,1610612759,SAS,San Antonio Spurs,SAS @ CLE,110,16,Regular Season
22017,1610612749,MIL,Milwaukee Bucks,0021700893,2018-02-25T00:00:00Z,MIL vs. NOP,121,-2,1610612740,NOP,New Orleans Pelicans,NOP @ MIL,123,2,Regular Season
22017,1610612743,DEN,Denver Nuggets,0021700896,2018-02-25T00:00:00Z,DEN vs. HOU,114,-5,1610612745,HOU,Houston Rockets,HOU @ DEN,119,5,Regular Season
22017,1610612761,TOR,Toronto Raptors,0021700901,2018-02-26T00:00:00Z,TOR vs. DET,123,29,1610612765,DET,Detroit Pistons,DET @ TOR,94,-29,Regular Season
22017,1610612751,BKN,Brooklyn Nets,0021700899,2018-02-26T00:00:00Z,BKN vs. CHI,104,17,1610612741,CHI,Chicago Bulls,CHI @ BKN,87,-17,Regular Season
22017,1610612738,BOS,Boston Celtics,0021700898,2018-02-26T00:00:00Z,BOS vs. MEM,109,11,1610612763,MEM,Memphis Grizzlies,MEM @ BOS,98,-11,Regular Season
22017,1610612737,ATL,Atlanta Hawks,0021700897,2018-02-26T00:00:00Z,ATL vs. LAL,104,-19,1610612747,LAL,Los Angeles Lakers,LAL @ ATL,123,19,Regular Season
22017,1610612742,DAL,Dallas Mavericks,0021700904,2018-02-26T00:00:00Z,DAL vs. IND,109,6,1610612754,IND,Indiana Pacers,IND @ DAL,103,-6,Regular Season
22017,1610612760,OKC,Oklahoma City Thunder,0021700903,2018-02-26T00:00:00Z,OKC vs. ORL,112,7,1610612753,ORL,Orlando Magic,ORL @ OKC,105,-7,Regular Season
22017,1610612752,NYK,New York Knicks,0021700900,2018-02-26T00:00:00Z,NYK vs. GSW,111,-14,1610612744,GSW,Golden State Warriors,GSW @ NYK,125,14,Regular Season
22017,1610612758,SAC,Sacramento Kings,0021700906,2018-02-26T00:00:00Z,SAC vs. MIN,100,-18,1610612750,MIN,Minnesota Timberwolves,MIN @ SAC,118,18,Regular Season
22017,1610612740,NOP,New Orleans Pelicans,0021700902,2018-02-26T00:00:00Z,NOP vs. PHX,125,9,1610612756,PHX,Phoenix Suns,PHX @ NOP,116,-9,Regular Season
22017,1610612762,UTA,Utah Jazz,0021700905,2018-02-26T00:00:00Z,UTA vs. HOU,85,-11,1610612745,HOU,Houston Rockets,HOU @ UTA,96,11,Regular Season
22017,1610612766,CHA,Charlotte Hornets,0021700907,2018-02-27T00:00:00Z,CHA vs. CHI,118,15,1610612741,CHI,Chicago Bulls,CHI @ CHA,103,-15,Regular Season
22017,1610612739,CLE,Cleveland Cavaliers,0021700908,2018-02-27T00:00:00Z,CLE vs. BKN,129,6,1610612751,BKN,Brooklyn Nets,BKN @ CLE,123,-6,Regular Season
22017,1610612749,MIL,Milwaukee Bucks,0021700910,2018-02-27T00:00:00Z,MIL vs. WAS,104,-3,1610612764,WAS,Washington Wizards,WAS @ MIL,107,3,Regular Season
22017,1610612757,POR,Portland Trail Blazers,0021700911,2018-02-27T00:00:00Z,POR vs. SAC,116,17,1610612758,SAC,Sacramento Kings,SAC @ POR,99,-17,Regular Season
22017,1610612748,MIA,Miami Heat,0021700909,2018-02-27T00:00:00Z,MIA vs. PHI,102,1,1610612755,PHI,Philadelphia 76ers,PHI @ MIA,101,-1,Regular Season
22017,1610612743,DEN,Denver Nuggets,0021700912,2018-02-27T00:00:00Z,DEN vs. LAC,120,-2,1610612746,LAC,LA Clippers,LAC @ DEN,122,2,Regular Season
22017,1610612737,ATL,Atlanta Hawks,0021700915,2018-02-28T00:00:00Z,ATL vs. IND,107,5,1610612754,IND,Indiana Pacers,IND @ ATL,102,-5,Regular Season
22017,1610612759,SAS,San Antonio Spurs,0021700920,2018-02-28T00:00:00Z,SAS vs. NOP,116,-5,1610612740,NOP,New Orleans Pelicans,NOP @ SAS,121,5,Regular Season
22017,1610612753,ORL,Orlando Magic,0021700914,2018-02-28T00:00:00Z,ORL vs. TOR,104,-13,1610612761,TOR,Toronto Raptors,TOR @ ORL,117,13,Regular Season
22017,1610612738,BOS,Boston Celtics,0021700916,2018-02-28T00:00:00Z,BOS vs. CHA,134,28,1610612766,CHA,Charlotte Hornets,CHA @ BOS,106,-28,Regular Season
22017,1610612746,LAC,LA Clippers,0021700921,2018-02-28T00:00:00Z,LAC vs. HOU,92,-13,1610612745,HOU,Houston Rockets,HOU @ LAC,105,13,Regular Season
22017,1610612765,DET,Detroit Pistons,0021700913,2018-02-28T00:00:00Z,DET vs. MIL,110,23,1610612749,MIL,Milwaukee Bucks,MIL @ DET,87,-23,Regular Season
22017,1610612763,MEM,Memphis Grizzlies,0021700918,2018-02-28T00:00:00Z,MEM vs. PHX,102,-8,1610612756,PHX,Phoenix Suns,PHX @ MEM,110,8,Regular Season
22017,1610612764,WAS,Washington Wizards,0021700917,2018-02-28T00:00:00Z,WAS vs. GSW,101,-8,1610612744,GSW,Golden State Warriors,GSW @ WAS,109,8,Regular Season
22017,1610612742,DAL,Dallas Mavericks,0021700919,2018-02-28T00:00:00Z,DAL vs. OKC,110,-1,1610612760,OKC,Oklahoma City Thunder,OKC @ DAL,111,1,Regular Season
22017,1610612739,CLE,Cleveland Cavaliers,0021700923,2018-03-01T00:00:00Z,CLE vs. PHI,97,-11,1610612755,PHI,Philadelphia 76ers,PHI @ CLE,108,11,Regular Season
22017,1610612757,POR,Portland Trail Blazers,0021700925,2018-03-01T00:00:00Z,POR vs. MIN,108,9,1610612750,MIN,Minnesota Timberwolves,MIN @ POR,99,-9,Regular Season
22017,1610612748,MIA,Miami Heat,0021700922,2018-03-01T00:00:00Z,MIA vs. LAL,113,-18,1610612747,LAL,Los Angeles Lakers,LAL @ MIA,131,18,Regular Season
22017,1610612758,SAC,Sacramento Kings,0021700924,2018-03-01T00:00:00Z,SAC vs. BKN,116,5,1610612751,BKN,Brooklyn Nets,BKN @ SAC,111,-5,Regular Season
22017,1610612755,PHI,Philadelphia 76ers,0021700927,2018-03-02T00:00:00Z,PHI vs. CHA,110,11,1610612766,CHA,Charlotte Hornets,CHA @ PHI,99,-11,Regular Season
22017,1610612763,MEM,Memphis Grizzlies,0021700931,2018-03-02T00:00:00Z,MEM vs. DEN,102,-6,1610612743,DEN,Denver Nuggets,DEN @ MEM,108,6,Regular Season
22017,1610612737,ATL,Atlanta Hawks,0021700928,2018-03-02T00:00:00Z,ATL vs. GSW,109,-5,1610612744,GSW,Golden State Warriors,GSW @ ATL,114,5,Regular Season
22017,1610612762,UTA,Utah Jazz,0021700934,2018-03-02T00:00:00Z,UTA vs. MIN,116,8,1610612750,MIN,Minnesota Timberwolves,MIN @ UTA,108,-8,Regular Season
22017,1610612746,LAC,LA Clippers,0021700935,2018-03-02T00:00:00Z,LAC vs. NYK,128,23,1610612752,NYK,New York Knicks,NYK @ LAC,105,-23,Regular Season
22017,1610612764,WAS,Washington Wizards,0021700929,2018-03-02T00:00:00Z,WAS vs. TOR,95,-7,1610612761,TOR,Toronto Raptors,TOR @ WAS,102,7,Regular Season
22017,1610612756,PHX,Phoenix Suns,0021700933,2018-03-02T00:00:00Z,PHX vs. OKC,116,-8,1610612760,OKC,Oklahoma City Thunder,OKC @ PHX,124,8,Regular Season
22017,1610612741,CHI,Chicago Bulls,0021700930,2018-03-02T00:00:00Z,CHI vs. DAL,108,8,1610612742,DAL,Dallas Mavericks,DAL @ CHI,100,-8,Regular Season
22017,1610612749,MIL,Milwaukee Bucks,0021700932,2018-03-02T00:00:00Z,MIL vs. IND,96,-7,1610612754,IND,Indiana Pacers,IND @ MIL,103,7,Regular Season
22017,1610612753,ORL,Orlando Magic,0021700926,2018-03-02T00:00:00Z,ORL vs. DET,115,9,1610612765,DET,Detroit Pistons,DET @ ORL,106,-9,Regular Season
22017,1610612748,MIA,Miami Heat,0021700938,2018-03-03T00:00:00Z,MIA vs. DET,105,9,1610612765,DET,Detroit Pistons,DET @ MIA,96,-9,Regular Season
22017,1610612739,CLE,Cleveland Cavaliers,0021700937,2018-03-03T00:00:00Z,CLE vs. DEN,117,-9,1610612743,DEN,Denver Nuggets,DEN @ CLE,126,9,Regular Season
22017,1610612753,ORL,Orlando Magic,0021700936,2018-03-03T00:00:00Z,ORL vs. MEM,107,7,1610612763,MEM,Memphis Grizzlies,MEM @ ORL,100,-7,Regular Season
22017,1610612745,HOU,Houston Rockets,0021700939,2018-03-03T00:00:00Z,HOU vs. BOS,123,3,1610612738,BOS,Boston Celtics,BOS @ HOU,120,-3,Regular Season
22017,1610612759,SAS,San Antonio Spurs,0021700940,2018-03-03T00:00:00Z,SAS vs. LAL,112,-4,1610612747,LAL,Los Angeles Lakers,LAL @ SAS,116,4,Regular Season
22017,1610612757,POR,Portland Trail Blazers,0021700941,2018-03-03T00:00:00Z,POR vs. OKC,108,8,1610612760,OKC,Oklahoma City Thunder,OKC @ POR,100,-8,Regular Season
22017,1610612758,SAC,Sacramento Kings,0021700942,2018-03-03T00:00:00Z,SAC vs. UTA,91,-7,1610612762,UTA,Utah Jazz,UTA @ SAC,98,7,Regular Season
22017,1610612764,WAS,Washington Wizards,0021700945,2018-03-04T00:00:00Z,WAS vs. IND,95,-3,1610612754,IND,Indiana Pacers,IND @ WAS,98,3,Regular Season
22017,1610612758,SAC,Sacramento Kings,0021700949,2018-03-04T00:00:00Z,SAC vs. NYK,102,3,1610612752,NYK,New York Knicks,NYK @ SAC,99,-3,Regular Season
22017,1610612749,MIL,Milwaukee Bucks,0021700947,2018-03-04T00:00:00Z,MIL vs. PHI,118,8,1610612755,PHI,Philadelphia 76ers,PHI @ MIL,110,-8,Regular Season
22017,1610612746,LAC,LA Clippers,0021700948,2018-03-04T00:00:00Z,LAC vs. BKN,123,3,1610612751,BKN,Brooklyn Nets,BKN @ LAC,120,-3,Regular Season
22017,1610612742,DAL,Dallas Mavericks,0021700946,2018-03-04T00:00:00Z,DAL vs. NOP,109,-17,1610612740,NOP,New Orleans Pelicans,NOP @ DAL,126,17,Regular Season
22017,1610612737,ATL,Atlanta Hawks,0021700943,2018-03-04T00:00:00Z,ATL vs. PHX,113,1,1610612756,PHX,Phoenix Suns,PHX @ ATL,112,-1,Regular Season
22017,1610612761,TOR,Toronto Raptors,0021700944,2018-03-04T00:00:00Z,TOR vs. CHA,103,5,1610612766,CHA,Charlotte Hornets,CHA @ TOR,98,-5,Regular Season
22017,1610612741,CHI,Chicago Bulls,0021700953,2018-03-05T00:00:00Z,CHI vs. BOS,89,-16,1610612738,BOS,Boston Celtics,BOS @ CHI,105,16,Regular Season
22017,1610612754,IND,Indiana Pacers,0021700951,2018-03-05T00:00:00Z,IND vs. MIL,92,3,1610612749,MIL,Milwaukee Bucks,MIL @ IND,89,-3,Regular Season
22017,1610612762,UTA,Utah Jazz,0021700955,2018-03-05T00:00:00Z,UTA vs. ORL,94,14,1610612753,ORL,Orlando Magic,ORL @ UTA,80,-14,Regular Season
22017,1610612748,MIA,Miami Heat,0021700952,2018-03-05T00:00:00Z,MIA vs. PHX,125,22,1610612756,PHX,Phoenix Suns,PHX @ MIA,103,-22,Regular Season
22017,1610612759,SAS,San Antonio Spurs,0021700954,2018-03-05T00:00:00Z,SAS vs. MEM,100,2,1610612763,MEM,Memphis Grizzlies,MEM @ SAS,98,-2,Regular Season
22017,1610612747,LAL,Los Angeles Lakers,0021700956,2018-03-05T00:00:00Z,LAL vs. POR,103,-5,1610612757,POR,Portland Trail Blazers,POR @ LAL,108,5,Regular Season
22017,1610612739,CLE,Cleveland Cavaliers,0021700950,2018-03-05T00:00:00Z,CLE vs. DET,112,22,1610612765,DET,Detroit Pistons,DET @ CLE,90,-22,Regular Season
22017,1610612764,WAS,Washington Wizards,0021700959,2018-03-06T00:00:00Z,WAS vs. MIA,117,4,1610612748,MIA,Miami Heat,MIA @ WAS,113,-4,Regular Season
22017,1610612760,OKC,Oklahoma City Thunder,0021700960,2018-03-06T00:00:00Z,OKC vs. HOU,112,-10,1610612745,HOU,Houston Rockets,HOU @ OKC,122,10,Regular Season
22017,1610612744,GSW,Golden State Warriors,0021700963,2018-03-06T00:00:00Z,GSW vs. BKN,114,13,1610612751,BKN,Brooklyn Nets,BKN @ GSW,101,-13,Regular Season
22017,1610612761,TOR,Toronto Raptors,0021700958,2018-03-06T00:00:00Z,TOR vs. ATL,106,16,1610612737,ATL,Atlanta Hawks,ATL @ TOR,90,-16,Regular Season
22017,1610612742,DAL,Dallas Mavericks,0021700961,2018-03-06T00:00:00Z,DAL vs. DEN,118,11,1610612743,DEN,Denver Nuggets,DEN @ DAL,107,-11,Regular Season
22017,1610612757,POR,Portland Trail Blazers,0021700962,2018-03-06T00:00:00Z,POR vs. NYK,111,24,1610612752,NYK,New York Knicks,NYK @ POR,87,-24,Regular Season
22017,1610612766,CHA,Charlotte Hornets,0021700957,2018-03-06T00:00:00Z,CHA vs. PHI,114,-14,1610612755,PHI,Philadelphia 76ers,PHI @ CHA,128,14,Regular Season
22017,1610612746,LAC,LA Clippers,0021700964,2018-03-06T00:00:00Z,LAC vs. NOP,116,-5,1610612740,NOP,New Orleans Pelicans,NOP @ LAC,121,5,Regular Season
22017,1610612743,DEN,Denver Nuggets,0021700970,2018-03-07T00:00:00Z,DEN vs. CLE,108,-5,1610612739,CLE,Cleveland Cavaliers,CLE @ DEN,113,5,Regular Season
22017,1610612754,IND,Indiana Pacers,0021700965,2018-03-07T00:00:00Z,IND vs. UTA,84,-20,1610612762,UTA,Utah Jazz,UTA @ IND,104,20,Regular Season
22017,1610612741,CHI,Chicago Bulls,0021700967,2018-03-07T00:00:00Z,CHI vs. MEM,119,9,1610612763,MEM,Memphis Grizzlies,MEM @ CHI,110,-9,Regular Season
22017,1610612765,DET,Detroit Pistons,0021700966,2018-03-07T00:00:00Z,DET vs. TOR,119,-2,1610612761,TOR,Toronto Raptors,TOR @ DET,121,2,Regular Season
22017,1610612749,MIL,Milwaukee Bucks,0021700968,2018-03-07T00:00:00Z,MIL vs. HOU,99,-11,1610612745,HOU,Houston Rockets,HOU @ MIL,110,11,Regular Season
22017,1610612747,LAL,Los Angeles Lakers,0021700971,2018-03-07T00:00:00Z,LAL vs. ORL,108,1,1610612753,ORL,Orlando Magic,ORL @ LAL,107,-1,Regular Season
22017,1610612758,SAC,Sacramento Kings,0021700969,2018-03-07T00:00:00Z,SAC vs. NOP,101,-13,1610612740,NOP,New Orleans Pelicans,NOP @ SAC,114,13,Regular Season
22017,1610612766,CHA,Charlotte Hornets,0021700972,2018-03-08T00:00:00Z,CHA vs. BKN,111,-14,1610612751,BKN,Brooklyn Nets,BKN @ CHA,125,14,Regular Season
22017,1610612744,GSW,Golden State Warriors,0021700976,2018-03-08T00:00:00Z,GSW vs. SAS,110,3,1610612759,SAS,San Antonio Spurs,SAS @ GSW,107,-3,Regular Season
22017,1610612748,MIA,Miami Heat,0021700973,2018-03-08T00:00:00Z,MIA vs. PHI,108,9,1610612755,PHI,Philadelphia 76ers,PHI @ MIA,99,-9,Regular Season
22017,1610612760,OKC,Oklahoma City Thunder,0021700975,2018-03-08T00:00:00Z,OKC vs. PHX,115,28,1610612756,PHX,Phoenix Suns,PHX @ OKC,87,-28,Regular Season
22017,1610612750,MIN,Minnesota Timberwolves,0021700974,2018-03-08T00:00:00Z,MIN vs. BOS,109,-8,1610612738,BOS,Boston Celtics,BOS @ MIN,117,8,Regular Season
22017,1610612754,IND,Indiana Pacers,0021700978,2018-03-09T00:00:00Z,IND vs. ATL,112,25,1610612737,ATL,Atlanta Hawks,ATL @ IND,87,-25,Regular Season
22017,1610612740,NOP,New Orleans Pelicans,0021700982,2018-03-09T00:00:00Z,NOP vs. WAS,97,-19,1610612764,WAS,Washington Wizards,WAS @ NOP,116,19,Regular Season
22017,1610612757,POR,Portland Trail Blazers,0021700984,2018-03-09T00:00:00Z,POR vs. GSW,125,17,1610612744,GSW,Golden State Warriors,GSW @ POR,108,-17,Regular Season
22017,1610612765,DET,Detroit Pistons,0021700977,2018-03-09T00:00:00Z,DET vs. CHI,99,16,1610612741,CHI,Chicago Bulls,CHI @ DET,83,-16,Regular Season
22017,1610612763,MEM,Memphis Grizzlies,0021700980,2018-03-09T00:00:00Z,MEM vs. UTA,78,-17,1610612762,UTA,Utah Jazz,UTA @ MEM,95,17,Regular Season
22017,1610612746,LAC,LA Clippers,0021700986,2018-03-09T00:00:00Z,LAC vs. CLE,116,14,1610612739,CLE,Cleveland Cavaliers,CLE @ LAC,102,-14,Regular Season
22017,1610612743,DEN,Denver Nuggets,0021700983,2018-03-09T00:00:00Z,DEN vs. LAL,125,9,1610612747,LAL,Los Angeles Lakers,LAL @ DEN,116,-9,Regular Season
22017,1610612749,MIL,Milwaukee Bucks,0021700981,2018-03-09T00:00:00Z,MIL vs. NYK,120,8,1610612752,NYK,New York Knicks,NYK @ MIL,112,-8,Regular Season
22017,1610612761,TOR,Toronto Raptors,0021700979,2018-03-09T00:00:00Z,TOR vs. HOU,108,3,1610612745,HOU,Houston Rockets,HOU @ TOR,105,-3,Regular Season
22017,1610612758,SAC,Sacramento Kings,0021700985,2018-03-09T00:00:00Z,SAC vs. ORL,94,6,1610612753,ORL,Orlando Magic,ORL @ SAC,88,-6,Regular Season
22017,1610612746,LAC,LA Clippers,0021700991,2018-03-10T00:00:00Z,LAC vs. ORL,113,8,1610612753,ORL,Orlando Magic,ORL @ LAC,105,-8,Regular Season
22017,1610612742,DAL,Dallas Mavericks,0021700989,2018-03-10T00:00:00Z,DAL vs. MEM,114,34,1610612763,MEM,Memphis Grizzlies,MEM @ DAL,80,-34,Regular Season
22017,1610612766,CHA,Charlotte Hornets,0021700987,2018-03-10T00:00:00Z,CHA vs. PHX,122,7,1610612756,PHX,Phoenix Suns,PHX @ CHA,115,-7,Regular Season
22017,1610612748,MIA,Miami Heat,0021700988,2018-03-10T00:00:00Z,MIA vs. WAS,129,27,1610612764,WAS,Washington Wizards,WAS @ MIA,102,-27,Regular Season
22017,1610612760,OKC,Oklahoma City Thunder,0021700990,2018-03-10T00:00:00Z,OKC vs. SAS,104,10,1610612759,SAS,San Antonio Spurs,SAS @ OKC,94,-10,Regular Season
22017,1610612752,NYK,New York Knicks,0021700992,2018-03-11T00:00:00Z,NYK vs. TOR,106,-26,1610612761,TOR,Toronto Raptors,TOR @ NYK,132,26,Regular Season
22017,1610612738,BOS,Boston Celtics,0021700998,2018-03-11T00:00:00Z,BOS vs. IND,97,-2,1610612754,IND,Indiana Pacers,IND @ BOS,99,2,Regular Season
22017,1610612742,DAL,Dallas Mavericks,0021700997,2018-03-11T00:00:00Z,DAL vs. HOU,82,-23,1610612745,HOU,Houston Rockets,HOU @ DAL,105,23,Regular Season
22017,1610612743,DEN,Denver Nuggets,0021700996,2018-03-11T00:00:00Z,DEN vs. SAC,130,26,1610612758,SAC,Sacramento Kings,SAC @ DEN,104,-26,Regular Season
22017,1610612740,NOP,New Orleans Pelicans,0021700995,2018-03-11T00:00:00Z,NOP vs. UTA,99,-17,1610612762,UTA,Utah Jazz,UTA @ NOP,116,17,Regular Season
22017,1610612747,LAL,Los Angeles Lakers,0021701000,2018-03-11T00:00:00Z,LAL vs. CLE,127,14,1610612739,CLE,Cleveland Cavaliers,CLE @ LAL,113,-14,Regular Season
22017,1610612751,BKN,Brooklyn Nets,0021700999,2018-03-11T00:00:00Z,BKN vs. PHI,97,-23,1610612755,PHI,Philadelphia 76ers,PHI @ BKN,120,23,Regular Season
22017,1610612750,MIN,Minnesota Timberwolves,0021700994,2018-03-11T00:00:00Z,MIN vs. GSW,109,6,1610612744,GSW,Golden State Warriors,GSW @ MIN,103,-6,Regular Season
22017,1610612737,ATL,Atlanta Hawks,0021700993,2018-03-11T00:00:00Z,ATL vs. CHI,122,-7,1610612741,CHI,Chicago Bulls,CHI @ ATL,129,7,Regular Season
22017,1610612745,HOU,Houston Rockets,0021701001,2018-03-12T00:00:00Z,HOU vs. SAS,109,16,1610612759,SAS,San Antonio Spurs,SAS @ HOU,93,-16,Regular Season
22017,1610612760,OKC,Oklahoma City Thunder,0021701003,2018-03-12T00:00:00Z,OKC vs. SAC,106,5,1610612758,SAC,Sacramento Kings,SAC @ OKC,101,-5,Regular Season
22017,1610612757,POR,Portland Trail Blazers,0021701004,2018-03-12T00:00:00Z,POR vs. MIA,115,16,1610612748,MIA,Miami Heat,MIA @ POR,99,-16,Regular Season
22017,1610612763,MEM,Memphis Grizzlies,0021701002,2018-03-12T00:00:00Z,MEM vs. MIL,103,-18,1610612749,MIL,Milwaukee Bucks,MIL @ MEM,121,18,Regular Season
22017,1610612759,SAS,San Antonio Spurs,0021701012,2018-03-13T00:00:00Z,SAS vs. ORL,108,36,1610612753,ORL,Orlando Magic,ORL @ SAS,72,-36,Regular Season
22017,1610612737,ATL,Atlanta Hawks,0021701007,2018-03-13T00:00:00Z,ATL vs. OKC,107,-12,1610612760,OKC,Oklahoma City Thunder,OKC @ ATL,119,12,Regular Season
22017,1610612740,NOP,New Orleans Pelicans,0021701011,2018-03-13T00:00:00Z,NOP vs. CHA,119,4,1610612766,CHA,Charlotte Hornets,CHA @ NOP,115,-4,Regular Season
22017,1610612752,NYK,New York Knicks,0021701009,2018-03-13T00:00:00Z,NYK vs. DAL,97,-13,1610612742,DAL,Dallas Mavericks,DAL @ NYK,110,13,Regular Season
22017,1610612764,WAS,Washington Wizards,0021701006,2018-03-13T00:00:00Z,WAS vs. MIN,111,-5,1610612750,MIN,Minnesota Timberwolves,MIN @ WAS,116,5,Regular Season
22017,1610612741,CHI,Chicago Bulls,0021701010,2018-03-13T00:00:00Z,CHI vs. LAC,106,-6,1610612746,LAC,LA Clippers,LAC @ CHI,112,6,Regular Season
22017,1610612756,PHX,Phoenix Suns,0021701014,2018-03-13T00:00:00Z,PHX vs. CLE,107,-22,1610612739,CLE,Cleveland Cavaliers,CLE @ PHX,129,22,Regular Season
22017,1610612762,UTA,Utah Jazz,0021701013,2018-03-13T00:00:00Z,UTA vs. DET,110,31,1610612765,DET,Detroit Pistons,DET @ UTA,79,-31,Regular Season
22017,1610612755,PHI,Philadelphia 76ers,0021701005,2018-03-13T00:00:00Z,PHI vs. IND,98,-3,1610612754,IND,Indiana Pacers,IND @ PHI,101,3,Regular Season
22017,1610612747,LAL,Los Angeles Lakers,0021701015,2018-03-13T00:00:00Z,LAL vs. DEN,112,9,1610612743,DEN,Denver Nuggets,DEN @ LAL,103,-9,Regular Season
22017,1610612751,BKN,Brooklyn Nets,0021701008,2018-03-13T00:00:00Z,BKN vs. TOR,102,-14,1610612761,TOR,Toronto Raptors,TOR @ BKN,116,14,Regular Season
22017,1610612738,BOS,Boston Celtics,0021701017,2018-03-14T00:00:00Z,BOS vs. WAS,124,-1,1610612764,WAS,Washington Wizards,WAS @ BOS,125,1,Regular Season
22017,1610612758,SAC,Sacramento Kings,0021701018,2018-03-14T00:00:00Z,SAC vs. MIA,123,4,1610612748,MIA,Miami Heat,MIA @ SAC,119,-4,Regular Season
22017,1610612744,GSW,Golden State Warriors,0021701019,2018-03-14T00:00:00Z,GSW vs. LAL,117,11,1610612747,LAL,Los Angeles Lakers,LAL @ GSW,106,-11,Regular Season
22017,1610612753,ORL,Orlando Magic,0021701016,2018-03-14T00:00:00Z,ORL vs. MIL,126,9,1610612749,MIL,Milwaukee Bucks,MIL @ ORL,117,-9,Regular Season
22017,1610612737,ATL,Atlanta Hawks,0021701021,2018-03-15T00:00:00Z,ATL vs. CHA,117,-12,1610612766,CHA,Charlotte Hornets,CHA @ ATL,129,12,Regular Season
22017,1610612759,SAS,San Antonio Spurs,0021701025,2018-03-15T00:00:00Z,SAS vs. NOP,98,5,1610612740,NOP,New Orleans Pelicans,NOP @ SAS,93,-5,Regular Season
22017,1610612762,UTA,Utah Jazz,0021701027,2018-03-15T00:00:00Z,UTA vs. PHX,116,28,1610612756,PHX,Phoenix Suns,PHX @ UTA,88,-28,Regular Season
22017,1610612743,DEN,Denver Nuggets,0021701026,2018-03-15T00:00:00Z,DEN vs. DET,120,7,1610612765,DET,Detroit Pistons,DET @ DEN,113,-7,Regular Season
22017,1610612754,IND,Indiana Pacers,0021701020,2018-03-15T00:00:00Z,IND vs. TOR,99,-7,1610612761,TOR,Toronto Raptors,TOR @ IND,106,7,Regular Season
22017,1610612757,POR,Portland Trail Blazers,0021701028,2018-03-15T00:00:00Z,POR vs. CLE,113,8,1610612739,CLE,Cleveland Cavaliers,CLE @ POR,105,-8,Regular Season
22017,1610612745,HOU,Houston Rockets,0021701023,2018-03-15T00:00:00Z,HOU vs. LAC,101,5,1610612746,LAC,LA Clippers,LAC @ HOU,96,-5,Regular Season
22017,1610612752,NYK,New York Knicks,0021701022,2018-03-15T00:00:00Z,NYK vs. PHI,110,-8,1610612755,PHI,Philadelphia 76ers,PHI @ NYK,118,8,Regular Season
22017,1610612763,MEM,Memphis Grizzlies,0021701024,2018-03-15T00:00:00Z,MEM vs. CHI,110,-1,1610612741,CHI,Chicago Bulls,CHI @ MEM,111,1,Regular Season
22017,1610612747,LAL,Los Angeles Lakers,0021701034,2018-03-16T00:00:00Z,LAL vs. MIA,91,-1,1610612748,MIA,Miami Heat,MIA @ LAL,92,1,Regular Season
22017,1610612753,ORL,Orlando Magic,0021701029,2018-03-16T00:00:00Z,ORL vs. BOS,83,-9,1610612738,BOS,Boston Celtics,BOS @ ORL,92,9,Regular Season
22017,1610612761,TOR,Toronto Raptors,0021701031,2018-03-16T00:00:00Z,TOR vs. DAL,122,7,1610612742,DAL,Dallas Mavericks,DAL @ TOR,115,-7,Regular Season
22017,1610612755,PHI,Philadelphia 76ers,0021701030,2018-03-16T00:00:00Z,PHI vs. BKN,120,4,1610612751,BKN,Brooklyn Nets,BKN @ PHI,116,-4,Regular Season
22017,1610612744,GSW,Golden State Warriors,0021701033,2018-03-16T00:00:00Z,GSW vs. SAC,93,-5,1610612758,SAC,Sacramento Kings,SAC @ GSW,98,5,Regular Season
22017,1610612760,OKC,Oklahoma City Thunder,0021701032,2018-03-16T00:00:00Z,OKC vs. LAC,121,8,1610612746,LAC,LA Clippers,LAC @ OKC,113,-8,Regular Season
22017,1610612740,NOP,New Orleans Pelicans,0021701036,2018-03-17T00:00:00Z,NOP vs. HOU,101,-6,1610612745,HOU,Houston Rockets,HOU @ NOP,107,6,Regular Season
22017,1610612751,BKN,Brooklyn Nets,0021701037,2018-03-17T00:00:00Z,BKN vs. DAL,114,8,1610612742,DAL,Dallas Mavericks,DAL @ BKN,106,-8,Regular Season
22017,1610612756,PHX,Phoenix Suns,0021701044,2018-03-17T00:00:00Z,PHX vs. GSW,109,-15,1610612744,GSW,Golden State Warriors,GSW @ PHX,124,15,Regular Season
22017,1610612749,MIL,Milwaukee Bucks,0021701041,2018-03-17T00:00:00Z,MIL vs. ATL,122,5,1610612737,ATL,Atlanta Hawks,ATL @ MIL,117,-5,Regular Season
22017,1610612759,SAS,San Antonio Spurs,0021701042,2018-03-17T00:00:00Z,SAS vs. MIN,117,16,1610612750,MIN,Minnesota Timberwolves,MIN @ SAS,101,-16,Regular Season
22017,1610612752,NYK,New York Knicks,0021701038,2018-03-17T00:00:00Z,NYK vs. CHA,124,23,1610612766,CHA,Charlotte Hornets,CHA @ NYK,101,-23,Regular Season
22017,1610612762,UTA,Utah Jazz,0021701043,2018-03-17T00:00:00Z,UTA vs. SAC,103,6,1610612758,SAC,Sacramento Kings,SAC @ UTA,97,-6,Regular Season
22017,1610612757,POR,Portland Trail Blazers,0021701045,2018-03-17T00:00:00Z,POR vs. DET,100,13,1610612765,DET,Detroit Pistons,DET @ POR,87,-13,Regular Season
22017,1610612763,MEM,Memphis Grizzlies,0021701040,2018-03-17T00:00:00Z,MEM vs. DEN,101,7,1610612743,DEN,Denver Nuggets,DEN @ MEM,94,-7,Regular Season
22017,1610612741,CHI,Chicago Bulls,0021701039,2018-03-17T00:00:00Z,CHI vs. CLE,109,-5,1610612739,CLE,Cleveland Cavaliers,CLE @ CHI,114,5,Regular Season
22017,1610612764,WAS,Washington Wizards,0021701035,2018-03-17T00:00:00Z,WAS vs. IND,109,7,1610612754,IND,Indiana Pacers,IND @ WAS,102,-7,Regular Season
22017,1610612740,NOP,New Orleans Pelicans,0021701047,2018-03-18T00:00:00Z,NOP vs. BOS,108,19,1610612738,BOS,Boston Celtics,BOS @ NOP,89,-19,Regular Season
22017,1610612761,TOR,Toronto Raptors,0021701046,2018-03-18T00:00:00Z,TOR vs. OKC,125,-7,1610612760,OKC,Oklahoma City Thunder,OKC @ TOR,132,7,Regular Season
22017,1610612750,MIN,Minnesota Timberwolves,0021701048,2018-03-18T00:00:00Z,MIN vs. HOU,120,-9,1610612745,HOU,Houston Rockets,HOU @ MIN,129,9,Regular Season
22017,1610612746,LAC,LA Clippers,0021701049,2018-03-18T00:00:00Z,LAC vs. POR,109,-13,1610612757,POR,Portland Trail Blazers,POR @ LAC,122,13,Regular Season
22017,1610612751,BKN,Brooklyn Nets,0021701053,2018-03-19T00:00:00Z,BKN vs. MEM,118,3,1610612763,MEM,Memphis Grizzlies,MEM @ BKN,115,-3,Regular Season
22017,1610612748,MIA,Miami Heat,0021701054,2018-03-19T00:00:00Z,MIA vs. DEN,149,8,1610612743,DEN,Denver Nuggets,DEN @ MIA,141,-8,Regular Season
22017,1610612759,SAS,San Antonio Spurs,0021701056,2018-03-19T00:00:00Z,SAS vs. GSW,89,14,1610612744,GSW,Golden State Warriors,GSW @ SAS,75,-14,Regular Season
22017,1610612755,PHI,Philadelphia 76ers,0021701052,2018-03-19T00:00:00Z,PHI vs. CHA,108,14,1610612766,CHA,Charlotte Hornets,CHA @ PHI,94,-14,Regular Season
22017,1610612758,SAC,Sacramento Kings,0021701057,2018-03-19T00:00:00Z,SAC vs. DET,90,-16,1610612765,DET,Detroit Pistons,DET @ SAC,106,16,Regular Season
22017,1610612752,NYK,New York Knicks,0021701055,2018-03-19T00:00:00Z,NYK vs. CHI,110,18,1610612741,CHI,Chicago Bulls,CHI @ NYK,92,-18,Regular Season
22017,1610612739,CLE,Cleveland Cavaliers,0021701050,2018-03-19T00:00:00Z,CLE vs. MIL,124,7,1610612749,MIL,Milwaukee Bucks,MIL @ CLE,117,-7,Regular Season
22017,1610612754,IND,Indiana Pacers,0021701051,2018-03-19T00:00:00Z,IND vs. LAL,110,10,1610612747,LAL,Los Angeles Lakers,LAL @ IND,100,-10,Regular Season
22017,1610612750,MIN,Minnesota Timberwolves,0021701060,2018-03-20T00:00:00Z,MIN vs. LAC,123,14,1610612746,LAC,LA Clippers,LAC @ MIN,109,-14,Regular Season
22017,1610612756,PHX,Phoenix Suns,0021701063,2018-03-20T00:00:00Z,PHX vs. DET,88,-27,1610612765,DET,Detroit Pistons,DET @ PHX,115,27,Regular Season
22017,1610612753,ORL,Orlando Magic,0021701058,2018-03-20T00:00:00Z,ORL vs. TOR,86,-7,1610612761,TOR,Toronto Raptors,TOR @ ORL,93,7,Regular Season
22017,1610612740,NOP,New Orleans Pelicans,0021701061,2018-03-20T00:00:00Z,NOP vs. DAL,115,10,1610612742,DAL,Dallas Mavericks,DAL @ NOP,105,-10,Regular Season
22017,1610612762,UTA,Utah Jazz,0021701062,2018-03-20T00:00:00Z,UTA vs. ATL,94,-5,1610612737,ATL,Atlanta Hawks,ATL @ UTA,99,5,Regular Season
22017,1610612757,POR,Portland Trail Blazers,0021701064,2018-03-20T00:00:00Z,POR vs. HOU,111,-4,1610612745,HOU,Houston Rockets,HOU @ POR,115,4,Regular Season
22017,1610612738,BOS,Boston Celtics,0021701059,2018-03-20T00:00:00Z,BOS vs. OKC,100,1,1610612760,OKC,Oklahoma City Thunder,OKC @ BOS,99,-1,Regular Season
22017,1610612755,PHI,Philadelphia 76ers,0021701066,2018-03-21T00:00:00Z,PHI vs. MEM,119,14,1610612763,MEM,Memphis Grizzlies,MEM @ PHI,105,-14,Regular Season
22017,1610612740,NOP,New Orleans Pelicans,0021700809,2018-03-21T00:00:00Z,NOP vs. IND,96,4,1610612754,IND,Indiana Pacers,IND @ NOP,92,-4,Regular Season
22017,1610612739,CLE,Cleveland Cavaliers,0021701065,2018-03-21T00:00:00Z,CLE vs. TOR,132,3,1610612761,TOR,Toronto Raptors,TOR @ CLE,129,-3,Regular Season
22017,1610612741,CHI,Chicago Bulls,0021701069,2018-03-21T00:00:00Z,CHI vs. DEN,102,-33,1610612743,DEN,Denver Nuggets,DEN @ CHI,135,33,Regular Season
22017,1610612749,MIL,Milwaukee Bucks,0021701070,2018-03-21T00:00:00Z,MIL vs. LAC,120,-7,1610612746,LAC,LA Clippers,LAC @ MIL,127,7,Regular Season
22017,1610612748,MIA,Miami Heat,0021701068,2018-03-21T00:00:00Z,MIA vs. NYK,119,21,1610612752,NYK,New York Knicks,NYK @ MIA,98,-21,Regular Season
22017,1610612751,BKN,Brooklyn Nets,0021701067,2018-03-21T00:00:00Z,BKN vs. CHA,105,-6,1610612766,CHA,Charlotte Hornets,CHA @ BKN,111,6,Regular Season
22017,1610612759,SAS,San Antonio Spurs,0021701071,2018-03-21T00:00:00Z,SAS vs. WAS,98,8,1610612764,WAS,Washington Wizards,WAS @ SAS,90,-8,Regular Season
22017,1610612766,CHA,Charlotte Hornets,0021701072,2018-03-22T00:00:00Z,CHA vs. MEM,140,61,1610612763,MEM,Memphis Grizzlies,MEM @ CHA,79,-61,Regular Season
22017,1610612745,HOU,Houston Rockets,0021701074,2018-03-22T00:00:00Z,HOU vs. DET,100,4,1610612765,DET,Detroit Pistons,DET @ HOU,96,-4,Regular Season
22017,1610612758,SAC,Sacramento Kings,0021701077,2018-03-22T00:00:00Z,SAC vs. ATL,105,15,1610612737,ATL,Atlanta Hawks,ATL @ SAC,90,-15,Regular Season
22017,1610612742,DAL,Dallas Mavericks,0021701076,2018-03-22T00:00:00Z,DAL vs. UTA,112,-7,1610612762,UTA,Utah Jazz,UTA @ DAL,119,7,Regular Season
22017,1610612740,NOP,New Orleans Pelicans,0021701075,2018-03-22T00:00:00Z,NOP vs. LAL,128,3,1610612747,LAL,Los Angeles Lakers,LAL @ NOP,125,-3,Regular Season
22017,1610612753,ORL,Orlando Magic,0021701073,2018-03-22T00:00:00Z,ORL vs. PHI,98,-20,1610612755,PHI,Philadelphia 76ers,PHI @ ORL,118,20,Regular Season
22017,1610612760,OKC,Oklahoma City Thunder,0021701084,2018-03-23T00:00:00Z,OKC vs. MIA,105,6,1610612748,MIA,Miami Heat,MIA @ OKC,99,-6,Regular Season
22017,1610612757,POR,Portland Trail Blazers,0021701086,2018-03-23T00:00:00Z,POR vs. BOS,100,-5,1610612738,BOS,Boston Celtics,BOS @ POR,105,5,Regular Season
22017,1610612754,IND,Indiana Pacers,0021701078,2018-03-23T00:00:00Z,IND vs. LAC,109,5,1610612746,LAC,LA Clippers,LAC @ IND,104,-5,Regular Season
22017,1610612764,WAS,Washington Wizards,0021701079,2018-03-23T00:00:00Z,WAS vs. DEN,100,-8,1610612743,DEN,Denver Nuggets,DEN @ WAS,108,8,Regular Season
22017,1610612752,NYK,New York Knicks,0021701081,2018-03-23T00:00:00Z,NYK vs. MIN,104,-4,1610612750,MIN,Minnesota Timberwolves,MIN @ NYK,108,4,Regular Season
22017,1610612744,GSW,Golden State Warriors,0021701087,2018-03-23T00:00:00Z,GSW vs. ATL,106,12,1610612737,ATL,Atlanta Hawks,ATL @ GSW,94,-12,Regular Season
22017,1610612761,TOR,Toronto Raptors,0021701082,2018-03-23T00:00:00Z,TOR vs. BKN,116,4,1610612751,BKN,Brooklyn Nets,BKN @ TOR,112,-4,Regular Season
22017,1610612741,CHI,Chicago Bulls,0021701083,2018-03-23T00:00:00Z,CHI vs. MIL,105,-13,1610612749,MIL,Milwaukee Bucks,MIL @ CHI,118,13,Regular Season
22017,1610612759,SAS,San Antonio Spurs,0021701085,2018-03-23T00:00:00Z,SAS vs. UTA,124,4,1610612762,UTA,Utah Jazz,UTA @ SAS,120,-4,Regular Season
22017,1610612739,CLE,Cleveland Cavaliers,0021701080,2018-03-23T00:00:00Z,CLE vs. PHX,120,25,1610612756,PHX,Phoenix Suns,PHX @ CLE,95,-25,Regular Season
22017,1610612763,MEM,Memphis Grizzlies,0021701092,2018-03-24T00:00:00Z,MEM vs. LAL,93,-7,1610612747,LAL,Los Angeles Lakers,LAL @ MEM,100,7,Regular Season
22017,1610612765,DET,Detroit Pistons,0021701089,2018-03-24T00:00:00Z,DET vs. CHI,117,22,1610612741,CHI,Chicago Bulls,CHI @ DET,95,-22,Regular Season
22017,1610612742,DAL,Dallas Mavericks,0021701093,2018-03-24T00:00:00Z,DAL vs. CHA,98,-4,1610612766,CHA,Charlotte Hornets,CHA @ DAL,102,4,Regular Season
22017,1610612755,PHI,Philadelphia 76ers,0021701088,2018-03-24T00:00:00Z,PHI vs. MIN,120,12,1610612750,MIN,Minnesota Timberwolves,MIN @ PHI,108,-12,Regular Season
22017,1610612753,ORL,Orlando Magic,0021701090,2018-03-24T00:00:00Z,ORL vs. PHX,105,6,1610612756,PHX,Phoenix Suns,PHX @ ORL,99,-6,Regular Season
22017,1610612745,HOU,Houston Rockets,0021701091,2018-03-24T00:00:00Z,HOU vs. NOP,114,23,1610612740,NOP,New Orleans Pelicans,NOP @ HOU,91,-23,Regular Season
22017,1610612761,TOR,Toronto Raptors,0021701097,2018-03-25T00:00:00Z,TOR vs. LAC,106,-11,1610612746,LAC,LA Clippers,LAC @ TOR,117,11,Regular Season
22017,1610612764,WAS,Washington Wizards,0021701098,2018-03-25T00:00:00Z,WAS vs. NYK,97,-4,1610612752,NYK,New York Knicks,NYK @ WAS,101,4,Regular Season
22017,1610612744,GSW,Golden State Warriors,0021701102,2018-03-25T00:00:00Z,GSW vs. UTA,91,-19,1610612762,UTA,Utah Jazz,UTA @ GSW,110,19,Regular Season
22017,1610612760,OKC,Oklahoma City Thunder,0021701100,2018-03-25T00:00:00Z,OKC vs. POR,105,-3,1610612757,POR,Portland Trail Blazers,POR @ OKC,108,3,Regular Season
22017,1610612758,SAC,Sacramento Kings,0021701099,2018-03-25T00:00:00Z,SAC vs. BOS,93,-11,1610612738,BOS,Boston Celtics,BOS @ SAC,104,11,Regular Season
22017,1610612745,HOU,Houston Rockets,0021701101,2018-03-25T00:00:00Z,HOU vs. ATL,118,19,1610612737,ATL,Atlanta Hawks,ATL @ HOU,99,-19,Regular Season
22017,1610612754,IND,Indiana Pacers,0021701096,2018-03-25T00:00:00Z,IND vs. MIA,113,6,1610612748,MIA,Miami Heat,MIA @ IND,107,-6,Regular Season
22017,1610612751,BKN,Brooklyn Nets,0021701094,2018-03-25T00:00:00Z,BKN vs. CLE,114,-7,1610612739,CLE,Cleveland Cavaliers,CLE @ BKN,121,7,Regular Season
22017,1610612749,MIL,Milwaukee Bucks,0021701095,2018-03-25T00:00:00Z,MIL vs. SAS,106,3,1610612759,SAS,San Antonio Spurs,SAS @ MIL,103,-3,Regular Season
22017,1610612765,DET,Detroit Pistons,0021701104,2018-03-26T00:00:00Z,DET vs. LAL,112,6,1610612747,LAL,Los Angeles Lakers,LAL @ DET,106,-6,Regular Season
22017,1610612756,PHX,Phoenix Suns,0021701107,2018-03-26T00:00:00Z,PHX vs. BOS,94,-8,1610612738,BOS,Boston Celtics,BOS @ PHX,102,8,Regular Season
22017,1610612750,MIN,Minnesota Timberwolves,0021701106,2018-03-26T00:00:00Z,MIN vs. MEM,93,-8,1610612763,MEM,Memphis Grizzlies,MEM @ MIN,101,8,Regular Season
22017,1610612755,PHI,Philadelphia 76ers,0021701105,2018-03-26T00:00:00Z,PHI vs. DEN,123,19,1610612743,DEN,Denver Nuggets,DEN @ PHI,104,-19,Regular Season
22017,1610612766,CHA,Charlotte Hornets,0021701103,2018-03-26T00:00:00Z,CHA vs. NYK,137,9,1610612752,NYK,New York Knicks,NYK @ CHA,128,-9,Regular Season
22017,1610612758,SAC,Sacramento Kings,0021701113,2018-03-27T00:00:00Z,SAC vs. DAL,97,-6,1610612742,DAL,Dallas Mavericks,DAL @ SAC,103,6,Regular Season
22017,1610612740,NOP,New Orleans Pelicans,0021701112,2018-03-27T00:00:00Z,NOP vs. POR,103,-4,1610612757,POR,Portland Trail Blazers,POR @ NOP,107,4,Regular Season
22017,1610612748,MIA,Miami Heat,0021701110,2018-03-27T00:00:00Z,MIA vs. CLE,98,19,1610612739,CLE,Cleveland Cavaliers,CLE @ MIA,79,-19,Regular Season
22017,1610612761,TOR,Toronto Raptors,0021701109,2018-03-27T00:00:00Z,TOR vs. DEN,114,4,1610612743,DEN,Denver Nuggets,DEN @ TOR,110,-4,Regular Season
22017,1610612764,WAS,Washington Wizards,0021701108,2018-03-27T00:00:00Z,WAS vs. SAS,116,10,1610612759,SAS,San Antonio Spurs,SAS @ WAS,106,-10,Regular Season
22017,1610612746,LAC,LA Clippers,0021701115,2018-03-27T00:00:00Z,LAC vs. MIL,105,7,1610612749,MIL,Milwaukee Bucks,MIL @ LAC,98,-7,Regular Season
22017,1610612744,GSW,Golden State Warriors,0021701114,2018-03-27T00:00:00Z,GSW vs. IND,81,-11,1610612754,IND,Indiana Pacers,IND @ GSW,92,11,Regular Season
22017,1610612745,HOU,Houston Rockets,0021701111,2018-03-27T00:00:00Z,HOU vs. CHI,118,32,1610612741,CHI,Chicago Bulls,CHI @ HOU,86,-32,Regular Season
22017,1610612756,PHX,Phoenix Suns,0021701122,2018-03-28T00:00:00Z,PHX vs. LAC,99,-12,1610612746,LAC,LA Clippers,LAC @ PHX,111,12,Regular Season
22017,1610612755,PHI,Philadelphia 76ers,0021701118,2018-03-28T00:00:00Z,PHI vs. NYK,118,17,1610612752,NYK,New York Knicks,NYK @ PHI,101,-17,Regular Season
22017,1610612753,ORL,Orlando Magic,0021701117,2018-03-28T00:00:00Z,ORL vs. BKN,104,-7,1610612751,BKN,Brooklyn Nets,BKN @ ORL,111,7,Regular Season
22017,1610612747,LAL,Los Angeles Lakers,0021701123,2018-03-28T00:00:00Z,LAL vs. DAL,103,10,1610612742,DAL,Dallas Mavericks,DAL @ LAL,93,-10,Regular Season
22017,1610612766,CHA,Charlotte Hornets,0021701116,2018-03-28T00:00:00Z,CHA vs. CLE,105,-13,1610612739,CLE,Cleveland Cavaliers,CLE @ CHA,118,13,Regular Season
22017,1610612763,MEM,Memphis Grizzlies,0021701119,2018-03-28T00:00:00Z,MEM vs. POR,108,5,1610612757,POR,Portland Trail Blazers,POR @ MEM,103,-5,Regular Season
22017,1610612762,UTA,Utah Jazz,0021701121,2018-03-28T00:00:00Z,UTA vs. BOS,94,-3,1610612738,BOS,Boston Celtics,BOS @ UTA,97,3,Regular Season
22017,1610612750,MIN,Minnesota Timberwolves,0021701120,2018-03-28T00:00:00Z,MIN vs. ATL,126,12,1610612737,ATL,Atlanta Hawks,ATL @ MIN,114,-12,Regular Season
22017,1610612759,SAS,San Antonio Spurs,0021701126,2018-03-29T00:00:00Z,SAS vs. OKC,103,4,1610612760,OKC,Oklahoma City Thunder,OKC @ SAS,99,-4,Regular Season
22017,1610612744,GSW,Golden State Warriors,0021701128,2018-03-29T00:00:00Z,GSW vs. MIL,107,-9,1610612749,MIL,Milwaukee Bucks,MIL @ GSW,116,9,Regular Season
22017,1610612758,SAC,Sacramento Kings,0021701127,2018-03-29T00:00:00Z,SAC vs. IND,103,-3,1610612754,IND,Indiana Pacers,IND @ SAC,106,3,Regular Season
22017,1610612765,DET,Detroit Pistons,0021701124,2018-03-29T00:00:00Z,DET vs. WAS,103,11,1610612764,WAS,Washington Wizards,WAS @ DET,92,-11,Regular Season
22017,1610612748,MIA,Miami Heat,0021701125,2018-03-29T00:00:00Z,MIA vs. CHI,103,11,1610612741,CHI,Chicago Bulls,CHI @ MIA,92,-11,Regular Season
22017,1610612753,ORL,Orlando Magic,0021701129,2018-03-30T00:00:00Z,ORL vs. CHI,82,-8,1610612741,CHI,Chicago Bulls,CHI @ ORL,90,8,Regular Season
22017,1610612739,CLE,Cleveland Cavaliers,0021701131,2018-03-30T00:00:00Z,CLE vs. NOP,107,5,1610612740,NOP,New Orleans Pelicans,NOP @ CLE,102,-5,Regular Season
22017,1610612762,UTA,Utah Jazz,0021701135,2018-03-30T00:00:00Z,UTA vs. MEM,107,10,1610612763,MEM,Memphis Grizzlies,MEM @ UTA,97,-10,Regular Season
22017,1610612745,HOU,Houston Rockets,0021701132,2018-03-30T00:00:00Z,HOU vs. PHX,104,1,1610612756,PHX,Phoenix Suns,PHX @ HOU,103,-1,Regular Season
22017,1610612747,LAL,Los Angeles Lakers,0021701136,2018-03-30T00:00:00Z,LAL vs. MIL,122,-2,1610612749,MIL,Milwaukee Bucks,MIL @ LAL,124,2,Regular Season
22017,1610612737,ATL,Atlanta Hawks,0021701130,2018-03-30T00:00:00Z,ATL vs. PHI,91,-10,1610612755,PHI,Philadelphia 76ers,PHI @ ATL,101,10,Regular Season
22017,1610612760,OKC,Oklahoma City Thunder,0021701133,2018-03-30T00:00:00Z,OKC vs. DEN,125,-1,1610612743,DEN,Denver Nuggets,DEN @ OKC,126,1,Regular Season
22017,1610612742,DAL,Dallas Mavericks,0021701134,2018-03-30T00:00:00Z,DAL vs. MIN,92,-1,1610612750,MIN,Minnesota Timberwolves,MIN @ DAL,93,1,Regular Season
22017,1610612757,POR,Portland Trail Blazers,0021701137,2018-03-30T00:00:00Z,POR vs. LAC,105,9,1610612746,LAC,LA Clippers,LAC @ POR,96,-9,Regular Season
22017,1610612764,WAS,Washington Wizards,0021701138,2018-03-31T00:00:00Z,WAS vs. CHA,107,14,1610612766,CHA,Charlotte Hornets,CHA @ WAS,93,-14,Regular Season
22017,1610612758,SAC,Sacramento Kings,0021701142,2018-03-31T00:00:00Z,SAC vs. GSW,96,-16,1610612744,GSW,Golden State Warriors,GSW @ SAC,112,16,Regular Season
22017,1610612748,MIA,Miami Heat,0021701141,2018-03-31T00:00:00Z,MIA vs. BKN,109,-1,1610612751,BKN,Brooklyn Nets,BKN @ MIA,110,1,Regular Season
22017,1610612752,NYK,New York Knicks,0021701139,2018-03-31T00:00:00Z,NYK vs. DET,109,-6,1610612765,DET,Detroit Pistons,DET @ NYK,115,6,Regular Season
22017,1610612738,BOS,Boston Celtics,0021701140,2018-03-31T00:00:00Z,BOS vs. TOR,110,11,1610612761,TOR,Toronto Raptors,TOR @ BOS,99,-11,Regular Season
22017,1610612737,ATL,Atlanta Hawks,0021701147,2018-04-01T00:00:00Z,ATL vs. ORL,94,6,1610612753,ORL,Orlando Magic,ORL @ ATL,88,-6,Regular Season
22017,1610612743,DEN,Denver Nuggets,0021701152,2018-04-01T00:00:00Z,DEN vs. MIL,128,3,1610612749,MIL,Milwaukee Bucks,MIL @ DEN,125,-3,Regular Season
22017,1610612766,CHA,Charlotte Hornets,0021701143,2018-04-01T00:00:00Z,CHA vs. PHI,102,-17,1610612755,PHI,Philadelphia 76ers,PHI @ CHA,119,17,Regular Season
22017,1610612757,POR,Portland Trail Blazers,0021701154,2018-04-01T00:00:00Z,POR vs. MEM,113,15,1610612763,MEM,Memphis Grizzlies,MEM @ POR,98,-15,Regular Season
22017,1610612739,CLE,Cleveland Cavaliers,0021701149,2018-04-01T00:00:00Z,CLE vs. DAL,98,11,1610612742,DAL,Dallas Mavericks,DAL @ CLE,87,-11,Regular Season
22017,1610612751,BKN,Brooklyn Nets,0021701148,2018-04-01T00:00:00Z,BKN vs. DET,96,-12,1610612765,DET,Detroit Pistons,DET @ BKN,108,12,Regular Season
22017,1610612746,LAC,LA Clippers,0021701146,2018-04-01T00:00:00Z,LAC vs. IND,104,-7,1610612754,IND,Indiana Pacers,IND @ LAC,111,7,Regular Season
22017,1610612741,CHI,Chicago Bulls,0021701144,2018-04-01T00:00:00Z,CHI vs. WAS,113,19,1610612764,WAS,Washington Wizards,WAS @ CHI,94,-19,Regular Season
22017,1610612740,NOP,New Orleans Pelicans,0021701150,2018-04-01T00:00:00Z,NOP vs. OKC,104,-5,1610612760,OKC,Oklahoma City Thunder,OKC @ NOP,109,5,Regular Season
22017,1610612750,MIN,Minnesota Timberwolves,0021701151,2018-04-01T00:00:00Z,MIN vs. UTA,97,-24,1610612762,UTA,Utah Jazz,UTA @ MIN,121,24,Regular Season
22017,1610612747,LAL,Los Angeles Lakers,0021701155,2018-04-01T00:00:00Z,LAL vs. SAC,83,-1,1610612758,SAC,Sacramento Kings,SAC @ LAL,84,1,Regular Season
22017,1610612744,GSW,Golden State Warriors,0021701153,2018-04-01T00:00:00Z,GSW vs. PHX,117,10,1610612756,PHX,Phoenix Suns,PHX @ GSW,107,-10,Regular Season
22017,1610612759,SAS,San Antonio Spurs,0021701145,2018-04-01T00:00:00Z,SAS vs. HOU,100,17,1610612745,HOU,Houston Rockets,HOU @ SAS,83,-17,Regular Season
22017,1610612755,PHI,Philadelphia 76ers,0021701157,2018-04-03T00:00:00Z,PHI vs. BKN,121,26,1610612751,BKN,Brooklyn Nets,BKN @ PHI,95,-26,Regular Season
22017,1610612762,UTA,Utah Jazz,0021701166,2018-04-03T00:00:00Z,UTA vs. LAL,117,7,1610612747,LAL,Los Angeles Lakers,LAL @ UTA,110,-7,Regular Season
22017,1610612752,NYK,New York Knicks,0021701159,2018-04-03T00:00:00Z,NYK vs. ORL,73,-24,1610612753,ORL,Orlando Magic,ORL @ NYK,97,24,Regular Season
22017,1610612749,MIL,Milwaukee Bucks,0021701162,2018-04-03T00:00:00Z,MIL vs. BOS,106,4,1610612738,BOS,Boston Celtics,BOS @ MIL,102,-4,Regular Season
22017,1610612745,HOU,Houston Rockets,0021701161,2018-04-03T00:00:00Z,HOU vs. WAS,120,16,1610612764,WAS,Washington Wizards,WAS @ HOU,104,-16,Regular Season
22017,1610612748,MIA,Miami Heat,0021701158,2018-04-03T00:00:00Z,MIA vs. ATL,101,3,1610612737,ATL,Atlanta Hawks,ATL @ MIA,98,-3,Regular Season
22017,1610612756,PHX,Phoenix Suns,0021701167,2018-04-03T00:00:00Z,PHX vs. SAC,97,3,1610612758,SAC,Sacramento Kings,SAC @ PHX,94,-3,Regular Season
22017,1610612739,CLE,Cleveland Cavaliers,0021701156,2018-04-03T00:00:00Z,CLE vs. TOR,112,6,1610612761,TOR,Toronto Raptors,TOR @ CLE,106,-6,Regular Season
22017,1610612743,DEN,Denver Nuggets,0021701165,2018-04-03T00:00:00Z,DEN vs. IND,107,3,1610612754,IND,Indiana Pacers,IND @ DEN,104,-3,Regular Season
22017,1610612741,CHI,Chicago Bulls,0021701160,2018-04-03T00:00:00Z,CHI vs. CHA,120,6,1610612766,CHA,Charlotte Hornets,CHA @ CHI,114,-6,Regular Season
22017,1610612746,LAC,LA Clippers,0021701168,2018-04-03T00:00:00Z,LAC vs. SAS,113,3,1610612759,SAS,San Antonio Spurs,SAS @ LAC,110,-3,Regular Season
22017,1610612760,OKC,Oklahoma City Thunder,0021701163,2018-04-03T00:00:00Z,OKC vs. GSW,107,-4,1610612744,GSW,Golden State Warriors,GSW @ OKC,111,4,Regular Season
22017,1610612742,DAL,Dallas Mavericks,0021701164,2018-04-03T00:00:00Z,DAL vs. POR,115,6,1610612757,POR,Portland Trail Blazers,POR @ DAL,109,-6,Regular Season
22017,1610612761,TOR,Toronto Raptors,0021701171,2018-04-04T00:00:00Z,TOR vs. BOS,96,18,1610612738,BOS,Boston Celtics,BOS @ TOR,78,-18,Regular Season
22017,1610612740,NOP,New Orleans Pelicans,0021701173,2018-04-04T00:00:00Z,NOP vs. MEM,123,28,1610612763,MEM,Memphis Grizzlies,MEM @ NOP,95,-28,Regular Season
22017,1610612737,ATL,Atlanta Hawks,0021701172,2018-04-04T00:00:00Z,ATL vs. MIA,86,-29,1610612748,MIA,Miami Heat,MIA @ ATL,115,29,Regular Season
22017,1610612753,ORL,Orlando Magic,0021701170,2018-04-04T00:00:00Z,ORL vs. DAL,105,5,1610612742,DAL,Dallas Mavericks,DAL @ ORL,100,-5,Regular Season
22017,1610612765,DET,Detroit Pistons,0021701169,2018-04-04T00:00:00Z,DET vs. PHI,108,-7,1610612755,PHI,Philadelphia 76ers,PHI @ DET,115,7,Regular Season
22017,1610612747,LAL,Los Angeles Lakers,0021701174,2018-04-04T00:00:00Z,LAL vs. SAS,122,10,1610612759,SAS,San Antonio Spurs,SAS @ LAL,112,-10,Regular Season
22017,1610612743,DEN,Denver Nuggets,0021701180,2018-04-05T00:00:00Z,DEN vs. MIN,100,4,1610612750,MIN,Minnesota Timberwolves,MIN @ DEN,96,-4,Regular Season
22017,1610612762,UTA,Utah Jazz,0021701179,2018-04-05T00:00:00Z,UTA vs. LAC,117,22,1610612746,LAC,LA Clippers,LAC @ UTA,95,-22,Regular Season
22017,1610612739,CLE,Cleveland Cavaliers,0021701176,2018-04-05T00:00:00Z,CLE vs. WAS,119,4,1610612764,WAS,Washington Wizards,WAS @ CLE,115,-4,Regular Season
22017,1610612749,MIL,Milwaukee Bucks,0021701178,2018-04-05T00:00:00Z,MIL vs. BKN,111,-8,1610612751,BKN,Brooklyn Nets,BKN @ MIL,119,8,Regular Season
22017,1610612745,HOU,Houston Rockets,0021701177,2018-04-05T00:00:00Z,HOU vs. POR,96,2,1610612757,POR,Portland Trail Blazers,POR @ HOU,94,-2,Regular Season
22017,1610612754,IND,Indiana Pacers,0021701175,2018-04-05T00:00:00Z,IND vs. GSW,126,20,1610612744,GSW,Golden State Warriors,GSW @ IND,106,-20,Regular Season
22017,1610612764,WAS,Washington Wizards,0021701184,2018-04-06T00:00:00Z,WAS vs. ATL,97,-6,1610612737,ATL,Atlanta Hawks,ATL @ WAS,103,6,Regular Season
22017,1610612761,TOR,Toronto Raptors,0021701187,2018-04-06T00:00:00Z,TOR vs. IND,92,19,1610612754,IND,Indiana Pacers,IND @ TOR,73,-19,Regular Season
22017,1610612753,ORL,Orlando Magic,0021701182,2018-04-06T00:00:00Z,ORL vs. CHA,100,-37,1610612766,CHA,Charlotte Hornets,CHA @ ORL,137,37,Regular Season
22017,1610612747,LAL,Los Angeles Lakers,0021701190,2018-04-06T00:00:00Z,LAL vs. MIN,96,-17,1610612750,MIN,Minnesota Timberwolves,MIN @ LAL,113,17,Regular Season
22017,1610612738,BOS,Boston Celtics,0021701185,2018-04-06T00:00:00Z,BOS vs. CHI,111,7,1610612741,CHI,Chicago Bulls,CHI @ BOS,104,-7,Regular Season
22017,1610612765,DET,Detroit Pistons,0021701181,2018-04-06T00:00:00Z,DET vs. DAL,113,7,1610612742,DAL,Dallas Mavericks,DAL @ DET,106,-7,Regular Season
22017,1610612763,MEM,Memphis Grizzlies,0021701188,2018-04-06T00:00:00Z,MEM vs. SAC,93,-1,1610612758,SAC,Sacramento Kings,SAC @ MEM,94,1,Regular Season
22017,1610612756,PHX,Phoenix Suns,0021701189,2018-04-06T00:00:00Z,PHX vs. NOP,103,-19,1610612740,NOP,New Orleans Pelicans,NOP @ PHX,122,19,Regular Season
22017,1610612752,NYK,New York Knicks,0021701186,2018-04-06T00:00:00Z,NYK vs. MIA,122,24,1610612748,MIA,Miami Heat,MIA @ NYK,98,-24,Regular Season
22017,1610612755,PHI,Philadelphia 76ers,0021701183,2018-04-06T00:00:00Z,PHI vs. CLE,132,2,1610612739,CLE,Cleveland Cavaliers,CLE @ PHI,130,-2,Regular Season
22017,1610612752,NYK,New York Knicks,0021701192,2018-04-07T00:00:00Z,NYK vs. MIL,102,-13,1610612749,MIL,Milwaukee Bucks,MIL @ NYK,115,13,Regular Season
22017,1610612759,SAS,San Antonio Spurs,0021701196,2018-04-07T00:00:00Z,SAS vs. POR,116,11,1610612757,POR,Portland Trail Blazers,POR @ SAS,105,-11,Regular Season
22017,1610612745,HOU,Houston Rockets,0021701194,2018-04-07T00:00:00Z,HOU vs. OKC,102,-6,1610612760,OKC,Oklahoma City Thunder,OKC @ HOU,108,6,Regular Season
22017,1610612746,LAC,LA Clippers,0021701191,2018-04-07T00:00:00Z,LAC vs. DEN,115,-19,1610612743,DEN,Denver Nuggets,DEN @ LAC,134,19,Regular Season
22017,1610612741,CHI,Chicago Bulls,0021701193,2018-04-07T00:00:00Z,CHI vs. BKN,96,-28,1610612751,BKN,Brooklyn Nets,BKN @ CHI,124,28,Regular Season
22017,1610612744,GSW,Golden State Warriors,0021701195,2018-04-07T00:00:00Z,GSW vs. NOP,120,-6,1610612740,NOP,New Orleans Pelicans,NOP @ GSW,126,6,Regular Season
22017,1610612761,TOR,Toronto Raptors,0021701200,2018-04-08T00:00:00Z,TOR vs. ORL,112,11,1610612753,ORL,Orlando Magic,ORL @ TOR,101,-11,Regular Season
22017,1610612738,BOS,Boston Celtics,0021701202,2018-04-08T00:00:00Z,BOS vs. ATL,106,-6,1610612737,ATL,Atlanta Hawks,ATL @ BOS,112,6,Regular Season
22017,1610612756,PHX,Phoenix Suns,0021701203,2018-04-08T00:00:00Z,PHX vs. GSW,100,-17,1610612744,GSW,Golden State Warriors,GSW @ PHX,117,17,Regular Season
22017,1610612755,PHI,Philadelphia 76ers,0021701198,2018-04-08T00:00:00Z,PHI vs. DAL,109,12,1610612742,DAL,Dallas Mavericks,DAL @ PHI,97,-12,Regular Season
22017,1610612763,MEM,Memphis Grizzlies,0021701199,2018-04-08T00:00:00Z,MEM vs. DET,130,13,1610612765,DET,Detroit Pistons,DET @ MEM,117,-13,Regular Season
22017,1610612766,CHA,Charlotte Hornets,0021701197,2018-04-08T00:00:00Z,CHA vs. IND,117,-6,1610612754,IND,Indiana Pacers,IND @ CHA,123,6,Regular Season
22017,1610612747,LAL,Los Angeles Lakers,0021701201,2018-04-08T00:00:00Z,LAL vs. UTA,97,-15,1610612762,UTA,Utah Jazz,UTA @ LAL,112,15,Regular Season
22017,1610612743,DEN,Denver Nuggets,0021701211,2018-04-09T00:00:00Z,DEN vs. POR,88,6,1610612757,POR,Portland Trail Blazers,POR @ DEN,82,-6,Regular Season
22017,1610612746,LAC,LA Clippers,0021701212,2018-04-09T00:00:00Z,LAC vs. NOP,100,-13,1610612740,NOP,New Orleans Pelicans,NOP @ LAC,113,13,Regular Season
22017,1610612765,DET,Detroit Pistons,0021701204,2018-04-09T00:00:00Z,DET vs. TOR,98,-10,1610612761,TOR,Toronto Raptors,TOR @ DET,108,10,Regular Season
22017,1610612752,NYK,New York Knicks,0021701207,2018-04-09T00:00:00Z,NYK vs. CLE,109,-14,1610612739,CLE,Cleveland Cavaliers,CLE @ NYK,123,14,Regular Season
22017,1610612750,MIN,Minnesota Timberwolves,0021701209,2018-04-09T00:00:00Z,MIN vs. MEM,113,19,1610612763,MEM,Memphis Grizzlies,MEM @ MIN,94,-19,Regular Season
22017,1610612748,MIA,Miami Heat,0021701206,2018-04-09T00:00:00Z,MIA vs. OKC,93,-22,1610612760,OKC,Oklahoma City Thunder,OKC @ MIA,115,22,Regular Season
22017,1610612749,MIL,Milwaukee Bucks,0021701208,2018-04-09T00:00:00Z,MIL vs. ORL,102,16,1610612753,ORL,Orlando Magic,ORL @ MIL,86,-16,Regular Season
22017,1610612751,BKN,Brooklyn Nets,0021701205,2018-04-09T00:00:00Z,BKN vs. CHI,114,9,1610612741,CHI,Chicago Bulls,CHI @ BKN,105,-9,Regular Season
22017,1610612759,SAS,San Antonio Spurs,0021701210,2018-04-09T00:00:00Z,SAS vs. SAC,98,13,1610612758,SAC,Sacramento Kings,SAC @ SAS,85,-13,Regular Season
22017,1610612742,DAL,Dallas Mavericks,0021701216,2018-04-10T00:00:00Z,DAL vs. PHX,97,-27,1610612756,PHX,Phoenix Suns,PHX @ DAL,124,27,Regular Season
22017,1610612754,IND,Indiana Pacers,0021701213,2018-04-10T00:00:00Z,IND vs. CHA,93,-26,1610612766,CHA,Charlotte Hornets,CHA @ IND,119,26,Regular Season
22017,1610612747,LAL,Los Angeles Lakers,0021701218,2018-04-10T00:00:00Z,LAL vs. HOU,99,-6,1610612745,HOU,Houston Rockets,HOU @ LAL,105,6,Regular Season
22017,1610612737,ATL,Atlanta Hawks,0021701214,2018-04-10T00:00:00Z,ATL vs. PHI,113,-8,1610612755,PHI,Philadelphia 76ers,PHI @ ATL,121,8,Regular Season
22017,1610612764,WAS,Washington Wizards,0021701215,2018-04-10T00:00:00Z,WAS vs. BOS,113,12,1610612738,BOS,Boston Celtics,BOS @ WAS,101,-12,Regular Season
22017,1610612762,UTA,Utah Jazz,0021701217,2018-04-10T00:00:00Z,UTA vs. GSW,119,40,1610612744,GSW,Golden State Warriors,GSW @ UTA,79,-40,Regular Season
22017,1610612748,MIA,Miami Heat,0021701221,2018-04-11T00:00:00Z,MIA vs. TOR,116,7,1610612761,TOR,Toronto Raptors,TOR @ MIA,109,-7,Regular Season
22017,1610612740,NOP,New Orleans Pelicans,0021701226,2018-04-11T00:00:00Z,NOP vs. SAS,122,24,1610612759,SAS,San Antonio Spurs,SAS @ NOP,98,-24,Regular Season
22017,1610612739,CLE,Cleveland Cavaliers,0021701220,2018-04-11T00:00:00Z,CLE vs. NYK,98,-12,1610612752,NYK,New York Knicks,NYK @ CLE,110,12,Regular Season
22017,1610612755,PHI,Philadelphia 76ers,0021701223,2018-04-11T00:00:00Z,PHI vs. MIL,130,35,1610612749,MIL,Milwaukee Bucks,MIL @ PHI,95,-35,Regular Season
22017,1610612750,MIN,Minnesota Timberwolves,0021701225,2018-04-11T00:00:00Z,MIN vs. DEN,112,6,1610612743,DEN,Denver Nuggets,DEN @ MIN,106,-6,Regular Season
22017,1610612758,SAC,Sacramento Kings,0021701230,2018-04-11T00:00:00Z,SAC vs. HOU,96,13,1610612745,HOU,Houston Rockets,HOU @ SAC,83,-13,Regular Season
22017,1610612746,LAC,LA Clippers,0021701228,2018-04-11T00:00:00Z,LAC vs. LAL,100,-15,1610612747,LAL,Los Angeles Lakers,LAL @ LAC,115,15,Regular Season
22017,1610612757,POR,Portland Trail Blazers,0021701229,2018-04-11T00:00:00Z,POR vs. UTA,102,9,1610612762,UTA,Utah Jazz,UTA @ POR,93,-9,Regular Season
22017,1610612741,CHI,Chicago Bulls,0021701224,2018-04-11T00:00:00Z,CHI vs. DET,87,-32,1610612765,DET,Detroit Pistons,DET @ CHI,119,32,Regular Season
22017,1610612753,ORL,Orlando Magic,0021701222,2018-04-11T00:00:00Z,ORL vs. WAS,101,9,1610612764,WAS,Washington Wizards,WAS @ ORL,92,-9,Regular Season
22017,1610612760,OKC,Oklahoma City Thunder,0021701227,2018-04-11T00:00:00Z,OKC vs. MEM,137,14,1610612763,MEM,Memphis Grizzlies,MEM @ OKC,123,-14,Regular Season
22017,1610612738,BOS,Boston Celtics,0021701219,2018-04-11T00:00:00Z,BOS vs. BKN,110,13,1610612751,BKN,Brooklyn Nets,BKN @ BOS,97,-13,Regular Season
42017,1610612755,PHI,Philadelphia 76ers,0041700121,2018-04-14T00:00:00Z,PHI vs. MIA,130,27,1610612748,MIA,Miami Heat,MIA @ PHI,103,-27,Playoffs
42017,1610612744,GSW,Golden State Warriors,0041700151,2018-04-14T00:00:00Z,GSW vs. SAS,113,21,1610612759,SAS,San Antonio Spurs,SAS @ GSW,92,-21,Playoffs
42017,1610612761,TOR,Toronto Raptors,0041700101,2018-04-14T00:00:00Z,TOR vs. WAS,114,8,1610612764,WAS,Washington Wizards,WAS @ TOR,106,-8,Playoffs
42017,1610612757,POR,Portland Trail Blazers,0041700161,2018-04-14T00:00:00Z,POR vs. NOP,95,-2,1610612740,NOP,New Orleans Pelicans,NOP @ POR,97,2,Playoffs
42017,1610612760,OKC,Oklahoma City Thunder,0041700171,2018-04-15T00:00:00Z,OKC vs. UTA,116,8,1610612762,UTA,Utah Jazz,UTA @ OKC,108,-8,Playoffs
42017,1610612745,HOU,Houston Rockets,0041700141,2018-04-15T00:00:00Z,HOU vs. MIN,104,3,1610612750,MIN,Minnesota Timberwolves,MIN @ HOU,101,-3,Playoffs
42017,1610612739,CLE,Cleveland Cavaliers,0041700131,2018-04-15T00:00:00Z,CLE vs. IND,80,-18,1610612754,IND,Indiana Pacers,IND @ CLE,98,18,Playoffs
42017,1610612738,BOS,Boston Celtics,0041700111,2018-04-15T00:00:00Z,BOS vs. MIL,113,6,1610612749,MIL,Milwaukee Bucks,MIL @ BOS,107,-6,Playoffs
42017,1610612755,PHI,Philadelphia 76ers,0041700122,2018-04-16T00:00:00Z,PHI vs. MIA,103,-10,1610612748,MIA,Miami Heat,MIA @ PHI,113,10,Playoffs
42017,1610612744,GSW,Golden State Warriors,0041700152,2018-04-16T00:00:00Z,GSW vs. SAS,116,15,1610612759,SAS,San Antonio Spurs,SAS @ GSW,101,-15,Playoffs
42017,1610612738,BOS,Boston Celtics,0041700112,2018-04-17T00:00:00Z,BOS vs. MIL,120,14,1610612749,MIL,Milwaukee Bucks,MIL @ BOS,106,-14,Playoffs
42017,1610612757,POR,Portland Trail Blazers,0041700162,2018-04-17T00:00:00Z,POR vs. NOP,102,-9,1610612740,NOP,New Orleans Pelicans,NOP @ POR,111,9,Playoffs
42017,1610612761,TOR,Toronto Raptors,0041700102,2018-04-17T00:00:00Z,TOR vs. WAS,130,11,1610612764,WAS,Washington Wizards,WAS @ TOR,119,-11,Playoffs
42017,1610612745,HOU,Houston Rockets,0041700142,2018-04-18T00:00:00Z,HOU vs. MIN,102,20,1610612750,MIN,Minnesota Timberwolves,MIN @ HOU,82,-20,Playoffs
42017,1610612760,OKC,Oklahoma City Thunder,0041700172,2018-04-18T00:00:00Z,OKC vs. UTA,95,-7,1610612762,UTA,Utah Jazz,UTA @ OKC,102,7,Playoffs
42017,1610612739,CLE,Cleveland Cavaliers,0041700132,2018-04-18T00:00:00Z,CLE vs. IND,100,3,1610612754,IND,Indiana Pacers,IND @ CLE,97,-3,Playoffs
42017,1610612748,MIA,Miami Heat,0041700123,2018-04-19T00:00:00Z,MIA vs. PHI,108,-20,1610612755,PHI,Philadelphia 76ers,PHI @ MIA,128,20,Playoffs
42017,1610612759,SAS,San Antonio Spurs,0041700153,2018-04-19T00:00:00Z,SAS vs. GSW,97,-13,1610612744,GSW,Golden State Warriors,GSW @ SAS,110,13,Playoffs
42017,1610612740,NOP,New Orleans Pelicans,0041700163,2018-04-19T00:00:00Z,NOP vs. POR,119,17,1610612757,POR,Portland Trail Blazers,POR @ NOP,102,-17,Playoffs
42017,1610612754,IND,Indiana Pacers,0041700133,2018-04-20T00:00:00Z,IND vs. CLE,92,2,1610612739,CLE,Cleveland Cavaliers,CLE @ IND,90,-2,Playoffs
42017,1610612764,WAS,Washington Wizards,0041700103,2018-04-20T00:00:00Z,WAS vs. TOR,122,19,1610612761,TOR,Toronto Raptors,TOR @ WAS,103,-19,Playoffs
42017,1610612749,MIL,Milwaukee Bucks,0041700113,2018-04-20T00:00:00Z,MIL vs. BOS,116,24,1610612738,BOS,Boston Celtics,BOS @ MIL,92,-24,Playoffs
42017,1610612740,NOP,New Orleans Pelicans,0041700164,2018-04-21T00:00:00Z,NOP vs. POR,131,8,1610612757,POR,Portland Trail Blazers,POR @ NOP,123,-8,Playoffs
42017,1610612750,MIN,Minnesota Timberwolves,0041700143,2018-04-21T00:00:00Z,MIN vs. HOU,121,16,1610612745,HOU,Houston Rockets,HOU @ MIN,105,-16,Playoffs
42017,1610612762,UTA,Utah Jazz,0041700173,2018-04-21T00:00:00Z,UTA vs. OKC,115,13,1610612760,OKC,Oklahoma City Thunder,OKC @ UTA,102,-13,Playoffs
42017,1610612748,MIA,Miami Heat,0041700124,2018-04-21T00:00:00Z,MIA vs. PHI,102,-4,1610612755,PHI,Philadelphia 76ers,PHI @ MIA,106,4,Playoffs
42017,1610612764,WAS,Washington Wizards,0041700104,2018-04-22T00:00:00Z,WAS vs. TOR,106,8,1610612761,TOR,Toronto Raptors,TOR @ WAS,98,-8,Playoffs
42017,1610612749,MIL,Milwaukee Bucks,0041700114,2018-04-22T00:00:00Z,MIL vs. BOS,104,2,1610612738,BOS,Boston Celtics,BOS @ MIL,102,-2,Playoffs
42017,1610612759,SAS,San Antonio Spurs,0041700154,2018-04-22T00:00:00Z,SAS vs. GSW,103,13,1610612744,GSW,Golden State Warriors,GSW @ SAS,90,-13,Playoffs
42017,1610612754,IND,Indiana Pacers,0041700134,2018-04-22T00:00:00Z,IND vs. CLE,100,-4,1610612739,CLE,Cleveland Cavaliers,CLE @ IND,104,4,Playoffs
42017,1610612762,UTA,Utah Jazz,0041700174,2018-04-23T00:00:00Z,UTA vs. OKC,113,17,1610612760,OKC,Oklahoma City Thunder,OKC @ UTA,96,-17,Playoffs
42017,1610612750,MIN,Minnesota Timberwolves,0041700144,2018-04-23T00:00:00Z,MIN vs. HOU,100,-19,1610612745,HOU,Houston Rockets,HOU @ MIN,119,19,Playoffs
42017,1610612744,GSW,Golden State Warriors,0041700155,2018-04-24T00:00:00Z,GSW vs. SAS,99,8,1610612759,SAS,San Antonio Spurs,SAS @ GSW,91,-8,Playoffs
42017,1610612755,PHI,Philadelphia 76ers,0041700125,2018-04-24T00:00:00Z,PHI vs. MIA,104,13,1610612748,MIA,Miami Heat,MIA @ PHI,91,-13,Playoffs
42017,1610612738,BOS,Boston Celtics,0041700115,2018-04-24T00:00:00Z,BOS vs. MIL,92,5,1610612749,MIL,Milwaukee Bucks,MIL @ BOS,87,-5,Playoffs
42017,1610612760,OKC,Oklahoma City Thunder,0041700175,2018-04-25T00:00:00Z,OKC vs. UTA,107,8,1610612762,UTA,Utah Jazz,UTA @ OKC,99,-8,Playoffs
42017,1610612745,HOU,Houston Rockets,0041700145,2018-04-25T00:00:00Z,HOU vs. MIN,122,18,1610612750,MIN,Minnesota Timberwolves,MIN @ HOU,104,-18,Playoffs
42017,1610612739,CLE,Cleveland Cavaliers,0041700135,2018-04-25T00:00:00Z,CLE vs. IND,98,3,1610612754,IND,Indiana Pacers,IND @ CLE,95,-3,Playoffs
42017,1610612761,TOR,Toronto Raptors,0041700105,2018-04-25T00:00:00Z,TOR vs. WAS,108,10,1610612764,WAS,Washington Wizards,WAS @ TOR,98,-10,Playoffs
42017,1610612749,MIL,Milwaukee Bucks,0041700116,2018-04-26T00:00:00Z,MIL vs. BOS,97,11,1610612738,BOS,Boston Celtics,BOS @ MIL,86,-11,Playoffs
42017,1610612754,IND,Indiana Pacers,0041700136,2018-04-27T00:00:00Z,IND vs. CLE,121,34,1610612739,CLE,Cleveland Cavaliers,CLE @ IND,87,-34,Playoffs
42017,1610612764,WAS,Washington Wizards,0041700106,2018-04-27T00:00:00Z,WAS vs. TOR,92,-10,1610612761,TOR,Toronto Raptors,TOR @ WAS,102,10,Playoffs
42017,1610612762,UTA,Utah Jazz,0041700176,2018-04-27T00:00:00Z,UTA vs. OKC,96,5,1610612760,OKC,Oklahoma City Thunder,OKC @ UTA,91,-5,Playoffs
42017,1610612738,BOS,Boston Celtics,0041700117,2018-04-28T00:00:00Z,BOS vs. MIL,112,16,1610612749,MIL,Milwaukee Bucks,MIL @ BOS,96,-16,Playoffs
42017,1610612744,GSW,Golden State Warriors,0041700231,2018-04-28T00:00:00Z,GSW vs. NOP,123,22,1610612740,NOP,New Orleans Pelicans,NOP @ GSW,101,-22,Playoffs
42017,1610612739,CLE,Cleveland Cavaliers,0041700137,2018-04-29T00:00:00Z,CLE vs. IND,105,4,1610612754,IND,Indiana Pacers,IND @ CLE,101,-4,Playoffs
42017,1610612745,HOU,Houston Rockets,0041700221,2018-04-29T00:00:00Z,HOU vs. UTA,110,14,1610612762,UTA,Utah Jazz,UTA @ HOU,96,-14,Playoffs
42017,1610612738,BOS,Boston Celtics,0041700211,2018-04-30T00:00:00Z,BOS vs. PHI,117,16,1610612755,PHI,Philadelphia 76ers,PHI @ BOS,101,-16,Playoffs
42017,1610612744,GSW,Golden State Warriors,0041700232,2018-05-01T00:00:00Z,GSW vs. NOP,121,5,1610612740,NOP,New Orleans Pelicans,NOP @ GSW,116,-5,Playoffs
42017,1610612761,TOR,Toronto Raptors,0041700201,2018-05-01T00:00:00Z,TOR vs. CLE,112,-1,1610612739,CLE,Cleveland Cavaliers,CLE @ TOR,113,1,Playoffs
42017,1610612745,HOU,Houston Rockets,0041700222,2018-05-02T00:00:00Z,HOU vs. UTA,108,-8,1610612762,UTA,Utah Jazz,UTA @ HOU,116,8,Playoffs
42017,1610612761,TOR,Toronto Raptors,0041700202,2018-05-03T00:00:00Z,TOR vs. CLE,110,-18,1610612739,CLE,Cleveland Cavaliers,CLE @ TOR,128,18,Playoffs
42017,1610612738,BOS,Boston Celtics,0041700212,2018-05-03T00:00:00Z,BOS vs. PHI,108,5,1610612755,PHI,Philadelphia 76ers,PHI @ BOS,103,-5,Playoffs
42017,1610612740,NOP,New Orleans Pelicans,0041700233,2018-05-04T00:00:00Z,NOP vs. GSW,119,19,1610612744,GSW,Golden State Warriors,GSW @ NOP,100,-19,Playoffs
42017,1610612762,UTA,Utah Jazz,0041700223,2018-05-04T00:00:00Z,UTA vs. HOU,92,-21,1610612745,HOU,Houston Rockets,HOU @ UTA,113,21,Playoffs
42017,1610612755,PHI,Philadelphia 76ers,0041700213,2018-05-05T00:00:00Z,PHI vs. BOS,98,-3,1610612738,BOS,Boston Celtics,BOS @ PHI,101,3,Playoffs
42017,1610612739,CLE,Cleveland Cavaliers,0041700203,2018-05-05T00:00:00Z,CLE vs. TOR,105,2,1610612761,TOR,Toronto Raptors,TOR @ CLE,103,-2,Playoffs
42017,1610612762,UTA,Utah Jazz,0041700224,2018-05-06T00:00:00Z,UTA vs. HOU,87,-13,1610612745,HOU,Houston Rockets,HOU @ UTA,100,13,Playoffs
42017,1610612740,NOP,New Orleans Pelicans,0041700234,2018-05-06T00:00:00Z,NOP vs. GSW,92,-26,1610612744,GSW,Golden State Warriors,GSW @ NOP,118,26,Playoffs
42017,1610612755,PHI,Philadelphia 76ers,0041700214,2018-05-07T00:00:00Z,PHI vs. BOS,103,11,1610612738,BOS,Boston Celtics,BOS @ PHI,92,-11,Playoffs
42017,1610612739,CLE,Cleveland Cavaliers,0041700204,2018-05-07T00:00:00Z,CLE vs. TOR,128,35,1610612761,TOR,Toronto Raptors,TOR @ CLE,93,-35,Playoffs
42017,1610612745,HOU,Houston Rockets,0041700225,2018-05-08T00:00:00Z,HOU vs. UTA,112,10,1610612762,UTA,Utah Jazz,UTA @ HOU,102,-10,Playoffs
42017,1610612744,GSW,Golden State Warriors,0041700235,2018-05-08T00:00:00Z,GSW vs. NOP,113,9,1610612740,NOP,New Orleans Pelicans,NOP @ GSW,104,-9,Playoffs
42017,1610612738,BOS,Boston Celtics,0041700215,2018-05-09T00:00:00Z,BOS vs. PHI,114,2,1610612755,PHI,Philadelphia 76ers,PHI @ BOS,112,-2,Playoffs
42017,1610612738,BOS,Boston Celtics,0041700301,2018-05-13T00:00:00Z,BOS vs. CLE,108,25,1610612739,CLE,Cleveland Cavaliers,CLE @ BOS,83,-25,Playoffs
42017,1610612745,HOU,Houston Rockets,0041700311,2018-05-14T00:00:00Z,HOU vs. GSW,106,-13,1610612744,GSW,Golden State Warriors,GSW @ HOU,119,13,Playoffs
42017,1610612738,BOS,Boston Celtics,0041700302,2018-05-15T00:00:00Z,BOS vs. CLE,107,13,1610612739,CLE,Cleveland Cavaliers,CLE @ BOS,94,-13,Playoffs
42017,1610612745,HOU,Houston Rockets,0041700312,2018-05-16T00:00:00Z,HOU vs. GSW,127,22,1610612744,GSW,Golden State Warriors,GSW @ HOU,105,-22,Playoffs
42017,1610612739,CLE,Cleveland Cavaliers,0041700303,2018-05-19T00:00:00Z,CLE vs. BOS,116,30,1610612738,BOS,Boston Celtics,BOS @ CLE,86,-30,Playoffs
42017,1610612744,GSW,Golden State Warriors,0041700313,2018-05-20T00:00:00Z,GSW vs. HOU,126,41,1610612745,HOU,Houston Rockets,HOU @ GSW,85,-41,Playoffs
42017,1610612739,CLE,Cleveland Cavaliers,0041700304,2018-05-21T00:00:00Z,CLE vs. BOS,111,9,1610612738,BOS,Boston Celtics,BOS @ CLE,102,-9,Playoffs
42017,1610612744,GSW,Golden State Warriors,0041700314,2018-05-22T00:00:00Z,GSW vs. HOU,92,-3,1610612745,HOU,Houston Rockets,HOU @ GSW,95,3,Playoffs
42017,1610612738,BOS,Boston Celtics,0041700305,2018-05-23T00:00:00Z,BOS vs. CLE,96,13,1610612739,CLE,Cleveland Cavaliers,CLE @ BOS,83,-13,Playoffs
42017,1610612745,HOU,Houston Rockets,0041700315,2018-05-24T00:00:00Z,HOU vs. GSW,98,4,1610612744,GSW,Golden State Warriors,GSW @ HOU,94,-4,Playoffs
42017,1610612739,CLE,Cleveland Cavaliers,0041700306,2018-05-25T00:00:00Z,CLE vs. BOS,109,10,1610612738,BOS,Boston Celtics,BOS @ CLE,99,-10,Playoffs
42017,1610612744,GSW,Golden State Warriors,0041700316,2018-05-26T00:00:00Z,GSW vs. HOU,115,29,1610612745,HOU,Houston Rockets,HOU @ GSW,86,-29,Playoffs
42017,1610612738,BOS,Boston Celtics,0041700307,2018-05-27T00:00:00Z,BOS vs. CLE,79,-8,1610612739,CLE,Cleveland Cavaliers,CLE @ BOS,87,8,Playoffs
42017,1610612745,HOU,Houston Rockets,0041700317,2018-05-28T00:00:00Z,HOU vs. GSW,92,-9,1610612744,GSW,Golden State Warriors,GSW @ HOU,101,9,Playoffs
42017,1610612744,GSW,Golden State Warriors,0041700401,2018-05-31T00:00:00Z,GSW vs. CLE,124,10,1610612739,CLE,Cleveland Cavaliers,CLE @ GSW,114,-10,Playoffs
42017,1610612744,GSW,Golden State Warriors,0041700402,2018-06-03T00:00:00Z,GSW vs. CLE,122,19,1610612739,CLE,Cleveland Cavaliers,CLE @ GSW,103,-19,Playoffs
42017,1610612739,CLE,Cleveland Cavaliers,0041700403,2018-06-06T00:00:00Z,CLE vs. GSW,102,-8,1610612744,GSW,Golden State Warriors,GSW @ CLE,110,8,Playoffs
42017,1610612739,CLE,Cleveland Cavaliers,0041700404,2018-06-08T00:00:00Z,CLE vs. GSW,85,-23,1610612744,GSW,Golden State Warriors,GSW @ CLE,108,23,Playoffs
32017,1610616834,STP,Team Stephen,0031700001,2018-02-18T00:00:00Z,STP vs. LBN,145,-3,1610616833,LBN,Team LeBron,LBN @ STP,148,3,All-Star
32017,1610616834,STP,Team Stephen,0031700001,2018-02-18T00:00:00Z,STP vs. LBN,145,-3,1610616833,LBN,Team LeBron,LBN @ STP,148,3,All Star
22018,1610612738,BOS,Boston Celtics,0021800001,2018-10-16T00:00:00Z,BOS vs. PHI,105,18,1610612755,PHI,Philadelphia 76ers,PHI @ BOS,87,-18,Regular Season
22018,1610612744,GSW,Golden State Warriors,0021800002,2018-10-16T00:00:00Z,GSW vs. OKC,108,8,1610612760,OKC,Oklahoma City Thunder,OKC @ GSW,100,-8,Regular Season
22018,1610612759,SAS,San Antonio Spurs,0021800010,2018-10-17T00:00:00Z,SAS vs. MIN,112,4,1610612750,MIN,Minnesota Timberwolves,MIN @ SAS,108,-4,Regular Season
22018,1610612756,PHX,Phoenix Suns,0021800013,2018-10-17T00:00:00Z,PHX vs. DAL,121,21,1610612742,DAL,Dallas Mavericks,DAL @ PHX,100,-21,Regular Season
22018,1610612746,LAC,LA Clippers,0021800012,2018-10-17T00:00:00Z,LAC vs. DEN,98,-9,1610612743,DEN,Denver Nuggets,DEN @ LAC,107,9,Regular Season
22018,1610612752,NYK,New York Knicks,0021800007,2018-10-17T00:00:00Z,NYK vs. ATL,126,19,1610612737,ATL,Atlanta Hawks,ATL @ NYK,107,-19,Regular Season
22018,1610612758,SAC,Sacramento Kings,0021800011,2018-10-17T00:00:00Z,SAC vs. UTA,117,-6,1610612762,UTA,Utah Jazz,UTA @ SAC,123,6,Regular Season
22018,1610612745,HOU,Houston Rockets,0021800009,2018-10-17T00:00:00Z,HOU vs. NOP,112,-19,1610612740,NOP,New Orleans Pelicans,NOP @ HOU,131,19,Regular Season
22018,1610612753,ORL,Orlando Magic,0021800006,2018-10-17T00:00:00Z,ORL vs. MIA,104,3,1610612748,MIA,Miami Heat,MIA @ ORL,101,-3,Regular Season
22018,1610612754,IND,Indiana Pacers,0021800005,2018-10-17T00:00:00Z,IND vs. MEM,111,28,1610612763,MEM,Memphis Grizzlies,MEM @ IND,83,-28,Regular Season
22018,1610612765,DET,Detroit Pistons,0021800004,2018-10-17T00:00:00Z,DET vs. BKN,103,3,1610612751,BKN,Brooklyn Nets,BKN @ DET,100,-3,Regular Season
22018,1610612766,CHA,Charlotte Hornets,0021800003,2018-10-17T00:00:00Z,CHA vs. MIL,112,-1,1610612749,MIL,Milwaukee Bucks,MIL @ CHA,113,1,Regular Season
22018,1610612761,TOR,Toronto Raptors,0021800008,2018-10-17T00:00:00Z,TOR vs. CLE,116,12,1610612739,CLE,Cleveland Cavaliers,CLE @ TOR,104,-12,Regular Season
22018,1610612757,POR,Portland Trail Blazers,0021800016,2018-10-18T00:00:00Z,POR vs. LAL,128,9,1610612747,LAL,Los Angeles Lakers,LAL @ POR,119,-9,Regular Season
22018,1610612764,WAS,Washington Wizards,0021800015,2018-10-18T00:00:00Z,WAS vs. MIA,112,-1,1610612748,MIA,Miami Heat,MIA @ WAS,113,1,Regular Season
22018,1610612755,PHI,Philadelphia 76ers,0021800014,2018-10-18T00:00:00Z,PHI vs. CHI,127,19,1610612741,CHI,Chicago Bulls,CHI @ PHI,108,-19,Regular Season
22018,1610612746,LAC,LA Clippers,0021800025,2018-10-19T00:00:00Z,LAC vs. OKC,108,16,1610612760,OKC,Oklahoma City Thunder,OKC @ LAC,92,-16,Regular Season
22018,1610612751,BKN,Brooklyn Nets,0021800018,2018-10-19T00:00:00Z,BKN vs. NYK,107,2,1610612752,NYK,New York Knicks,NYK @ BKN,105,-2,Regular Season
22018,1610612750,MIN,Minnesota Timberwolves,0021800021,2018-10-19T00:00:00Z,MIN vs. CLE,131,8,1610612739,CLE,Cleveland Cavaliers,CLE @ MIN,123,-8,Regular Season
22018,1610612753,ORL,Orlando Magic,0021800017,2018-10-19T00:00:00Z,ORL vs. CHA,88,-32,1610612766,CHA,Charlotte Hornets,CHA @ ORL,120,32,Regular Season
22018,1610612749,MIL,Milwaukee Bucks,0021800023,2018-10-19T00:00:00Z,MIL vs. IND,118,17,1610612754,IND,Indiana Pacers,IND @ MIL,101,-17,Regular Season
22018,1610612761,TOR,Toronto Raptors,0021800019,2018-10-19T00:00:00Z,TOR vs. BOS,113,12,1610612738,BOS,Boston Celtics,BOS @ TOR,101,-12,Regular Season
22018,1610612762,UTA,Utah Jazz,0021800024,2018-10-19T00:00:00Z,UTA vs. GSW,123,-1,1610612744,GSW,Golden State Warriors,GSW @ UTA,124,1,Regular Season
22018,1610612763,MEM,Memphis Grizzlies,0021800020,2018-10-19T00:00:00Z,MEM vs. ATL,131,14,1610612737,ATL,Atlanta Hawks,ATL @ MEM,117,-14,Regular Season
22018,1610612740,NOP,New Orleans Pelicans,0021800022,2018-10-19T00:00:00Z,NOP vs. SAC,149,20,1610612758,SAC,Sacramento Kings,SAC @ NOP,129,-20,Regular Season
22018,1610612748,MIA,Miami Heat,0021800030,2018-10-20T00:00:00Z,MIA vs. CHA,112,-1,1610612766,CHA,Charlotte Hornets,CHA @ MIA,113,1,Regular Season
22018,1610612757,POR,Portland Trail Blazers,0021800034,2018-10-20T00:00:00Z,POR vs. SAS,121,13,1610612759,SAS,San Antonio Spurs,SAS @ POR,108,-13,Regular Season
22018,1610612754,IND,Indiana Pacers,0021800026,2018-10-20T00:00:00Z,IND vs. BKN,132,20,1610612751,BKN,Brooklyn Nets,BKN @ IND,112,-20,Regular Season
22018,1610612742,DAL,Dallas Mavericks,0021800032,2018-10-20T00:00:00Z,DAL vs. MIN,140,4,1610612750,MIN,Minnesota Timberwolves,MIN @ DAL,136,-4,Regular Season
22018,1610612747,LAL,Los Angeles Lakers,0021800035,2018-10-20T00:00:00Z,LAL vs. HOU,115,-9,1610612745,HOU,Houston Rockets,HOU @ LAL,124,9,Regular Season
22018,1610612741,CHI,Chicago Bulls,0021800031,2018-10-20T00:00:00Z,CHI vs. DET,116,-2,1610612765,DET,Detroit Pistons,DET @ CHI,118,2,Regular Season
22018,1610612764,WAS,Washington Wizards,0021800027,2018-10-20T00:00:00Z,WAS vs. TOR,113,-4,1610612761,TOR,Toronto Raptors,TOR @ WAS,117,4,Regular Season
22018,1610612752,NYK,New York Knicks,0021800028,2018-10-20T00:00:00Z,NYK vs. BOS,101,-2,1610612738,BOS,Boston Celtics,BOS @ NYK,103,2,Regular Season
22018,1610612743,DEN,Denver Nuggets,0021800033,2018-10-20T00:00:00Z,DEN vs. PHX,119,28,1610612756,PHX,Phoenix Suns,PHX @ DEN,91,-28,Regular Season
22018,1610612755,PHI,Philadelphia 76ers,0021800029,2018-10-20T00:00:00Z,PHI vs. ORL,116,1,1610612753,ORL,Orlando Magic,ORL @ PHI,115,-1,Regular Season
22018,1610612743,DEN,Denver Nuggets,0021800038,2018-10-21T00:00:00Z,DEN vs. GSW,100,2,1610612744,GSW,Golden State Warriors,GSW @ DEN,98,-2,Regular Season
22018,1610612746,LAC,LA Clippers,0021800039,2018-10-21T00:00:00Z,LAC vs. HOU,115,3,1610612745,HOU,Houston Rockets,HOU @ LAC,112,-3,Regular Season
22018,1610612739,CLE,Cleveland Cavaliers,0021800036,2018-10-21T00:00:00Z,CLE vs. ATL,111,-22,1610612737,ATL,Atlanta Hawks,ATL @ CLE,133,22,Regular Season
22018,1610612760,OKC,Oklahoma City Thunder,0021800037,2018-10-21T00:00:00Z,OKC vs. SAC,120,-11,1610612758,SAC,Sacramento Kings,SAC @ OKC,131,11,Regular Season
22018,1610612749,MIL,Milwaukee Bucks,0021800042,2018-10-22T00:00:00Z,MIL vs. NYK,124,11,1610612752,NYK,New York Knicks,NYK @ MIL,113,-11,Regular Season
22018,1610612757,POR,Portland Trail Blazers,0021800046,2018-10-22T00:00:00Z,POR vs. WAS,124,-1,1610612764,WAS,Washington Wizards,WAS @ POR,125,1,Regular Season
22018,1610612747,LAL,Los Angeles Lakers,0021800048,2018-10-22T00:00:00Z,LAL vs. SAS,142,-1,1610612759,SAS,San Antonio Spurs,SAS @ LAL,143,1,Regular Season
22018,1610612761,TOR,Toronto Raptors,0021800041,2018-10-22T00:00:00Z,TOR vs. CHA,127,21,1610612766,CHA,Charlotte Hornets,CHA @ TOR,106,-21,Regular Season
22018,1610612742,DAL,Dallas Mavericks,0021800044,2018-10-22T00:00:00Z,DAL vs. CHI,115,6,1610612741,CHI,Chicago Bulls,CHI @ DAL,109,-6,Regular Season
22018,1610612744,GSW,Golden State Warriors,0021800047,2018-10-22T00:00:00Z,GSW vs. PHX,123,20,1610612756,PHX,Phoenix Suns,PHX @ GSW,103,-20,Regular Season
22018,1610612738,BOS,Boston Celtics,0021800040,2018-10-22T00:00:00Z,BOS vs. ORL,90,-3,1610612753,ORL,Orlando Magic,ORL @ BOS,93,3,Regular Season
22018,1610612762,UTA,Utah Jazz,0021800045,2018-10-22T00:00:00Z,UTA vs. MEM,84,-8,1610612763,MEM,Memphis Grizzlies,MEM @ UTA,92,8,Regular Season
22018,1610612750,MIN,Minnesota Timberwolves,0021800043,2018-10-22T00:00:00Z,MIN vs. IND,101,10,1610612754,IND,Indiana Pacers,IND @ MIN,91,-10,Regular Season
22018,1610612743,DEN,Denver Nuggets,0021800051,2018-10-23T00:00:00Z,DEN vs. SAC,126,14,1610612758,SAC,Sacramento Kings,SAC @ DEN,112,-14,Regular Season
22018,1610612740,NOP,New Orleans Pelicans,0021800050,2018-10-23T00:00:00Z,NOP vs. LAC,116,7,1610612746,LAC,LA Clippers,LAC @ NOP,109,-7,Regular Season
22018,1610612765,DET,Detroit Pistons,0021800049,2018-10-23T00:00:00Z,DET vs. PHI,133,1,1610612755,PHI,Philadelphia 76ers,PHI @ DET,132,-1,Regular Season
22018,1610612756,PHX,Phoenix Suns,0021800060,2018-10-24T00:00:00Z,PHX vs. LAL,113,-18,1610612747,LAL,Los Angeles Lakers,LAL @ PHX,131,18,Regular Season
22018,1610612758,SAC,Sacramento Kings,0021800061,2018-10-24T00:00:00Z,SAC vs. MEM,97,5,1610612763,MEM,Memphis Grizzlies,MEM @ SAC,92,-5,Regular Season
22018,1610612761,TOR,Toronto Raptors,0021800055,2018-10-24T00:00:00Z,TOR vs. MIN,112,7,1610612750,MIN,Minnesota Timberwolves,MIN @ TOR,105,-7,Regular Season
22018,1610612741,CHI,Chicago Bulls,0021800056,2018-10-24T00:00:00Z,CHI vs. CHA,112,2,1610612766,CHA,Charlotte Hornets,CHA @ CHI,110,-2,Regular Season
22018,1610612749,MIL,Milwaukee Bucks,0021800059,2018-10-24T00:00:00Z,MIL vs. PHI,123,15,1610612755,PHI,Philadelphia 76ers,PHI @ MIL,108,-15,Regular Season
22018,1610612759,SAS,San Antonio Spurs,0021800058,2018-10-24T00:00:00Z,SAS vs. IND,96,-20,1610612754,IND,Indiana Pacers,IND @ SAS,116,20,Regular Season
22018,1610612745,HOU,Houston Rockets,0021800057,2018-10-24T00:00:00Z,HOU vs. UTA,89,-11,1610612762,UTA,Utah Jazz,UTA @ HOU,100,11,Regular Season
22018,1610612737,ATL,Atlanta Hawks,0021800052,2018-10-24T00:00:00Z,ATL vs. DAL,111,7,1610612742,DAL,Dallas Mavericks,DAL @ ATL,104,-7,Regular Season
22018,1610612748,MIA,Miami Heat,0021800054,2018-10-24T00:00:00Z,MIA vs. NYK,110,23,1610612752,NYK,New York Knicks,NYK @ MIA,87,-23,Regular Season
22018,1610612739,CLE,Cleveland Cavaliers,0021800053,2018-10-24T00:00:00Z,CLE vs. BKN,86,-16,1610612751,BKN,Brooklyn Nets,BKN @ CLE,102,16,Regular Season
22018,1610612744,GSW,Golden State Warriors,0021800062,2018-10-24T00:00:00Z,GSW vs. WAS,144,22,1610612764,WAS,Washington Wizards,WAS @ GSW,122,-22,Regular Season
22018,1610612747,LAL,Los Angeles Lakers,0021800066,2018-10-25T00:00:00Z,LAL vs. DEN,121,7,1610612743,DEN,Denver Nuggets,DEN @ LAL,114,-7,Regular Season
22018,1610612760,OKC,Oklahoma City Thunder,0021800065,2018-10-25T00:00:00Z,OKC vs. BOS,95,-6,1610612738,BOS,Boston Celtics,BOS @ OKC,101,6,Regular Season
22018,1610612753,ORL,Orlando Magic,0021800064,2018-10-25T00:00:00Z,ORL vs. POR,114,-14,1610612757,POR,Portland Trail Blazers,POR @ ORL,128,14,Regular Season
22018,1610612765,DET,Detroit Pistons,0021800063,2018-10-25T00:00:00Z,DET vs. CLE,110,7,1610612739,CLE,Cleveland Cavaliers,CLE @ DET,103,-7,Regular Season
22018,1610612750,MIN,Minnesota Timberwolves,0021800071,2018-10-26T00:00:00Z,MIN vs. MIL,95,-30,1610612749,MIL,Milwaukee Bucks,MIL @ MIN,125,30,Regular Season
22018,1610612740,NOP,New Orleans Pelicans,0021800072,2018-10-26T00:00:00Z,NOP vs. BKN,117,2,1610612751,BKN,Brooklyn Nets,BKN @ NOP,115,-2,Regular Season
22018,1610612761,TOR,Toronto Raptors,0021800069,2018-10-26T00:00:00Z,TOR vs. DAL,116,9,1610612742,DAL,Dallas Mavericks,DAL @ TOR,107,-9,Regular Season
22018,1610612752,NYK,New York Knicks,0021800068,2018-10-26T00:00:00Z,NYK vs. GSW,100,-28,1610612744,GSW,Golden State Warriors,GSW @ NYK,128,28,Regular Season
22018,1610612758,SAC,Sacramento Kings,0021800073,2018-10-26T00:00:00Z,SAC vs. WAS,116,4,1610612764,WAS,Washington Wizards,WAS @ SAC,112,-4,Regular Season
22018,1610612766,CHA,Charlotte Hornets,0021800067,2018-10-26T00:00:00Z,CHA vs. CHI,135,29,1610612741,CHI,Chicago Bulls,CHI @ CHA,106,-29,Regular Season
22018,1610612745,HOU,Houston Rockets,0021800070,2018-10-26T00:00:00Z,HOU vs. LAC,113,-20,1610612746,LAC,LA Clippers,LAC @ HOU,133,20,Regular Season
22018,1610612763,MEM,Memphis Grizzlies,0021800080,2018-10-27T00:00:00Z,MEM vs. PHX,117,21,1610612756,PHX,Phoenix Suns,PHX @ MEM,96,-21,Regular Season
22018,1610612759,SAS,San Antonio Spurs,0021800082,2018-10-27T00:00:00Z,SAS vs. LAL,110,4,1610612747,LAL,Los Angeles Lakers,LAL @ SAS,106,-4,Regular Season
22018,1610612748,MIA,Miami Heat,0021800079,2018-10-27T00:00:00Z,MIA vs. POR,120,9,1610612757,POR,Portland Trail Blazers,POR @ MIA,111,-9,Regular Season
22018,1610612755,PHI,Philadelphia 76ers,0021800078,2018-10-27T00:00:00Z,PHI vs. CHA,105,2,1610612766,CHA,Charlotte Hornets,CHA @ PHI,103,-2,Regular Season
22018,1610612739,CLE,Cleveland Cavaliers,0021800077,2018-10-27T00:00:00Z,CLE vs. IND,107,-12,1610612754,IND,Indiana Pacers,IND @ CLE,119,12,Regular Season
22018,1610612737,ATL,Atlanta Hawks,0021800076,2018-10-27T00:00:00Z,ATL vs. CHI,85,-12,1610612741,CHI,Chicago Bulls,CHI @ ATL,97,12,Regular Season
22018,1610612749,MIL,Milwaukee Bucks,0021800081,2018-10-27T00:00:00Z,MIL vs. ORL,113,22,1610612753,ORL,Orlando Magic,ORL @ MIL,91,-22,Regular Season
22018,1610612765,DET,Detroit Pistons,0021800074,2018-10-27T00:00:00Z,DET vs. BOS,89,-20,1610612738,BOS,Boston Celtics,BOS @ DET,109,20,Regular Season
22018,1610612740,NOP,New Orleans Pelicans,0021800075,2018-10-27T00:00:00Z,NOP vs. UTA,111,-21,1610612762,UTA,Utah Jazz,UTA @ NOP,132,21,Regular Season
22018,1610612760,OKC,Oklahoma City Thunder,0021800085,2018-10-28T00:00:00Z,OKC vs. PHX,117,7,1610612756,PHX,Phoenix Suns,PHX @ OKC,110,-7,Regular Season
22018,1610612746,LAC,LA Clippers,0021800086,2018-10-28T00:00:00Z,LAC vs. WAS,136,32,1610612764,WAS,Washington Wizards,WAS @ LAC,104,-32,Regular Season
22018,1610612751,BKN,Brooklyn Nets,0021800083,2018-10-28T00:00:00Z,BKN vs. GSW,114,-6,1610612744,GSW,Golden State Warriors,GSW @ BKN,120,6,Regular Season
22018,1610612742,DAL,Dallas Mavericks,0021800084,2018-10-28T00:00:00Z,DAL vs. UTA,104,-9,1610612762,UTA,Utah Jazz,UTA @ DAL,113,9,Regular Season
22018,1610612752,NYK,New York Knicks,0021800090,2018-10-29T00:00:00Z,NYK vs. BKN,115,19,1610612751,BKN,Brooklyn Nets,BKN @ NYK,96,-19,Regular Season
22018,1610612748,MIA,Miami Heat,0021800089,2018-10-29T00:00:00Z,MIA vs. SAC,113,-10,1610612758,SAC,Sacramento Kings,SAC @ MIA,123,10,Regular Season
22018,1610612749,MIL,Milwaukee Bucks,0021800092,2018-10-29T00:00:00Z,MIL vs. TOR,124,15,1610612761,TOR,Toronto Raptors,TOR @ MIL,109,-15,Regular Season
22018,1610612741,CHI,Chicago Bulls,0021800091,2018-10-29T00:00:00Z,CHI vs. GSW,124,-25,1610612744,GSW,Golden State Warriors,GSW @ CHI,149,25,Regular Season
22018,1610612754,IND,Indiana Pacers,0021800087,2018-10-29T00:00:00Z,IND vs. POR,93,-10,1610612757,POR,Portland Trail Blazers,POR @ IND,103,10,Regular Season
22018,1610612750,MIN,Minnesota Timberwolves,0021800093,2018-10-29T00:00:00Z,MIN vs. LAL,124,4,1610612747,LAL,Los Angeles Lakers,LAL @ MIN,120,-4,Regular Season
22018,1610612759,SAS,San Antonio Spurs,0021800094,2018-10-29T00:00:00Z,SAS vs. DAL,113,5,1610612742,DAL,Dallas Mavericks,DAL @ SAS,108,-5,Regular Season
22018,1610612743,DEN,Denver Nuggets,0021800095,2018-10-29T00:00:00Z,DEN vs. NOP,116,5,1610612740,NOP,New Orleans Pelicans,NOP @ DEN,111,-5,Regular Season
22018,1610612755,PHI,Philadelphia 76ers,0021800088,2018-10-29T00:00:00Z,PHI vs. ATL,113,21,1610612737,ATL,Atlanta Hawks,ATL @ PHI,92,-21,Regular Season
22018,1610612766,CHA,Charlotte Hornets,0021800096,2018-10-30T00:00:00Z,CHA vs. MIA,125,12,1610612748,MIA,Miami Heat,MIA @ CHA,113,-12,Regular Season
22018,1610612739,CLE,Cleveland Cavaliers,0021800097,2018-10-30T00:00:00Z,CLE vs. ATL,136,22,1610612737,ATL,Atlanta Hawks,ATL @ CLE,114,-22,Regular Season
22018,1610612745,HOU,Houston Rockets,0021800101,2018-10-30T00:00:00Z,HOU vs. POR,85,-19,1610612757,POR,Portland Trail Blazers,POR @ HOU,104,19,Regular Season
22018,1610612738,BOS,Boston Celtics,0021800099,2018-10-30T00:00:00Z,BOS vs. DET,108,3,1610612765,DET,Detroit Pistons,DET @ BOS,105,-3,Regular Season
22018,1610612760,OKC,Oklahoma City Thunder,0021800103,2018-10-30T00:00:00Z,OKC vs. LAC,128,18,1610612746,LAC,LA Clippers,LAC @ OKC,110,-18,Regular Season
22018,1610612763,MEM,Memphis Grizzlies,0021800102,2018-10-30T00:00:00Z,MEM vs. WAS,107,12,1610612764,WAS,Washington Wizards,WAS @ MEM,95,-12,Regular Season
22018,1610612753,ORL,Orlando Magic,0021800098,2018-10-30T00:00:00Z,ORL vs. SAC,99,-8,1610612758,SAC,Sacramento Kings,SAC @ ORL,107,8,Regular Season
22018,1610612761,TOR,Toronto Raptors,0021800100,2018-10-30T00:00:00Z,TOR vs. PHI,129,17,1610612755,PHI,Philadelphia 76ers,PHI @ TOR,112,-17,Regular Season
22018,1610612756,PHX,Phoenix Suns,0021800110,2018-10-31T00:00:00Z,PHX vs. SAS,90,-30,1610612759,SAS,San Antonio Spurs,SAS @ PHX,120,30,Regular Season
22018,1610612744,GSW,Golden State Warriors,0021800108,2018-10-31T00:00:00Z,GSW vs. NOP,131,10,1610612740,NOP,New Orleans Pelicans,NOP @ GSW,121,-10,Regular Season
22018,1610612750,MIN,Minnesota Timberwolves,0021800107,2018-10-31T00:00:00Z,MIN vs. UTA,128,3,1610612762,UTA,Utah Jazz,UTA @ MIN,125,-3,Regular Season
22018,1610612752,NYK,New York Knicks,0021800105,2018-10-31T00:00:00Z,NYK vs. IND,101,-6,1610612754,IND,Indiana Pacers,IND @ NYK,107,6,Regular Season
22018,1610612751,BKN,Brooklyn Nets,0021800104,2018-10-31T00:00:00Z,BKN vs. DET,120,1,1610612765,DET,Detroit Pistons,DET @ BKN,119,-1,Regular Season
22018,1610612741,CHI,Chicago Bulls,0021800106,2018-10-31T00:00:00Z,CHI vs. DEN,107,-1,1610612743,DEN,Denver Nuggets,DEN @ CHI,108,1,Regular Season
22018,1610612747,LAL,Los Angeles Lakers,0021800109,2018-10-31T00:00:00Z,LAL vs. DAL,114,1,1610612742,DAL,Dallas Mavericks,DAL @ LAL,113,-1,Regular Season
22018,1610612757,POR,Portland Trail Blazers,0021800116,2018-11-01T00:00:00Z,POR vs. NOP,132,13,1610612740,NOP,New Orleans Pelicans,NOP @ POR,119,-13,Regular Season
22018,1610612738,BOS,Boston Celtics,0021800115,2018-11-01T00:00:00Z,BOS vs. MIL,117,4,1610612749,MIL,Milwaukee Bucks,MIL @ BOS,113,-4,Regular Season
22018,1610612739,CLE,Cleveland Cavaliers,0021800112,2018-11-01T00:00:00Z,CLE vs. DEN,91,-19,1610612743,DEN,Denver Nuggets,DEN @ CLE,110,19,Regular Season
22018,1610612766,CHA,Charlotte Hornets,0021800111,2018-11-01T00:00:00Z,CHA vs. OKC,107,-4,1610612760,OKC,Oklahoma City Thunder,OKC @ CHA,111,4,Regular Season
22018,1610612737,ATL,Atlanta Hawks,0021800114,2018-11-01T00:00:00Z,ATL vs. SAC,115,-31,1610612758,SAC,Sacramento Kings,SAC @ ATL,146,31,Regular Season
22018,1610612755,PHI,Philadelphia 76ers,0021800113,2018-11-01T00:00:00Z,PHI vs. LAC,122,9,1610612746,LAC,LA Clippers,LAC @ PHI,113,-9,Regular Season
22018,1610612764,WAS,Washington Wizards,0021800119,2018-11-02T00:00:00Z,WAS vs. OKC,111,-23,1610612760,OKC,Oklahoma City Thunder,OKC @ WAS,134,23,Regular Season
22018,1610612753,ORL,Orlando Magic,0021800117,2018-11-02T00:00:00Z,ORL vs. LAC,95,-25,1610612746,LAC,LA Clippers,LAC @ ORL,120,25,Regular Season
22018,1610612756,PHX,Phoenix Suns,0021800123,2018-11-02T00:00:00Z,PHX vs. TOR,98,-9,1610612761,TOR,Toronto Raptors,TOR @ PHX,107,9,Regular Season
22018,1610612742,DAL,Dallas Mavericks,0021800121,2018-11-02T00:00:00Z,DAL vs. NYK,106,-12,1610612752,NYK,New York Knicks,NYK @ DAL,118,12,Regular Season
22018,1610612751,BKN,Brooklyn Nets,0021800118,2018-11-02T00:00:00Z,BKN vs. HOU,111,-8,1610612745,HOU,Houston Rockets,HOU @ BKN,119,8,Regular Season
22018,1610612741,CHI,Chicago Bulls,0021800120,2018-11-02T00:00:00Z,CHI vs. IND,105,-2,1610612754,IND,Indiana Pacers,IND @ CHI,107,2,Regular Season
22018,1610612744,GSW,Golden State Warriors,0021800124,2018-11-02T00:00:00Z,GSW vs. MIN,116,17,1610612750,MIN,Minnesota Timberwolves,MIN @ GSW,99,-17,Regular Season
22018,1610612762,UTA,Utah Jazz,0021800122,2018-11-02T00:00:00Z,UTA vs. MEM,100,-10,1610612763,MEM,Memphis Grizzlies,MEM @ UTA,110,10,Regular Season
22018,1610612754,IND,Indiana Pacers,0021800127,2018-11-03T00:00:00Z,IND vs. BOS,102,1,1610612738,BOS,Boston Celtics,BOS @ IND,101,-1,Regular Season
22018,1610612737,ATL,Atlanta Hawks,0021800128,2018-11-03T00:00:00Z,ATL vs. MIA,123,5,1610612748,MIA,Miami Heat,MIA @ ATL,118,-5,Regular Season
22018,1610612755,PHI,Philadelphia 76ers,0021800125,2018-11-03T00:00:00Z,PHI vs. DET,109,10,1610612765,DET,Detroit Pistons,DET @ PHI,99,-10,Regular Season
22018,1610612766,CHA,Charlotte Hornets,0021800126,2018-11-03T00:00:00Z,CHA vs. CLE,126,32,1610612739,CLE,Cleveland Cavaliers,CLE @ CHA,94,-32,Regular Season
22018,1610612743,DEN,Denver Nuggets,0021800131,2018-11-03T00:00:00Z,DEN vs. UTA,103,15,1610612762,UTA,Utah Jazz,UTA @ DEN,88,-15,Regular Season
22018,1610612757,POR,Portland Trail Blazers,0021800132,2018-11-03T00:00:00Z,POR vs. LAL,110,-4,1610612747,LAL,Los Angeles Lakers,LAL @ POR,114,4,Regular Season
22018,1610612741,CHI,Chicago Bulls,0021800129,2018-11-03T00:00:00Z,CHI vs. HOU,88,-8,1610612745,HOU,Houston Rockets,HOU @ CHI,96,8,Regular Season
22018,1610612759,SAS,San Antonio Spurs,0021800130,2018-11-03T00:00:00Z,SAS vs. NOP,109,14,1610612740,NOP,New Orleans Pelicans,NOP @ SAS,95,-14,Regular Season
22018,1610612759,SAS,San Antonio Spurs,0021800137,2018-11-04T00:00:00Z,SAS vs. ORL,110,-7,1610612753,ORL,Orlando Magic,ORL @ SAS,117,7,Regular Season
22018,1610612751,BKN,Brooklyn Nets,0021800134,2018-11-04T00:00:00Z,BKN vs. PHI,122,25,1610612755,PHI,Philadelphia 76ers,PHI @ BKN,97,-25,Regular Season
22018,1610612757,POR,Portland Trail Blazers,0021800138,2018-11-04T00:00:00Z,POR vs. MIN,111,30,1610612750,MIN,Minnesota Timberwolves,MIN @ POR,81,-30,Regular Season
22018,1610612756,PHX,Phoenix Suns,0021800136,2018-11-04T00:00:00Z,PHX vs. MEM,102,2,1610612763,MEM,Memphis Grizzlies,MEM @ PHX,100,-2,Regular Season
22018,1610612764,WAS,Washington Wizards,0021800135,2018-11-04T00:00:00Z,WAS vs. NYK,108,13,1610612752,NYK,New York Knicks,NYK @ WAS,95,-13,Regular Season
22018,1610612749,MIL,Milwaukee Bucks,0021800133,2018-11-04T00:00:00Z,MIL vs. SAC,144,35,1610612758,SAC,Sacramento Kings,SAC @ MIL,109,-35,Regular Season
22018,1610612747,LAL,Los Angeles Lakers,0021800139,2018-11-04T00:00:00Z,LAL vs. TOR,107,-14,1610612761,TOR,Toronto Raptors,TOR @ LAL,121,14,Regular Season
22018,1610612746,LAC,LA Clippers,0021800148,2018-11-05T00:00:00Z,LAC vs. MIN,120,11,1610612750,MIN,Minnesota Timberwolves,MIN @ LAC,109,-11,Regular Season
22018,1610612743,DEN,Denver Nuggets,0021800145,2018-11-05T00:00:00Z,DEN vs. BOS,115,8,1610612738,BOS,Boston Celtics,BOS @ DEN,107,-8,Regular Season
22018,1610612760,OKC,Oklahoma City Thunder,0021800144,2018-11-05T00:00:00Z,OKC vs. NOP,122,6,1610612740,NOP,New Orleans Pelicans,NOP @ OKC,116,-6,Regular Season
22018,1610612744,GSW,Golden State Warriors,0021800147,2018-11-05T00:00:00Z,GSW vs. MEM,117,16,1610612763,MEM,Memphis Grizzlies,MEM @ GSW,101,-16,Regular Season
22018,1610612754,IND,Indiana Pacers,0021800141,2018-11-05T00:00:00Z,IND vs. HOU,94,-4,1610612745,HOU,Houston Rockets,HOU @ IND,98,4,Regular Season
22018,1610612752,NYK,New York Knicks,0021800143,2018-11-05T00:00:00Z,NYK vs. CHI,115,-1,1610612741,CHI,Chicago Bulls,CHI @ NYK,116,1,Regular Season
22018,1610612753,ORL,Orlando Magic,0021800142,2018-11-05T00:00:00Z,ORL vs. CLE,102,2,1610612739,CLE,Cleveland Cavaliers,CLE @ ORL,100,-2,Regular Season
22018,1610612765,DET,Detroit Pistons,0021800140,2018-11-05T00:00:00Z,DET vs. MIA,115,-5,1610612748,MIA,Miami Heat,MIA @ DET,120,5,Regular Season
22018,1610612762,UTA,Utah Jazz,0021800146,2018-11-05T00:00:00Z,UTA vs. TOR,111,-13,1610612761,TOR,Toronto Raptors,TOR @ UTA,124,13,Regular Season
22018,1610612742,DAL,Dallas Mavericks,0021800150,2018-11-06T00:00:00Z,DAL vs. WAS,119,19,1610612764,WAS,Washington Wizards,WAS @ DAL,100,-19,Regular Season
22018,1610612756,PHX,Phoenix Suns,0021800151,2018-11-06T00:00:00Z,PHX vs. BKN,82,-22,1610612751,BKN,Brooklyn Nets,BKN @ PHX,104,22,Regular Season
22018,1610612757,POR,Portland Trail Blazers,0021800152,2018-11-06T00:00:00Z,POR vs. MIL,118,15,1610612749,MIL,Milwaukee Bucks,MIL @ POR,103,-15,Regular Season
22018,1610612766,CHA,Charlotte Hornets,0021800149,2018-11-06T00:00:00Z,CHA vs. ATL,113,11,1610612737,ATL,Atlanta Hawks,ATL @ CHA,102,-11,Regular Season
22018,1610612762,UTA,Utah Jazz,0021800160,2018-11-07T00:00:00Z,UTA vs. DAL,117,15,1610612742,DAL,Dallas Mavericks,DAL @ UTA,102,-15,Regular Season
22018,1610612763,MEM,Memphis Grizzlies,0021800158,2018-11-07T00:00:00Z,MEM vs. DEN,89,2,1610612743,DEN,Denver Nuggets,DEN @ MEM,87,-2,Regular Season
22018,1610612747,LAL,Los Angeles Lakers,0021800162,2018-11-07T00:00:00Z,LAL vs. MIN,114,4,1610612750,MIN,Minnesota Timberwolves,MIN @ LAL,110,-4,Regular Season
22018,1610612739,CLE,Cleveland Cavaliers,0021800153,2018-11-07T00:00:00Z,CLE vs. OKC,86,-9,1610612760,OKC,Oklahoma City Thunder,OKC @ CLE,95,9,Regular Season
22018,1610612754,IND,Indiana Pacers,0021800157,2018-11-07T00:00:00Z,IND vs. PHI,94,-6,1610612755,PHI,Philadelphia 76ers,PHI @ IND,100,6,Regular Season
22018,1610612740,NOP,New Orleans Pelicans,0021800159,2018-11-07T00:00:00Z,NOP vs. CHI,107,9,1610612741,CHI,Chicago Bulls,CHI @ NOP,98,-9,Regular Season
22018,1610612748,MIA,Miami Heat,0021800156,2018-11-07T00:00:00Z,MIA vs. SAS,95,7,1610612759,SAS,San Antonio Spurs,SAS @ MIA,88,-7,Regular Season
22018,1610612737,ATL,Atlanta Hawks,0021800155,2018-11-07T00:00:00Z,ATL vs. NYK,107,-5,1610612752,NYK,New York Knicks,NYK @ ATL,112,5,Regular Season
22018,1610612753,ORL,Orlando Magic,0021800154,2018-11-07T00:00:00Z,ORL vs. DET,96,-7,1610612765,DET,Detroit Pistons,DET @ ORL,103,7,Regular Season
22018,1610612758,SAC,Sacramento Kings,0021800161,2018-11-07T00:00:00Z,SAC vs. TOR,105,-9,1610612761,TOR,Toronto Raptors,TOR @ SAC,114,9,Regular Season
22018,1610612757,POR,Portland Trail Blazers,0021800165,2018-11-08T00:00:00Z,POR vs. LAC,116,11,1610612746,LAC,LA Clippers,LAC @ POR,105,-11,Regular Season
22018,1610612756,PHX,Phoenix Suns,0021800164,2018-11-08T00:00:00Z,PHX vs. BOS,109,-7,1610612738,BOS,Boston Celtics,BOS @ PHX,116,7,Regular Season
22018,1610612744,GSW,Golden State Warriors,0021800166,2018-11-08T00:00:00Z,GSW vs. MIL,111,-23,1610612749,MIL,Milwaukee Bucks,MIL @ GSW,134,23,Regular Season
22018,1610612760,OKC,Oklahoma City Thunder,0021800163,2018-11-08T00:00:00Z,OKC vs. HOU,98,18,1610612745,HOU,Houston Rockets,HOU @ OKC,80,-18,Regular Season
22018,1610612737,ATL,Atlanta Hawks,0021800169,2018-11-09T00:00:00Z,ATL vs. DET,109,-15,1610612765,DET,Detroit Pistons,DET @ ATL,124,15,Regular Season
22018,1610612758,SAC,Sacramento Kings,0021800173,2018-11-09T00:00:00Z,SAC vs. MIN,121,11,1610612750,MIN,Minnesota Timberwolves,MIN @ SAC,110,-11,Regular Season
22018,1610612762,UTA,Utah Jazz,0021800172,2018-11-09T00:00:00Z,UTA vs. BOS,123,8,1610612738,BOS,Boston Celtics,BOS @ UTA,115,-8,Regular Season
22018,1610612753,ORL,Orlando Magic,0021800167,2018-11-09T00:00:00Z,ORL vs. WAS,117,9,1610612764,WAS,Washington Wizards,WAS @ ORL,108,-9,Regular Season
22018,1610612755,PHI,Philadelphia 76ers,0021800168,2018-11-09T00:00:00Z,PHI vs. CHA,133,1,1610612766,CHA,Charlotte Hornets,CHA @ PHI,132,-1,Regular Season
22018,1610612743,DEN,Denver Nuggets,0021800171,2018-11-09T00:00:00Z,DEN vs. BKN,110,-2,1610612751,BKN,Brooklyn Nets,BKN @ DEN,112,2,Regular Season
22018,1610612748,MIA,Miami Heat,0021800170,2018-11-09T00:00:00Z,MIA vs. IND,102,-8,1610612754,IND,Indiana Pacers,IND @ MIA,110,8,Regular Season
22018,1610612742,DAL,Dallas Mavericks,0021800181,2018-11-10T00:00:00Z,DAL vs. OKC,111,15,1610612760,OKC,Oklahoma City Thunder,OKC @ DAL,96,-15,Regular Season
22018,1610612741,CHI,Chicago Bulls,0021800178,2018-11-10T00:00:00Z,CHI vs. CLE,99,1,1610612739,CLE,Cleveland Cavaliers,CLE @ CHI,98,-1,Regular Season
22018,1610612758,SAC,Sacramento Kings,0021800183,2018-11-10T00:00:00Z,SAC vs. LAL,86,-15,1610612747,LAL,Los Angeles Lakers,LAL @ SAC,101,15,Regular Season
22018,1610612761,TOR,Toronto Raptors,0021800174,2018-11-10T00:00:00Z,TOR vs. NYK,128,16,1610612752,NYK,New York Knicks,NYK @ TOR,112,-16,Regular Season
22018,1610612740,NOP,New Orleans Pelicans,0021800176,2018-11-10T00:00:00Z,NOP vs. PHX,119,20,1610612756,PHX,Phoenix Suns,PHX @ NOP,99,-20,Regular Season
22018,1610612744,GSW,Golden State Warriors,0021800182,2018-11-10T00:00:00Z,GSW vs. BKN,116,16,1610612751,BKN,Brooklyn Nets,BKN @ GSW,100,-16,Regular Season
22018,1610612759,SAS,San Antonio Spurs,0021800180,2018-11-10T00:00:00Z,SAS vs. HOU,96,7,1610612745,HOU,Houston Rockets,HOU @ SAS,89,-7,Regular Season
22018,1610612748,MIA,Miami Heat,0021800177,2018-11-10T00:00:00Z,MIA vs. WAS,110,-6,1610612764,WAS,Washington Wizards,WAS @ MIA,116,6,Regular Season
22018,1610612746,LAC,LA Clippers,0021800175,2018-11-10T00:00:00Z,LAC vs. MIL,128,2,1610612749,MIL,Milwaukee Bucks,MIL @ LAC,126,-2,Regular Season
22018,1610612763,MEM,Memphis Grizzlies,0021800179,2018-11-10T00:00:00Z,MEM vs. PHI,112,6,1610612755,PHI,Philadelphia 76ers,PHI @ MEM,106,-6,Regular Season
22018,1610612752,NYK,New York Knicks,0021800186,2018-11-11T00:00:00Z,NYK vs. ORL,89,-26,1610612753,ORL,Orlando Magic,ORL @ NYK,115,26,Regular Season
22018,1610612745,HOU,Houston Rockets,0021800185,2018-11-11T00:00:00Z,HOU vs. IND,115,12,1610612754,IND,Indiana Pacers,IND @ HOU,103,-12,Regular Season
22018,1610612757,POR,Portland Trail Blazers,0021800188,2018-11-11T00:00:00Z,POR vs. BOS,100,6,1610612738,BOS,Boston Celtics,BOS @ POR,94,-6,Regular Season
22018,1610612765,DET,Detroit Pistons,0021800184,2018-11-11T00:00:00Z,DET vs. CHA,103,-10,1610612766,CHA,Charlotte Hornets,CHA @ DET,113,10,Regular Season
22018,1610612747,LAL,Los Angeles Lakers,0021800189,2018-11-11T00:00:00Z,LAL vs. ATL,107,1,1610612737,ATL,Atlanta Hawks,ATL @ LAL,106,-1,Regular Season
22018,1610612743,DEN,Denver Nuggets,0021800187,2018-11-11T00:00:00Z,DEN vs. MIL,114,-7,1610612749,MIL,Milwaukee Bucks,MIL @ DEN,121,7,Regular Season
22018,1610612761,TOR,Toronto Raptors,0021800192,2018-11-12T00:00:00Z,TOR vs. NOP,110,-16,1610612740,NOP,New Orleans Pelicans,NOP @ TOR,126,16,Regular Season
22018,1610612764,WAS,Washington Wizards,0021800190,2018-11-12T00:00:00Z,WAS vs. ORL,117,8,1610612753,ORL,Orlando Magic,ORL @ WAS,109,-8,Regular Season
22018,1610612746,LAC,LA Clippers,0021800198,2018-11-12T00:00:00Z,LAC vs. GSW,121,5,1610612744,GSW,Golden State Warriors,GSW @ LAC,116,-5,Regular Season
22018,1610612758,SAC,Sacramento Kings,0021800197,2018-11-12T00:00:00Z,SAC vs. SAS,104,5,1610612759,SAS,San Antonio Spurs,SAS @ SAC,99,-5,Regular Season
22018,1610612748,MIA,Miami Heat,0021800191,2018-11-12T00:00:00Z,MIA vs. PHI,114,-10,1610612755,PHI,Philadelphia 76ers,PHI @ MIA,124,10,Regular Season
22018,1610612763,MEM,Memphis Grizzlies,0021800194,2018-11-12T00:00:00Z,MEM vs. UTA,88,-8,1610612762,UTA,Utah Jazz,UTA @ MEM,96,8,Regular Season
22018,1610612760,OKC,Oklahoma City Thunder,0021800196,2018-11-12T00:00:00Z,OKC vs. PHX,118,17,1610612756,PHX,Phoenix Suns,PHX @ OKC,101,-17,Regular Season
22018,1610612741,CHI,Chicago Bulls,0021800193,2018-11-12T00:00:00Z,CHI vs. DAL,98,-5,1610612742,DAL,Dallas Mavericks,DAL @ CHI,103,5,Regular Season
22018,1610612750,MIN,Minnesota Timberwolves,0021800195,2018-11-12T00:00:00Z,MIN vs. BKN,120,7,1610612751,BKN,Brooklyn Nets,BKN @ MIN,113,-7,Regular Season
22018,1610612743,DEN,Denver Nuggets,0021800200,2018-11-13T00:00:00Z,DEN vs. HOU,99,-10,1610612745,HOU,Houston Rockets,HOU @ DEN,109,10,Regular Season
22018,1610612739,CLE,Cleveland Cavaliers,0021800199,2018-11-13T00:00:00Z,CLE vs. CHA,113,24,1610612766,CHA,Charlotte Hornets,CHA @ CLE,89,-24,Regular Season
22018,1610612744,GSW,Golden State Warriors,0021800201,2018-11-13T00:00:00Z,GSW vs. ATL,110,7,1610612737,ATL,Atlanta Hawks,ATL @ GSW,103,-7,Regular Season
22018,1610612747,LAL,Los Angeles Lakers,0021800212,2018-11-14T00:00:00Z,LAL vs. POR,126,9,1610612757,POR,Portland Trail Blazers,POR @ LAL,117,-9,Regular Season
22018,1610612761,TOR,Toronto Raptors,0021800206,2018-11-14T00:00:00Z,TOR vs. DET,104,-2,1610612765,DET,Detroit Pistons,DET @ TOR,106,2,Regular Season
22018,1610612764,WAS,Washington Wizards,0021800203,2018-11-14T00:00:00Z,WAS vs. CLE,119,24,1610612739,CLE,Cleveland Cavaliers,CLE @ WAS,95,-24,Regular Season
22018,1610612751,BKN,Brooklyn Nets,0021800205,2018-11-14T00:00:00Z,BKN vs. MIA,107,-13,1610612748,MIA,Miami Heat,MIA @ BKN,120,13,Regular Season
22018,1610612749,MIL,Milwaukee Bucks,0021800207,2018-11-14T00:00:00Z,MIL vs. MEM,113,-3,1610612763,MEM,Memphis Grizzlies,MEM @ MIL,116,3,Regular Season
22018,1610612750,MIN,Minnesota Timberwolves,0021800208,2018-11-14T00:00:00Z,MIN vs. NOP,107,7,1610612740,NOP,New Orleans Pelicans,NOP @ MIN,100,-7,Regular Season
22018,1610612756,PHX,Phoenix Suns,0021800211,2018-11-14T00:00:00Z,PHX vs. SAS,116,20,1610612759,SAS,San Antonio Spurs,SAS @ PHX,96,-20,Regular Season
22018,1610612760,OKC,Oklahoma City Thunder,0021800209,2018-11-14T00:00:00Z,OKC vs. NYK,128,25,1610612752,NYK,New York Knicks,NYK @ OKC,103,-25,Regular Season
22018,1610612742,DAL,Dallas Mavericks,0021800210,2018-11-14T00:00:00Z,DAL vs. UTA,118,50,1610612762,UTA,Utah Jazz,UTA @ DAL,68,-50,Regular Season
22018,1610612753,ORL,Orlando Magic,0021800202,2018-11-14T00:00:00Z,ORL vs. PHI,111,5,1610612755,PHI,Philadelphia 76ers,PHI @ ORL,106,-5,Regular Season
22018,1610612738,BOS,Boston Celtics,0021800204,2018-11-14T00:00:00Z,BOS vs. CHI,111,29,1610612741,CHI,Chicago Bulls,CHI @ BOS,82,-29,Regular Season
22018,1610612743,DEN,Denver Nuggets,0021800214,2018-11-15T00:00:00Z,DEN vs. ATL,138,45,1610612737,ATL,Atlanta Hawks,ATL @ DEN,93,-45,Regular Season
22018,1610612745,HOU,Houston Rockets,0021800213,2018-11-15T00:00:00Z,HOU vs. GSW,107,21,1610612744,GSW,Golden State Warriors,GSW @ HOU,86,-21,Regular Season
22018,1610612746,LAC,LA Clippers,0021800215,2018-11-15T00:00:00Z,LAC vs. SAS,116,5,1610612759,SAS,San Antonio Spurs,SAS @ LAC,111,-5,Regular Season
22018,1610612754,IND,Indiana Pacers,0021800217,2018-11-16T00:00:00Z,IND vs. MIA,99,8,1610612748,MIA,Miami Heat,MIA @ IND,91,-8,Regular Season
22018,1610612749,MIL,Milwaukee Bucks,0021800223,2018-11-16T00:00:00Z,MIL vs. CHI,123,19,1610612741,CHI,Chicago Bulls,CHI @ MIL,104,-19,Regular Season
22018,1610612755,PHI,Philadelphia 76ers,0021800218,2018-11-16T00:00:00Z,PHI vs. UTA,113,6,1610612762,UTA,Utah Jazz,UTA @ PHI,107,-6,Regular Season
22018,1610612740,NOP,New Orleans Pelicans,0021800222,2018-11-16T00:00:00Z,NOP vs. NYK,129,5,1610612752,NYK,New York Knicks,NYK @ NOP,124,-5,Regular Season
22018,1610612738,BOS,Boston Celtics,0021800216,2018-11-16T00:00:00Z,BOS vs. TOR,123,7,1610612761,TOR,Toronto Raptors,TOR @ BOS,116,-7,Regular Season
22018,1610612763,MEM,Memphis Grizzlies,0021800220,2018-11-16T00:00:00Z,MEM vs. SAC,112,8,1610612758,SAC,Sacramento Kings,SAC @ MEM,104,-8,Regular Season
22018,1610612750,MIN,Minnesota Timberwolves,0021800221,2018-11-16T00:00:00Z,MIN vs. POR,112,16,1610612757,POR,Portland Trail Blazers,POR @ MIN,96,-16,Regular Season
22018,1610612764,WAS,Washington Wizards,0021800219,2018-11-16T00:00:00Z,WAS vs. BKN,104,-11,1610612751,BKN,Brooklyn Nets,BKN @ WAS,115,11,Regular Season
22018,1610612754,IND,Indiana Pacers,0021800226,2018-11-17T00:00:00Z,IND vs. ATL,97,8,1610612737,ATL,Atlanta Hawks,ATL @ IND,89,-8,Regular Season
22018,1610612745,HOU,Houston Rockets,0021800231,2018-11-17T00:00:00Z,HOU vs. SAC,132,20,1610612758,SAC,Sacramento Kings,SAC @ HOU,112,-20,Regular Season
22018,1610612766,CHA,Charlotte Hornets,0021800225,2018-11-17T00:00:00Z,CHA vs. PHI,119,-3,1610612755,PHI,Philadelphia 76ers,PHI @ CHA,122,3,Regular Season
22018,1610612753,ORL,Orlando Magic,0021800227,2018-11-17T00:00:00Z,ORL vs. LAL,130,13,1610612747,LAL,Los Angeles Lakers,LAL @ ORL,117,-13,Regular Season
22018,1610612742,DAL,Dallas Mavericks,0021800232,2018-11-17T00:00:00Z,DAL vs. GSW,112,3,1610612744,GSW,Golden State Warriors,GSW @ DAL,109,-3,Regular Season
22018,1610612741,CHI,Chicago Bulls,0021800230,2018-11-17T00:00:00Z,CHI vs. TOR,83,-39,1610612761,TOR,Toronto Raptors,TOR @ CHI,122,39,Regular Season
22018,1610612756,PHX,Phoenix Suns,0021800233,2018-11-17T00:00:00Z,PHX vs. OKC,100,-10,1610612760,OKC,Oklahoma City Thunder,OKC @ PHX,110,10,Regular Season
22018,1610612740,NOP,New Orleans Pelicans,0021800228,2018-11-17T00:00:00Z,NOP vs. DEN,125,10,1610612743,DEN,Denver Nuggets,DEN @ NOP,115,-10,Regular Season
22018,1610612738,BOS,Boston Celtics,0021800229,2018-11-17T00:00:00Z,BOS vs. UTA,86,-12,1610612762,UTA,Utah Jazz,UTA @ BOS,98,12,Regular Season
22018,1610612751,BKN,Brooklyn Nets,0021800224,2018-11-17T00:00:00Z,BKN vs. LAC,119,-8,1610612746,LAC,LA Clippers,LAC @ BKN,127,8,Regular Season
22018,1610612759,SAS,San Antonio Spurs,0021800238,2018-11-18T00:00:00Z,SAS vs. GSW,104,12,1610612744,GSW,Golden State Warriors,GSW @ SAS,92,-12,Regular Season
22018,1610612764,WAS,Washington Wizards,0021800237,2018-11-18T00:00:00Z,WAS vs. POR,109,-10,1610612757,POR,Portland Trail Blazers,POR @ WAS,119,10,Regular Season
22018,1610612750,MIN,Minnesota Timberwolves,0021800234,2018-11-18T00:00:00Z,MIN vs. MEM,87,-13,1610612763,MEM,Memphis Grizzlies,MEM @ MIN,100,13,Regular Season
22018,1610612753,ORL,Orlando Magic,0021800236,2018-11-18T00:00:00Z,ORL vs. NYK,131,14,1610612752,NYK,New York Knicks,NYK @ ORL,117,-14,Regular Season
22018,1610612748,MIA,Miami Heat,0021800235,2018-11-18T00:00:00Z,MIA vs. LAL,97,-16,1610612747,LAL,Los Angeles Lakers,LAL @ MIA,113,16,Regular Season
22018,1610612755,PHI,Philadelphia 76ers,0021800242,2018-11-19T00:00:00Z,PHI vs. PHX,119,5,1610612756,PHX,Phoenix Suns,PHX @ PHI,114,-5,Regular Season
22018,1610612754,IND,Indiana Pacers,0021800241,2018-11-19T00:00:00Z,IND vs. UTA,121,27,1610612762,UTA,Utah Jazz,UTA @ IND,94,-27,Regular Season
22018,1610612737,ATL,Atlanta Hawks,0021800243,2018-11-19T00:00:00Z,ATL vs. LAC,119,-8,1610612746,LAC,LA Clippers,LAC @ ATL,127,8,Regular Season
22018,1610612763,MEM,Memphis Grizzlies,0021800244,2018-11-19T00:00:00Z,MEM vs. DAL,98,10,1610612742,DAL,Dallas Mavericks,DAL @ MEM,88,-10,Regular Season
22018,1610612758,SAC,Sacramento Kings,0021800247,2018-11-19T00:00:00Z,SAC vs. OKC,117,4,1610612760,OKC,Oklahoma City Thunder,OKC @ SAC,113,-4,Regular Season
22018,1610612740,NOP,New Orleans Pelicans,0021800246,2018-11-19T00:00:00Z,NOP vs. SAS,140,14,1610612759,SAS,San Antonio Spurs,SAS @ NOP,126,-14,Regular Season
22018,1610612766,CHA,Charlotte Hornets,0021800239,2018-11-19T00:00:00Z,CHA vs. BOS,117,5,1610612738,BOS,Boston Celtics,BOS @ CHA,112,-5,Regular Season
22018,1610612765,DET,Detroit Pistons,0021800240,2018-11-19T00:00:00Z,DET vs. CLE,113,11,1610612739,CLE,Cleveland Cavaliers,CLE @ DET,102,-11,Regular Season
22018,1610612749,MIL,Milwaukee Bucks,0021800245,2018-11-19T00:00:00Z,MIL vs. DEN,104,6,1610612743,DEN,Denver Nuggets,DEN @ MIL,98,-6,Regular Season
22018,1610612764,WAS,Washington Wizards,0021800249,2018-11-20T00:00:00Z,WAS vs. LAC,125,7,1610612746,LAC,LA Clippers,LAC @ WAS,118,-7,Regular Season
22018,1610612753,ORL,Orlando Magic,0021800248,2018-11-20T00:00:00Z,ORL vs. TOR,91,-2,1610612761,TOR,Toronto Raptors,TOR @ ORL,93,2,Regular Season
22018,1610612752,NYK,New York Knicks,0021800251,2018-11-20T00:00:00Z,NYK vs. POR,114,-4,1610612757,POR,Portland Trail Blazers,POR @ NYK,118,4,Regular Season
22018,1610612748,MIA,Miami Heat,0021800250,2018-11-20T00:00:00Z,MIA vs. BKN,92,-12,1610612751,BKN,Brooklyn Nets,BKN @ MIA,104,12,Regular Season
22018,1610612762,UTA,Utah Jazz,0021800263,2018-11-21T00:00:00Z,UTA vs. SAC,110,-9,1610612758,SAC,Sacramento Kings,SAC @ UTA,119,9,Regular Season
22018,1610612759,SAS,San Antonio Spurs,0021800262,2018-11-21T00:00:00Z,SAS vs. MEM,103,-1,1610612763,MEM,Memphis Grizzlies,MEM @ SAS,104,1,Regular Season
22018,1610612744,GSW,Golden State Warriors,0021800264,2018-11-21T00:00:00Z,GSW vs. OKC,95,-28,1610612760,OKC,Oklahoma City Thunder,OKC @ GSW,123,28,Regular Season
22018,1610612737,ATL,Atlanta Hawks,0021800254,2018-11-21T00:00:00Z,ATL vs. TOR,108,-16,1610612761,TOR,Toronto Raptors,TOR @ ATL,124,16,Regular Season
22018,1610612745,HOU,Houston Rockets,0021800258,2018-11-21T00:00:00Z,HOU vs. DET,126,2,1610612765,DET,Detroit Pistons,DET @ HOU,124,-2,Regular Season
22018,1610612741,CHI,Chicago Bulls,0021800257,2018-11-21T00:00:00Z,CHI vs. PHX,124,8,1610612756,PHX,Phoenix Suns,PHX @ CHI,116,-8,Regular Season
22018,1610612742,DAL,Dallas Mavericks,0021800261,2018-11-21T00:00:00Z,DAL vs. BKN,119,6,1610612751,BKN,Brooklyn Nets,BKN @ DAL,113,-6,Regular Season
22018,1610612739,CLE,Cleveland Cavaliers,0021800256,2018-11-21T00:00:00Z,CLE vs. LAL,105,-4,1610612747,LAL,Los Angeles Lakers,LAL @ CLE,109,4,Regular Season
22018,1610612766,CHA,Charlotte Hornets,0021800252,2018-11-21T00:00:00Z,CHA vs. IND,127,18,1610612754,IND,Indiana Pacers,IND @ CHA,109,-18,Regular Season
22018,1610612755,PHI,Philadelphia 76ers,0021800253,2018-11-21T00:00:00Z,PHI vs. NOP,121,1,1610612740,NOP,New Orleans Pelicans,NOP @ PHI,120,-1,Regular Season
22018,1610612749,MIL,Milwaukee Bucks,0021800259,2018-11-21T00:00:00Z,MIL vs. POR,143,43,1610612757,POR,Portland Trail Blazers,POR @ MIL,100,-43,Regular Season
22018,1610612750,MIN,Minnesota Timberwolves,0021800260,2018-11-21T00:00:00Z,MIN vs. DEN,101,-2,1610612743,DEN,Denver Nuggets,DEN @ MIN,103,2,Regular Season
22018,1610612738,BOS,Boston Celtics,0021800255,2018-11-21T00:00:00Z,BOS vs. NYK,109,-8,1610612752,NYK,New York Knicks,NYK @ BOS,117,8,Regular Season
22018,1610612760,OKC,Oklahoma City Thunder,0021800274,2018-11-23T00:00:00Z,OKC vs. CHA,109,5,1610612766,CHA,Charlotte Hornets,CHA @ OKC,104,-5,Regular Season
22018,1610612765,DET,Detroit Pistons,0021800267,2018-11-23T00:00:00Z,DET vs. HOU,116,5,1610612745,HOU,Houston Rockets,HOU @ DET,111,-5,Regular Season
22018,1610612741,CHI,Chicago Bulls,0021800273,2018-11-23T00:00:00Z,CHI vs. MIA,96,-7,1610612748,MIA,Miami Heat,MIA @ CHI,103,7,Regular Season
22018,1610612746,LAC,LA Clippers,0021800266,2018-11-23T00:00:00Z,LAC vs. MEM,112,5,1610612763,MEM,Memphis Grizzlies,MEM @ LAC,107,-5,Regular Season
22018,1610612761,TOR,Toronto Raptors,0021800271,2018-11-23T00:00:00Z,TOR vs. WAS,125,18,1610612764,WAS,Washington Wizards,WAS @ TOR,107,-18,Regular Season
22018,1610612749,MIL,Milwaukee Bucks,0021800275,2018-11-23T00:00:00Z,MIL vs. PHX,114,-2,1610612756,PHX,Phoenix Suns,PHX @ MIL,116,2,Regular Season
22018,1610612747,LAL,Los Angeles Lakers,0021800278,2018-11-23T00:00:00Z,LAL vs. UTA,90,7,1610612762,UTA,Utah Jazz,UTA @ LAL,83,-7,Regular Season
22018,1610612743,DEN,Denver Nuggets,0021800276,2018-11-23T00:00:00Z,DEN vs. ORL,112,25,1610612753,ORL,Orlando Magic,ORL @ DEN,87,-25,Regular Season
22018,1610612755,PHI,Philadelphia 76ers,0021800270,2018-11-23T00:00:00Z,PHI vs. CLE,112,-9,1610612739,CLE,Cleveland Cavaliers,CLE @ PHI,121,9,Regular Season
22018,1610612744,GSW,Golden State Warriors,0021800277,2018-11-23T00:00:00Z,GSW vs. POR,125,28,1610612757,POR,Portland Trail Blazers,POR @ GSW,97,-28,Regular Season
22018,1610612737,ATL,Atlanta Hawks,0021800268,2018-11-23T00:00:00Z,ATL vs. BOS,96,-18,1610612738,BOS,Boston Celtics,BOS @ ATL,114,18,Regular Season
22018,1610612752,NYK,New York Knicks,0021800269,2018-11-23T00:00:00Z,NYK vs. NOP,114,5,1610612740,NOP,New Orleans Pelicans,NOP @ NYK,109,-5,Regular Season
22018,1610612751,BKN,Brooklyn Nets,0021800265,2018-11-23T00:00:00Z,BKN vs. MIN,102,-10,1610612750,MIN,Minnesota Timberwolves,MIN @ BKN,112,10,Regular Season
22018,1610612754,IND,Indiana Pacers,0021800272,2018-11-23T00:00:00Z,IND vs. SAS,100,-11,1610612759,SAS,San Antonio Spurs,SAS @ IND,111,11,Regular Season
22018,1610612739,CLE,Cleveland Cavaliers,0021800279,2018-11-24T00:00:00Z,CLE vs. HOU,117,9,1610612745,HOU,Houston Rockets,HOU @ CLE,108,-9,Regular Season
22018,1610612749,MIL,Milwaukee Bucks,0021800284,2018-11-24T00:00:00Z,MIL vs. SAS,135,6,1610612759,SAS,San Antonio Spurs,SAS @ MIL,129,-6,Regular Season
22018,1610612764,WAS,Washington Wizards,0021800280,2018-11-24T00:00:00Z,WAS vs. NOP,124,10,1610612740,NOP,New Orleans Pelicans,NOP @ WAS,114,-10,Regular Season
22018,1610612760,OKC,Oklahoma City Thunder,0021800282,2018-11-24T00:00:00Z,OKC vs. DEN,98,-7,1610612743,DEN,Denver Nuggets,DEN @ OKC,105,7,Regular Season
22018,1610612742,DAL,Dallas Mavericks,0021800283,2018-11-24T00:00:00Z,DAL vs. BOS,113,9,1610612738,BOS,Boston Celtics,BOS @ DAL,104,-9,Regular Season
22018,1610612750,MIN,Minnesota Timberwolves,0021800281,2018-11-24T00:00:00Z,MIN vs. CHI,111,15,1610612741,CHI,Chicago Bulls,CHI @ MIN,96,-15,Regular Season
22018,1610612744,GSW,Golden State Warriors,0021800285,2018-11-24T00:00:00Z,GSW vs. SAC,117,1,1610612758,SAC,Sacramento Kings,SAC @ GSW,116,-1,Regular Season
22018,1610612747,LAL,Los Angeles Lakers,0021800286,2018-11-25T00:00:00Z,LAL vs. ORL,104,-4,1610612753,ORL,Orlando Magic,ORL @ LAL,108,4,Regular Season
22018,1610612761,TOR,Toronto Raptors,0021800290,2018-11-25T00:00:00Z,TOR vs. MIA,125,10,1610612748,MIA,Miami Heat,MIA @ TOR,115,-10,Regular Season
22018,1610612763,MEM,Memphis Grizzlies,0021800291,2018-11-25T00:00:00Z,MEM vs. NYK,98,-5,1610612752,NYK,New York Knicks,NYK @ MEM,103,5,Regular Season
22018,1610612757,POR,Portland Trail Blazers,0021800293,2018-11-25T00:00:00Z,POR vs. LAC,100,-4,1610612746,LAC,LA Clippers,LAC @ POR,104,4,Regular Season
22018,1610612737,ATL,Atlanta Hawks,0021800288,2018-11-25T00:00:00Z,ATL vs. CHA,124,1,1610612766,CHA,Charlotte Hornets,CHA @ ATL,123,-1,Regular Season
22018,1610612758,SAC,Sacramento Kings,0021800292,2018-11-25T00:00:00Z,SAC vs. UTA,112,-21,1610612762,UTA,Utah Jazz,UTA @ SAC,133,21,Regular Season
22018,1610612751,BKN,Brooklyn Nets,0021800289,2018-11-25T00:00:00Z,BKN vs. PHI,125,-2,1610612755,PHI,Philadelphia 76ers,PHI @ BKN,127,2,Regular Season
22018,1610612765,DET,Detroit Pistons,0021800287,2018-11-25T00:00:00Z,DET vs. PHX,118,11,1610612756,PHX,Phoenix Suns,PHX @ DET,107,-11,Regular Season
22018,1610612741,CHI,Chicago Bulls,0021800297,2018-11-26T00:00:00Z,CHI vs. SAS,107,-1,1610612759,SAS,San Antonio Spurs,SAS @ CHI,108,1,Regular Season
22018,1610612744,GSW,Golden State Warriors,0021800300,2018-11-26T00:00:00Z,GSW vs. ORL,116,6,1610612753,ORL,Orlando Magic,ORL @ GSW,110,-6,Regular Season
22018,1610612762,UTA,Utah Jazz,0021800299,2018-11-26T00:00:00Z,UTA vs. IND,88,-33,1610612754,IND,Indiana Pacers,IND @ UTA,121,33,Regular Season
22018,1610612764,WAS,Washington Wizards,0021800296,2018-11-26T00:00:00Z,WAS vs. HOU,135,4,1610612745,HOU,Houston Rockets,HOU @ WAS,131,-4,Regular Season
22018,1610612740,NOP,New Orleans Pelicans,0021800298,2018-11-26T00:00:00Z,NOP vs. BOS,107,-17,1610612738,BOS,Boston Celtics,BOS @ NOP,124,17,Regular Season
22018,1610612739,CLE,Cleveland Cavaliers,0021800295,2018-11-26T00:00:00Z,CLE vs. MIN,95,-7,1610612750,MIN,Minnesota Timberwolves,MIN @ CLE,102,7,Regular Season
22018,1610612766,CHA,Charlotte Hornets,0021800294,2018-11-26T00:00:00Z,CHA vs. MIL,110,3,1610612749,MIL,Milwaukee Bucks,MIL @ CHA,107,-3,Regular Season
22018,1610612743,DEN,Denver Nuggets,0021800304,2018-11-27T00:00:00Z,DEN vs. LAL,117,32,1610612747,LAL,Los Angeles Lakers,LAL @ DEN,85,-32,Regular Season
22018,1610612756,PHX,Phoenix Suns,0021800305,2018-11-27T00:00:00Z,PHX vs. IND,104,-5,1610612754,IND,Indiana Pacers,IND @ PHX,109,5,Regular Season
22018,1610612748,MIA,Miami Heat,0021800302,2018-11-27T00:00:00Z,MIA vs. ATL,113,-2,1610612737,ATL,Atlanta Hawks,ATL @ MIA,115,2,Regular Season
22018,1610612765,DET,Detroit Pistons,0021800301,2018-11-27T00:00:00Z,DET vs. NYK,115,7,1610612752,NYK,New York Knicks,NYK @ DET,108,-7,Regular Season
22018,1610612763,MEM,Memphis Grizzlies,0021800303,2018-11-27T00:00:00Z,MEM vs. TOR,114,-8,1610612761,TOR,Toronto Raptors,TOR @ MEM,122,8,Regular Season
22018,1610612746,LAC,LA Clippers,0021800315,2018-11-28T00:00:00Z,LAC vs. PHX,115,16,1610612756,PHX,Phoenix Suns,PHX @ LAC,99,-16,Regular Season
22018,1610612749,MIL,Milwaukee Bucks,0021800310,2018-11-28T00:00:00Z,MIL vs. CHI,116,3,1610612741,CHI,Chicago Bulls,CHI @ MIL,113,-3,Regular Season
22018,1610612745,HOU,Houston Rockets,0021800309,2018-11-28T00:00:00Z,HOU vs. DAL,108,-20,1610612742,DAL,Dallas Mavericks,DAL @ HOU,128,20,Regular Season
22018,1610612755,PHI,Philadelphia 76ers,0021800307,2018-11-28T00:00:00Z,PHI vs. NYK,117,26,1610612752,NYK,New York Knicks,NYK @ PHI,91,-26,Regular Season
22018,1610612740,NOP,New Orleans Pelicans,0021800312,2018-11-28T00:00:00Z,NOP vs. WAS,125,21,1610612764,WAS,Washington Wizards,WAS @ NOP,104,-21,Regular Season
22018,1610612757,POR,Portland Trail Blazers,0021800314,2018-11-28T00:00:00Z,POR vs. ORL,115,3,1610612753,ORL,Orlando Magic,ORL @ POR,112,-3,Regular Season
22018,1610612750,MIN,Minnesota Timberwolves,0021800311,2018-11-28T00:00:00Z,MIN vs. SAS,128,39,1610612759,SAS,San Antonio Spurs,SAS @ MIN,89,-39,Regular Season
22018,1610612751,BKN,Brooklyn Nets,0021800308,2018-11-28T00:00:00Z,BKN vs. UTA,91,-10,1610612762,UTA,Utah Jazz,UTA @ BKN,101,10,Regular Season
22018,1610612766,CHA,Charlotte Hornets,0021800306,2018-11-28T00:00:00Z,CHA vs. ATL,108,14,1610612737,ATL,Atlanta Hawks,ATL @ CHA,94,-14,Regular Season
22018,1610612760,OKC,Oklahoma City Thunder,0021800313,2018-11-28T00:00:00Z,OKC vs. CLE,100,17,1610612739,CLE,Cleveland Cavaliers,CLE @ OKC,83,-17,Regular Season
22018,1610612761,TOR,Toronto Raptors,0021800316,2018-11-29T00:00:00Z,TOR vs. GSW,131,3,1610612744,GSW,Golden State Warriors,GSW @ TOR,128,-3,Regular Season
22018,1610612747,LAL,Los Angeles Lakers,0021800317,2018-11-29T00:00:00Z,LAL vs. IND,104,8,1610612754,IND,Indiana Pacers,IND @ LAL,96,-8,Regular Season
22018,1610612758,SAC,Sacramento Kings,0021800318,2018-11-29T00:00:00Z,SAC vs. LAC,121,-12,1610612746,LAC,LA Clippers,LAC @ SAC,133,12,Regular Season
22018,1610612759,SAS,San Antonio Spurs,0021800326,2018-11-30T00:00:00Z,SAS vs. HOU,105,-31,1610612745,HOU,Houston Rockets,HOU @ SAS,136,31,Regular Season
22018,1610612760,OKC,Oklahoma City Thunder,0021800325,2018-11-30T00:00:00Z,OKC vs. ATL,124,15,1610612737,ATL,Atlanta Hawks,ATL @ OKC,109,-15,Regular Season
22018,1610612756,PHX,Phoenix Suns,0021800327,2018-11-30T00:00:00Z,PHX vs. ORL,85,-14,1610612753,ORL,Orlando Magic,ORL @ PHX,99,14,Regular Season
22018,1610612738,BOS,Boston Celtics,0021800319,2018-11-30T00:00:00Z,BOS vs. CLE,128,33,1610612739,CLE,Cleveland Cavaliers,CLE @ BOS,95,-33,Regular Season
22018,1610612766,CHA,Charlotte Hornets,0021800320,2018-11-30T00:00:00Z,CHA vs. UTA,111,-8,1610612762,UTA,Utah Jazz,UTA @ CHA,119,8,Regular Season
22018,1610612747,LAL,Los Angeles Lakers,0021800328,2018-11-30T00:00:00Z,LAL vs. DAL,114,11,1610612742,DAL,Dallas Mavericks,DAL @ LAL,103,-11,Regular Season
22018,1610612765,DET,Detroit Pistons,0021800321,2018-11-30T00:00:00Z,DET vs. CHI,107,19,1610612741,CHI,Chicago Bulls,CHI @ DET,88,-19,Regular Season
22018,1610612751,BKN,Brooklyn Nets,0021800323,2018-11-30T00:00:00Z,BKN vs. MEM,125,-6,1610612763,MEM,Memphis Grizzlies,MEM @ BKN,131,6,Regular Season
22018,1610612755,PHI,Philadelphia 76ers,0021800322,2018-11-30T00:00:00Z,PHI vs. WAS,123,25,1610612764,WAS,Washington Wizards,WAS @ PHI,98,-25,Regular Season
22018,1610612757,POR,Portland Trail Blazers,0021800329,2018-11-30T00:00:00Z,POR vs. DEN,112,-1,1610612743,DEN,Denver Nuggets,DEN @ POR,113,1,Regular Season
22018,1610612748,MIA,Miami Heat,0021800324,2018-11-30T00:00:00Z,MIA vs. NOP,106,5,1610612740,NOP,New Orleans Pelicans,NOP @ MIA,101,-5,Regular Season
22018,1610612750,MIN,Minnesota Timberwolves,0021800335,2018-12-01T00:00:00Z,MIN vs. BOS,109,-9,1610612738,BOS,Boston Celtics,BOS @ MIN,118,9,Regular Season
22018,1610612752,NYK,New York Knicks,0021800330,2018-12-01T00:00:00Z,NYK vs. MIL,136,2,1610612749,MIL,Milwaukee Bucks,MIL @ NYK,134,-2,Regular Season
22018,1610612739,CLE,Cleveland Cavaliers,0021800332,2018-12-01T00:00:00Z,CLE vs. TOR,95,-11,1610612761,TOR,Toronto Raptors,TOR @ CLE,106,11,Regular Season
22018,1610612745,HOU,Houston Rockets,0021800334,2018-12-01T00:00:00Z,HOU vs. CHI,121,16,1610612741,CHI,Chicago Bulls,CHI @ HOU,105,-16,Regular Season
22018,1610612765,DET,Detroit Pistons,0021800331,2018-12-01T00:00:00Z,DET vs. GSW,111,9,1610612744,GSW,Golden State Warriors,GSW @ DET,102,-9,Regular Season
22018,1610612758,SAC,Sacramento Kings,0021800336,2018-12-01T00:00:00Z,SAC vs. IND,111,1,1610612754,IND,Indiana Pacers,IND @ SAC,110,-1,Regular Season
22018,1610612764,WAS,Washington Wizards,0021800333,2018-12-01T00:00:00Z,WAS vs. BKN,102,14,1610612751,BKN,Brooklyn Nets,BKN @ WAS,88,-14,Regular Season
22018,1610612755,PHI,Philadelphia 76ers,0021800340,2018-12-02T00:00:00Z,PHI vs. MEM,103,8,1610612763,MEM,Memphis Grizzlies,MEM @ PHI,95,-8,Regular Season
22018,1610612748,MIA,Miami Heat,0021800339,2018-12-02T00:00:00Z,MIA vs. UTA,102,2,1610612762,UTA,Utah Jazz,UTA @ MIA,100,-2,Regular Season
22018,1610612747,LAL,Los Angeles Lakers,0021800337,2018-12-02T00:00:00Z,LAL vs. PHX,120,24,1610612756,PHX,Phoenix Suns,PHX @ LAL,96,-24,Regular Season
22018,1610612742,DAL,Dallas Mavericks,0021800341,2018-12-02T00:00:00Z,DAL vs. LAC,114,4,1610612746,LAC,LA Clippers,LAC @ DAL,110,-4,Regular Season
22018,1610612766,CHA,Charlotte Hornets,0021800338,2018-12-02T00:00:00Z,CHA vs. NOP,109,-10,1610612740,NOP,New Orleans Pelicans,NOP @ CHA,119,10,Regular Season
22018,1610612759,SAS,San Antonio Spurs,0021800342,2018-12-02T00:00:00Z,SAS vs. POR,131,13,1610612757,POR,Portland Trail Blazers,POR @ SAS,118,-13,Regular Season
22018,1610612750,MIN,Minnesota Timberwolves,0021800348,2018-12-03T00:00:00Z,MIN vs. HOU,103,12,1610612745,HOU,Houston Rockets,HOU @ MIN,91,-12,Regular Season
22018,1610612740,NOP,New Orleans Pelicans,0021800349,2018-12-03T00:00:00Z,NOP vs. LAC,126,-3,1610612746,LAC,LA Clippers,LAC @ NOP,129,3,Regular Season
22018,1610612737,ATL,Atlanta Hawks,0021800344,2018-12-03T00:00:00Z,ATL vs. GSW,111,-17,1610612744,GSW,Golden State Warriors,GSW @ ATL,128,17,Regular Season
22018,1610612765,DET,Detroit Pistons,0021800343,2018-12-03T00:00:00Z,DET vs. OKC,83,-27,1610612760,OKC,Oklahoma City Thunder,OKC @ DET,110,27,Regular Season
22018,1610612761,TOR,Toronto Raptors,0021800347,2018-12-03T00:00:00Z,TOR vs. DEN,103,-3,1610612743,DEN,Denver Nuggets,DEN @ TOR,106,3,Regular Season
22018,1610612752,NYK,New York Knicks,0021800346,2018-12-03T00:00:00Z,NYK vs. WAS,107,-3,1610612764,WAS,Washington Wizards,WAS @ NYK,110,3,Regular Season
22018,1610612751,BKN,Brooklyn Nets,0021800345,2018-12-03T00:00:00Z,BKN vs. CLE,97,-2,1610612739,CLE,Cleveland Cavaliers,CLE @ BKN,99,2,Regular Season
22018,1610612762,UTA,Utah Jazz,0021800354,2018-12-04T00:00:00Z,UTA vs. SAS,139,34,1610612759,SAS,San Antonio Spurs,SAS @ UTA,105,-34,Regular Season
22018,1610612756,PHX,Phoenix Suns,0021800353,2018-12-04T00:00:00Z,PHX vs. SAC,105,-17,1610612758,SAC,Sacramento Kings,SAC @ PHX,122,17,Regular Season
22018,1610612748,MIA,Miami Heat,0021800351,2018-12-04T00:00:00Z,MIA vs. ORL,90,-15,1610612753,ORL,Orlando Magic,ORL @ MIA,105,15,Regular Season
22018,1610612754,IND,Indiana Pacers,0021800350,2018-12-04T00:00:00Z,IND vs. CHI,96,6,1610612741,CHI,Chicago Bulls,CHI @ IND,90,-6,Regular Season
22018,1610612742,DAL,Dallas Mavericks,0021800352,2018-12-04T00:00:00Z,DAL vs. POR,111,9,1610612757,POR,Portland Trail Blazers,POR @ DAL,102,-9,Regular Season
22018,1610612763,MEM,Memphis Grizzlies,0021800360,2018-12-05T00:00:00Z,MEM vs. LAC,96,10,1610612746,LAC,LA Clippers,LAC @ MEM,86,-10,Regular Season
22018,1610612737,ATL,Atlanta Hawks,0021800357,2018-12-05T00:00:00Z,ATL vs. WAS,117,-14,1610612764,WAS,Washington Wizards,WAS @ ATL,131,14,Regular Season
22018,1610612751,BKN,Brooklyn Nets,0021800358,2018-12-05T00:00:00Z,BKN vs. OKC,112,-2,1610612760,OKC,Oklahoma City Thunder,OKC @ BKN,114,2,Regular Season
22018,1610612749,MIL,Milwaukee Bucks,0021800361,2018-12-05T00:00:00Z,MIL vs. DET,115,23,1610612765,DET,Detroit Pistons,DET @ MIL,92,-23,Regular Season
22018,1610612750,MIN,Minnesota Timberwolves,0021800362,2018-12-05T00:00:00Z,MIN vs. CHA,121,17,1610612766,CHA,Charlotte Hornets,CHA @ MIN,104,-17,Regular Season
22018,1610612747,LAL,Los Angeles Lakers,0021800364,2018-12-05T00:00:00Z,LAL vs. SAS,121,8,1610612759,SAS,San Antonio Spurs,SAS @ LAL,113,-8,Regular Season
22018,1610612740,NOP,New Orleans Pelicans,0021800363,2018-12-05T00:00:00Z,NOP vs. DAL,132,26,1610612742,DAL,Dallas Mavericks,DAL @ NOP,106,-26,Regular Season
22018,1610612739,CLE,Cleveland Cavaliers,0021800355,2018-12-05T00:00:00Z,CLE vs. GSW,105,-24,1610612744,GSW,Golden State Warriors,GSW @ CLE,129,24,Regular Season
22018,1610612761,TOR,Toronto Raptors,0021800359,2018-12-05T00:00:00Z,TOR vs. PHI,113,11,1610612755,PHI,Philadelphia 76ers,PHI @ TOR,102,-11,Regular Season
22018,1610612753,ORL,Orlando Magic,0021800356,2018-12-05T00:00:00Z,ORL vs. DEN,118,-6,1610612743,DEN,Denver Nuggets,DEN @ ORL,124,6,Regular Season
22018,1610612762,UTA,Utah Jazz,0021800367,2018-12-06T00:00:00Z,UTA vs. HOU,118,27,1610612745,HOU,Houston Rockets,HOU @ UTA,91,-27,Regular Season
22018,1610612738,BOS,Boston Celtics,0021800365,2018-12-06T00:00:00Z,BOS vs. NYK,128,28,1610612752,NYK,New York Knicks,NYK @ BOS,100,-28,Regular Season
22018,1610612757,POR,Portland Trail Blazers,0021800366,2018-12-06T00:00:00Z,POR vs. PHX,108,22,1610612756,PHX,Phoenix Suns,PHX @ POR,86,-22,Regular Season
22018,1610612753,ORL,Orlando Magic,0021800370,2018-12-07T00:00:00Z,ORL vs. IND,90,-22,1610612754,IND,Indiana Pacers,IND @ ORL,112,22,Regular Season
22018,1610612765,DET,Detroit Pistons,0021800369,2018-12-07T00:00:00Z,DET vs. PHI,111,-6,1610612755,PHI,Philadelphia 76ers,PHI @ DET,117,6,Regular Season
22018,1610612749,MIL,Milwaukee Bucks,0021800377,2018-12-07T00:00:00Z,MIL vs. GSW,95,-10,1610612744,GSW,Golden State Warriors,GSW @ MIL,105,10,Regular Season
22018,1610612766,CHA,Charlotte Hornets,0021800368,2018-12-07T00:00:00Z,CHA vs. DEN,113,6,1610612743,DEN,Denver Nuggets,DEN @ CHA,107,-6,Regular Season
22018,1610612741,CHI,Chicago Bulls,0021800373,2018-12-07T00:00:00Z,CHI vs. OKC,114,2,1610612760,OKC,Oklahoma City Thunder,OKC @ CHI,112,-2,Regular Season
22018,1610612740,NOP,New Orleans Pelicans,0021800374,2018-12-07T00:00:00Z,NOP vs. MEM,103,-4,1610612763,MEM,Memphis Grizzlies,MEM @ NOP,107,4,Regular Season
22018,1610612759,SAS,San Antonio Spurs,0021800375,2018-12-07T00:00:00Z,SAS vs. LAL,133,13,1610612747,LAL,Los Angeles Lakers,LAL @ SAS,120,-13,Regular Season
22018,1610612756,PHX,Phoenix Suns,0021800376,2018-12-07T00:00:00Z,PHX vs. MIA,98,-17,1610612748,MIA,Miami Heat,MIA @ PHX,115,17,Regular Season
22018,1610612739,CLE,Cleveland Cavaliers,0021800372,2018-12-07T00:00:00Z,CLE vs. SAC,110,-19,1610612758,SAC,Sacramento Kings,SAC @ CLE,129,19,Regular Season
22018,1610612751,BKN,Brooklyn Nets,0021800371,2018-12-07T00:00:00Z,BKN vs. TOR,106,1,1610612761,TOR,Toronto Raptors,TOR @ BKN,105,-1,Regular Season
22018,1610612754,IND,Indiana Pacers,0021800379,2018-12-08T00:00:00Z,IND vs. SAC,107,10,1610612758,SAC,Sacramento Kings,SAC @ IND,97,-10,Regular Season
22018,1610612742,DAL,Dallas Mavericks,0021800378,2018-12-08T00:00:00Z,DAL vs. HOU,107,3,1610612745,HOU,Houston Rockets,HOU @ DAL,104,-3,Regular Season
22018,1610612739,CLE,Cleveland Cavaliers,0021800381,2018-12-08T00:00:00Z,CLE vs. WAS,116,15,1610612764,WAS,Washington Wizards,WAS @ CLE,101,-15,Regular Season
22018,1610612763,MEM,Memphis Grizzlies,0021800384,2018-12-08T00:00:00Z,MEM vs. LAL,88,-23,1610612747,LAL,Los Angeles Lakers,LAL @ MEM,111,23,Regular Season
22018,1610612737,ATL,Atlanta Hawks,0021800380,2018-12-08T00:00:00Z,ATL vs. DEN,106,8,1610612743,DEN,Denver Nuggets,DEN @ ATL,98,-8,Regular Season
22018,1610612752,NYK,New York Knicks,0021800382,2018-12-08T00:00:00Z,NYK vs. BKN,104,-8,1610612751,BKN,Brooklyn Nets,BKN @ NYK,112,8,Regular Season
22018,1610612757,POR,Portland Trail Blazers,0021800385,2018-12-08T00:00:00Z,POR vs. MIN,113,8,1610612750,MIN,Minnesota Timberwolves,MIN @ POR,105,-8,Regular Season
22018,1610612741,CHI,Chicago Bulls,0021800383,2018-12-08T00:00:00Z,CHI vs. BOS,77,-56,1610612738,BOS,Boston Celtics,BOS @ CHI,133,56,Regular Season
22018,1610612746,LAC,LA Clippers,0021800386,2018-12-08T00:00:00Z,LAC vs. MIA,98,-23,1610612748,MIA,Miami Heat,MIA @ LAC,121,23,Regular Season
22018,1610612752,NYK,New York Knicks,0021800389,2018-12-09T00:00:00Z,NYK vs. CHA,107,-12,1610612766,CHA,Charlotte Hornets,CHA @ NYK,119,12,Regular Season
22018,1610612765,DET,Detroit Pistons,0021800387,2018-12-09T00:00:00Z,DET vs. NOP,108,-8,1610612740,NOP,New Orleans Pelicans,NOP @ DET,116,8,Regular Season
22018,1610612761,TOR,Toronto Raptors,0021800388,2018-12-09T00:00:00Z,TOR vs. MIL,99,-5,1610612749,MIL,Milwaukee Bucks,MIL @ TOR,104,5,Regular Season
22018,1610612759,SAS,San Antonio Spurs,0021800390,2018-12-09T00:00:00Z,SAS vs. UTA,110,13,1610612762,UTA,Utah Jazz,UTA @ SAS,97,-13,Regular Season
22018,1610612738,BOS,Boston Celtics,0021800393,2018-12-10T00:00:00Z,BOS vs. NOP,113,13,1610612740,NOP,New Orleans Pelicans,NOP @ BOS,100,-13,Regular Season
22018,1610612754,IND,Indiana Pacers,0021800391,2018-12-10T00:00:00Z,IND vs. WAS,109,8,1610612764,WAS,Washington Wizards,WAS @ IND,101,-8,Regular Season
22018,1610612756,PHX,Phoenix Suns,0021800399,2018-12-10T00:00:00Z,PHX vs. LAC,119,-4,1610612746,LAC,LA Clippers,LAC @ PHX,123,4,Regular Season
22018,1610612743,DEN,Denver Nuggets,0021800398,2018-12-10T00:00:00Z,DEN vs. MEM,105,6,1610612763,MEM,Memphis Grizzlies,MEM @ DEN,99,-6,Regular Season
22018,1610612744,GSW,Golden State Warriors,0021800400,2018-12-10T00:00:00Z,GSW vs. MIN,116,8,1610612750,MIN,Minnesota Timberwolves,MIN @ GSW,108,-8,Regular Season
22018,1610612747,LAL,Los Angeles Lakers,0021800401,2018-12-10T00:00:00Z,LAL vs. MIA,108,3,1610612748,MIA,Miami Heat,MIA @ LAL,105,-3,Regular Season
22018,1610612749,MIL,Milwaukee Bucks,0021800395,2018-12-10T00:00:00Z,MIL vs. CLE,108,16,1610612739,CLE,Cleveland Cavaliers,CLE @ MIL,92,-16,Regular Season
22018,1610612755,PHI,Philadelphia 76ers,0021800392,2018-12-10T00:00:00Z,PHI vs. DET,116,14,1610612765,DET,Detroit Pistons,DET @ PHI,102,-14,Regular Season
22018,1610612741,CHI,Chicago Bulls,0021800394,2018-12-10T00:00:00Z,CHI vs. SAC,89,-19,1610612758,SAC,Sacramento Kings,SAC @ CHI,108,19,Regular Season
22018,1610612760,OKC,Oklahoma City Thunder,0021800396,2018-12-10T00:00:00Z,OKC vs. UTA,122,9,1610612762,UTA,Utah Jazz,UTA @ OKC,113,-9,Regular Season
22018,1610612742,DAL,Dallas Mavericks,0021800397,2018-12-10T00:00:00Z,DAL vs. ORL,101,25,1610612753,ORL,Orlando Magic,ORL @ DAL,76,-25,Regular Season
22018,1610612746,LAC,LA Clippers,0021800404,2018-12-11T00:00:00Z,LAC vs. TOR,99,-24,1610612761,TOR,Toronto Raptors,TOR @ LAC,123,24,Regular Season
22018,1610612745,HOU,Houston Rockets,0021800402,2018-12-11T00:00:00Z,HOU vs. POR,111,7,1610612757,POR,Portland Trail Blazers,POR @ HOU,104,-7,Regular Season
22018,1610612759,SAS,San Antonio Spurs,0021800403,2018-12-11T00:00:00Z,SAS vs. PHX,111,25,1610612756,PHX,Phoenix Suns,PHX @ SAS,86,-25,Regular Season
22018,1610612742,DAL,Dallas Mavericks,0021800412,2018-12-12T00:00:00Z,DAL vs. ATL,114,7,1610612737,ATL,Atlanta Hawks,ATL @ DAL,107,-7,Regular Season
22018,1610612766,CHA,Charlotte Hornets,0021800405,2018-12-12T00:00:00Z,CHA vs. DET,108,1,1610612765,DET,Detroit Pistons,DET @ CHA,107,-1,Regular Season
22018,1610612744,GSW,Golden State Warriors,0021800415,2018-12-12T00:00:00Z,GSW vs. TOR,93,-20,1610612761,TOR,Toronto Raptors,TOR @ GSW,113,20,Regular Season
22018,1610612762,UTA,Utah Jazz,0021800413,2018-12-12T00:00:00Z,UTA vs. MIA,111,27,1610612748,MIA,Miami Heat,MIA @ UTA,84,-27,Regular Season
22018,1610612764,WAS,Washington Wizards,0021800409,2018-12-12T00:00:00Z,WAS vs. BOS,125,-5,1610612738,BOS,Boston Celtics,BOS @ WAS,130,5,Regular Season
22018,1610612740,NOP,New Orleans Pelicans,0021800411,2018-12-12T00:00:00Z,NOP vs. OKC,118,4,1610612760,OKC,Oklahoma City Thunder,OKC @ NOP,114,-4,Regular Season
22018,1610612755,PHI,Philadelphia 76ers,0021800408,2018-12-12T00:00:00Z,PHI vs. BKN,124,-3,1610612751,BKN,Brooklyn Nets,BKN @ PHI,127,3,Regular Season
22018,1610612763,MEM,Memphis Grizzlies,0021800410,2018-12-12T00:00:00Z,MEM vs. POR,92,9,1610612757,POR,Portland Trail Blazers,POR @ MEM,83,-9,Regular Season
22018,1610612754,IND,Indiana Pacers,0021800407,2018-12-12T00:00:00Z,IND vs. MIL,113,16,1610612749,MIL,Milwaukee Bucks,MIL @ IND,97,-16,Regular Season
22018,1610612758,SAC,Sacramento Kings,0021800414,2018-12-12T00:00:00Z,SAC vs. MIN,141,11,1610612750,MIN,Minnesota Timberwolves,MIN @ SAC,130,-11,Regular Season
22018,1610612739,CLE,Cleveland Cavaliers,0021800406,2018-12-12T00:00:00Z,CLE vs. NYK,113,7,1610612752,NYK,New York Knicks,NYK @ CLE,106,-7,Regular Season
22018,1610612753,ORL,Orlando Magic,0021800418,2018-12-13T00:00:00Z,ORL vs. CHI,97,6,1610612741,CHI,Chicago Bulls,CHI @ ORL,91,-6,Regular Season
22018,1610612759,SAS,San Antonio Spurs,0021800417,2018-12-13T00:00:00Z,SAS vs. LAC,125,38,1610612746,LAC,LA Clippers,LAC @ SAS,87,-38,Regular Season
22018,1610612745,HOU,Houston Rockets,0021800416,2018-12-13T00:00:00Z,HOU vs. LAL,126,15,1610612747,LAL,Los Angeles Lakers,LAL @ HOU,111,-15,Regular Season
22018,1610612756,PHX,Phoenix Suns,0021800419,2018-12-13T00:00:00Z,PHX vs. DAL,99,10,1610612742,DAL,Dallas Mavericks,DAL @ PHX,89,-10,Regular Season
22018,1610612738,BOS,Boston Celtics,0021800420,2018-12-14T00:00:00Z,BOS vs. ATL,129,21,1610612737,ATL,Atlanta Hawks,ATL @ BOS,108,-21,Regular Season
22018,1610612755,PHI,Philadelphia 76ers,0021800424,2018-12-14T00:00:00Z,PHI vs. IND,101,-12,1610612754,IND,Indiana Pacers,IND @ PHI,113,12,Regular Season
22018,1610612757,POR,Portland Trail Blazers,0021800427,2018-12-14T00:00:00Z,POR vs. TOR,128,6,1610612761,TOR,Toronto Raptors,TOR @ POR,122,-6,Regular Season
22018,1610612739,CLE,Cleveland Cavaliers,0021800423,2018-12-14T00:00:00Z,CLE vs. MIL,102,-12,1610612749,MIL,Milwaukee Bucks,MIL @ CLE,114,12,Regular Season
22018,1610612763,MEM,Memphis Grizzlies,0021800425,2018-12-14T00:00:00Z,MEM vs. MIA,97,-3,1610612748,MIA,Miami Heat,MIA @ MEM,100,3,Regular Season
22018,1610612766,CHA,Charlotte Hornets,0021800421,2018-12-14T00:00:00Z,CHA vs. NYK,124,-2,1610612752,NYK,New York Knicks,NYK @ CHA,126,2,Regular Season
22018,1610612751,BKN,Brooklyn Nets,0021800422,2018-12-14T00:00:00Z,BKN vs. WAS,125,7,1610612764,WAS,Washington Wizards,WAS @ BKN,118,-7,Regular Season
22018,1610612758,SAC,Sacramento Kings,0021800428,2018-12-14T00:00:00Z,SAC vs. GSW,125,-5,1610612744,GSW,Golden State Warriors,GSW @ SAC,130,5,Regular Season
22018,1610612743,DEN,Denver Nuggets,0021800426,2018-12-14T00:00:00Z,DEN vs. OKC,109,11,1610612760,OKC,Oklahoma City Thunder,OKC @ DEN,98,-11,Regular Season
22018,1610612763,MEM,Memphis Grizzlies,0021800432,2018-12-15T00:00:00Z,MEM vs. HOU,97,-8,1610612745,HOU,Houston Rockets,HOU @ MEM,105,8,Regular Season
22018,1610612759,SAS,San Antonio Spurs,0021800433,2018-12-15T00:00:00Z,SAS vs. CHI,93,-5,1610612741,CHI,Chicago Bulls,CHI @ SAS,98,5,Regular Season
22018,1610612765,DET,Detroit Pistons,0021800431,2018-12-15T00:00:00Z,DET vs. BOS,113,9,1610612738,BOS,Boston Celtics,BOS @ DET,104,-9,Regular Season
22018,1610612753,ORL,Orlando Magic,0021800429,2018-12-15T00:00:00Z,ORL vs. UTA,96,7,1610612762,UTA,Utah Jazz,UTA @ ORL,89,-7,Regular Season
22018,1610612760,OKC,Oklahoma City Thunder,0021800434,2018-12-15T00:00:00Z,OKC vs. LAC,110,6,1610612746,LAC,LA Clippers,LAC @ OKC,104,-6,Regular Season
22018,1610612766,CHA,Charlotte Hornets,0021800430,2018-12-15T00:00:00Z,CHA vs. LAL,100,-28,1610612747,LAL,Los Angeles Lakers,LAL @ CHA,128,28,Regular Season
22018,1610612756,PHX,Phoenix Suns,0021800435,2018-12-15T00:00:00Z,PHX vs. MIN,107,8,1610612750,MIN,Minnesota Timberwolves,MIN @ PHX,99,-8,Regular Season
22018,1610612764,WAS,Washington Wizards,0021800439,2018-12-16T00:00:00Z,WAS vs. LAL,128,18,1610612747,LAL,Los Angeles Lakers,LAL @ WAS,110,-18,Regular Season
22018,1610612740,NOP,New Orleans Pelicans,0021800441,2018-12-16T00:00:00Z,NOP vs. MIA,96,-6,1610612748,MIA,Miami Heat,MIA @ NOP,102,6,Regular Season
22018,1610612739,CLE,Cleveland Cavaliers,0021800437,2018-12-16T00:00:00Z,CLE vs. PHI,105,-23,1610612755,PHI,Philadelphia 76ers,PHI @ CLE,128,23,Regular Season
22018,1610612743,DEN,Denver Nuggets,0021800442,2018-12-16T00:00:00Z,DEN vs. TOR,95,9,1610612761,TOR,Toronto Raptors,TOR @ DEN,86,-9,Regular Season
22018,1610612742,DAL,Dallas Mavericks,0021800440,2018-12-16T00:00:00Z,DAL vs. SAC,113,-7,1610612758,SAC,Sacramento Kings,SAC @ DAL,120,7,Regular Season
22018,1610612751,BKN,Brooklyn Nets,0021800436,2018-12-16T00:00:00Z,BKN vs. ATL,144,17,1610612737,ATL,Atlanta Hawks,ATL @ BKN,127,-17,Regular Season
22018,1610612754,IND,Indiana Pacers,0021800438,2018-12-16T00:00:00Z,IND vs. NYK,110,11,1610612752,NYK,New York Knicks,NYK @ IND,99,-11,Regular Season
22018,1610612745,HOU,Houston Rockets,0021800445,2018-12-17T00:00:00Z,HOU vs. UTA,102,5,1610612762,UTA,Utah Jazz,UTA @ HOU,97,-5,Regular Season
22018,1610612759,SAS,San Antonio Spurs,0021800448,2018-12-17T00:00:00Z,SAS vs. PHI,123,27,1610612755,PHI,Philadelphia 76ers,PHI @ SAS,96,-27,Regular Season
22018,1610612765,DET,Detroit Pistons,0021800443,2018-12-17T00:00:00Z,DET vs. MIL,104,-3,1610612749,MIL,Milwaukee Bucks,MIL @ DET,107,3,Regular Season
22018,1610612760,OKC,Oklahoma City Thunder,0021800447,2018-12-17T00:00:00Z,OKC vs. CHI,121,25,1610612741,CHI,Chicago Bulls,CHI @ OKC,96,-25,Regular Season
22018,1610612750,MIN,Minnesota Timberwolves,0021800446,2018-12-17T00:00:00Z,MIN vs. SAC,132,27,1610612758,SAC,Sacramento Kings,SAC @ MIN,105,-27,Regular Season
22018,1610612746,LAC,LA Clippers,0021800450,2018-12-17T00:00:00Z,LAC vs. POR,127,-4,1610612757,POR,Portland Trail Blazers,POR @ LAC,131,4,Regular Season
22018,1610612752,NYK,New York Knicks,0021800444,2018-12-17T00:00:00Z,NYK vs. PHX,110,-18,1610612756,PHX,Phoenix Suns,PHX @ NYK,128,18,Regular Season
22018,1610612744,GSW,Golden State Warriors,0021800449,2018-12-17T00:00:00Z,GSW vs. MEM,110,17,1610612763,MEM,Memphis Grizzlies,MEM @ GSW,93,-17,Regular Season
22018,1610612743,DEN,Denver Nuggets,0021800454,2018-12-18T00:00:00Z,DEN vs. DAL,126,8,1610612742,DAL,Dallas Mavericks,DAL @ DEN,118,-8,Regular Season
22018,1610612737,ATL,Atlanta Hawks,0021800452,2018-12-18T00:00:00Z,ATL vs. WAS,118,8,1610612764,WAS,Washington Wizards,WAS @ ATL,110,-8,Regular Season
22018,1610612754,IND,Indiana Pacers,0021800451,2018-12-18T00:00:00Z,IND vs. CLE,91,-1,1610612739,CLE,Cleveland Cavaliers,CLE @ IND,92,1,Regular Season
22018,1610612751,BKN,Brooklyn Nets,0021800453,2018-12-18T00:00:00Z,BKN vs. LAL,115,5,1610612747,LAL,Los Angeles Lakers,LAL @ BKN,110,-5,Regular Season
22018,1610612757,POR,Portland Trail Blazers,0021800465,2018-12-19T00:00:00Z,POR vs. MEM,99,7,1610612763,MEM,Memphis Grizzlies,MEM @ POR,92,-7,Regular Season
22018,1610612738,BOS,Boston Celtics,0021800458,2018-12-19T00:00:00Z,BOS vs. PHX,103,-8,1610612756,PHX,Phoenix Suns,PHX @ BOS,111,8,Regular Season
22018,1610612745,HOU,Houston Rockets,0021800461,2018-12-19T00:00:00Z,HOU vs. WAS,136,18,1610612764,WAS,Washington Wizards,WAS @ HOU,118,-18,Regular Season
22018,1610612750,MIN,Minnesota Timberwolves,0021800463,2018-12-19T00:00:00Z,MIN vs. DET,123,-6,1610612765,DET,Detroit Pistons,DET @ MIN,129,6,Regular Season
22018,1610612761,TOR,Toronto Raptors,0021800459,2018-12-19T00:00:00Z,TOR vs. IND,99,3,1610612754,IND,Indiana Pacers,IND @ TOR,96,-3,Regular Season
22018,1610612755,PHI,Philadelphia 76ers,0021800457,2018-12-19T00:00:00Z,PHI vs. NYK,131,22,1610612752,NYK,New York Knicks,NYK @ PHI,109,-22,Regular Season
22018,1610612749,MIL,Milwaukee Bucks,0021800462,2018-12-19T00:00:00Z,MIL vs. NOP,123,8,1610612740,NOP,New Orleans Pelicans,NOP @ MIL,115,-8,Regular Season
22018,1610612741,CHI,Chicago Bulls,0021800460,2018-12-19T00:00:00Z,CHI vs. BKN,93,-3,1610612751,BKN,Brooklyn Nets,BKN @ CHI,96,3,Regular Season
22018,1610612758,SAC,Sacramento Kings,0021800466,2018-12-19T00:00:00Z,SAC vs. OKC,113,-19,1610612760,OKC,Oklahoma City Thunder,OKC @ SAC,132,19,Regular Season
22018,1610612753,ORL,Orlando Magic,0021800456,2018-12-19T00:00:00Z,ORL vs. SAS,90,-39,1610612759,SAS,San Antonio Spurs,SAS @ ORL,129,39,Regular Season
22018,1610612766,CHA,Charlotte Hornets,0021800455,2018-12-19T00:00:00Z,CHA vs. CLE,110,11,1610612739,CLE,Cleveland Cavaliers,CLE @ CHA,99,-11,Regular Season
22018,1610612762,UTA,Utah Jazz,0021800464,2018-12-19T00:00:00Z,UTA vs. GSW,108,5,1610612744,GSW,Golden State Warriors,GSW @ UTA,103,-5,Regular Season
22018,1610612746,LAC,LA Clippers,0021800468,2018-12-20T00:00:00Z,LAC vs. DAL,125,4,1610612742,DAL,Dallas Mavericks,DAL @ LAC,121,-4,Regular Season
22018,1610612748,MIA,Miami Heat,0021800467,2018-12-20T00:00:00Z,MIA vs. HOU,101,2,1610612745,HOU,Houston Rockets,HOU @ MIA,99,-2,Regular Season
22018,1610612759,SAS,San Antonio Spurs,0021800475,2018-12-21T00:00:00Z,SAS vs. MIN,124,26,1610612750,MIN,Minnesota Timberwolves,MIN @ SAS,98,-26,Regular Season
22018,1610612766,CHA,Charlotte Hornets,0021800469,2018-12-21T00:00:00Z,CHA vs. DET,98,12,1610612765,DET,Detroit Pistons,DET @ CHA,86,-12,Regular Season
22018,1610612761,TOR,Toronto Raptors,0021800470,2018-12-21T00:00:00Z,TOR vs. CLE,126,16,1610612739,CLE,Cleveland Cavaliers,CLE @ TOR,110,-16,Regular Season
22018,1610612752,NYK,New York Knicks,0021800472,2018-12-21T00:00:00Z,NYK vs. ATL,107,-7,1610612737,ATL,Atlanta Hawks,ATL @ NYK,114,7,Regular Season
22018,1610612738,BOS,Boston Celtics,0021800473,2018-12-21T00:00:00Z,BOS vs. MIL,107,-13,1610612749,MIL,Milwaukee Bucks,MIL @ BOS,120,13,Regular Season
22018,1610612751,BKN,Brooklyn Nets,0021800471,2018-12-21T00:00:00Z,BKN vs. IND,106,-8,1610612754,IND,Indiana Pacers,IND @ BKN,114,8,Regular Season
22018,1610612741,CHI,Chicago Bulls,0021800474,2018-12-21T00:00:00Z,CHI vs. ORL,90,10,1610612753,ORL,Orlando Magic,ORL @ CHI,80,-10,Regular Season
22018,1610612757,POR,Portland Trail Blazers,0021800476,2018-12-21T00:00:00Z,POR vs. UTA,90,-30,1610612762,UTA,Utah Jazz,UTA @ POR,120,30,Regular Season
22018,1610612758,SAC,Sacramento Kings,0021800477,2018-12-21T00:00:00Z,SAC vs. MEM,102,3,1610612763,MEM,Memphis Grizzlies,MEM @ SAC,99,-3,Regular Season
22018,1610612747,LAL,Los Angeles Lakers,0021800478,2018-12-21T00:00:00Z,LAL vs. NOP,112,8,1610612740,NOP,New Orleans Pelicans,NOP @ LAL,104,-8,Regular Season
22018,1610612745,HOU,Houston Rockets,0021800483,2018-12-22T00:00:00Z,HOU vs. SAS,108,7,1610612759,SAS,San Antonio Spurs,SAS @ HOU,101,-7,Regular Season
22018,1610612744,GSW,Golden State Warriors,0021800484,2018-12-22T00:00:00Z,GSW vs. DAL,120,4,1610612742,DAL,Dallas Mavericks,DAL @ GSW,116,-4,Regular Season
22018,1610612762,UTA,Utah Jazz,0021800485,2018-12-22T00:00:00Z,UTA vs. OKC,106,-1,1610612760,OKC,Oklahoma City Thunder,OKC @ UTA,107,1,Regular Season
22018,1610612755,PHI,Philadelphia 76ers,0021800481,2018-12-22T00:00:00Z,PHI vs. TOR,126,25,1610612761,TOR,Toronto Raptors,TOR @ PHI,101,-25,Regular Season
22018,1610612764,WAS,Washington Wizards,0021800480,2018-12-22T00:00:00Z,WAS vs. PHX,149,3,1610612756,PHX,Phoenix Suns,PHX @ WAS,146,-3,Regular Season
22018,1610612748,MIA,Miami Heat,0021800482,2018-12-22T00:00:00Z,MIA vs. MIL,94,7,1610612749,MIL,Milwaukee Bucks,MIL @ MIA,87,-7,Regular Season
22018,1610612746,LAC,LA Clippers,0021800479,2018-12-22T00:00:00Z,LAC vs. DEN,132,21,1610612743,DEN,Denver Nuggets,DEN @ LAC,111,-21,Regular Season
22018,1610612744,GSW,Golden State Warriors,0021800494,2018-12-23T00:00:00Z,GSW vs. LAC,129,2,1610612746,LAC,LA Clippers,LAC @ GSW,127,-2,Regular Season
22018,1610612753,ORL,Orlando Magic,0021800491,2018-12-23T00:00:00Z,ORL vs. MIA,91,-24,1610612748,MIA,Miami Heat,MIA @ ORL,115,24,Regular Season
22018,1610612760,OKC,Oklahoma City Thunder,0021800493,2018-12-23T00:00:00Z,OKC vs. MIN,112,-2,1610612750,MIN,Minnesota Timberwolves,MIN @ OKC,114,2,Regular Season
22018,1610612758,SAC,Sacramento Kings,0021800492,2018-12-23T00:00:00Z,SAC vs. NOP,122,5,1610612740,NOP,New Orleans Pelicans,NOP @ SAC,117,-5,Regular Season
22018,1610612765,DET,Detroit Pistons,0021800486,2018-12-23T00:00:00Z,DET vs. ATL,95,-3,1610612737,ATL,Atlanta Hawks,ATL @ DET,98,3,Regular Season
22018,1610612747,LAL,Los Angeles Lakers,0021800496,2018-12-23T00:00:00Z,LAL vs. MEM,99,-8,1610612763,MEM,Memphis Grizzlies,MEM @ LAL,107,8,Regular Season
22018,1610612738,BOS,Boston Celtics,0021800488,2018-12-23T00:00:00Z,BOS vs. CHA,119,16,1610612766,CHA,Charlotte Hornets,CHA @ BOS,103,-16,Regular Season
22018,1610612754,IND,Indiana Pacers,0021800487,2018-12-23T00:00:00Z,IND vs. WAS,105,16,1610612764,WAS,Washington Wizards,WAS @ IND,89,-16,Regular Season
22018,1610612757,POR,Portland Trail Blazers,0021800495,2018-12-23T00:00:00Z,POR vs. DAL,121,3,1610612742,DAL,Dallas Mavericks,DAL @ POR,118,-3,Regular Season
22018,1610612739,CLE,Cleveland Cavaliers,0021800490,2018-12-23T00:00:00Z,CLE vs. CHI,92,-20,1610612741,CHI,Chicago Bulls,CHI @ CLE,112,20,Regular Season
22018,1610612751,BKN,Brooklyn Nets,0021800489,2018-12-23T00:00:00Z,BKN vs. PHX,111,8,1610612756,PHX,Phoenix Suns,PHX @ BKN,103,-8,Regular Season
22018,1610612745,HOU,Houston Rockets,0021800498,2018-12-25T00:00:00Z,HOU vs. OKC,113,4,1610612760,OKC,Oklahoma City Thunder,OKC @ HOU,109,-4,Regular Season
22018,1610612752,NYK,New York Knicks,0021800497,2018-12-25T00:00:00Z,NYK vs. MIL,95,-14,1610612749,MIL,Milwaukee Bucks,MIL @ NYK,109,14,Regular Season
22018,1610612744,GSW,Golden State Warriors,0021800500,2018-12-25T00:00:00Z,GSW vs. LAL,101,-26,1610612747,LAL,Los Angeles Lakers,LAL @ GSW,127,26,Regular Season
22018,1610612738,BOS,Boston Celtics,0021800499,2018-12-25T00:00:00Z,BOS vs. PHI,121,7,1610612755,PHI,Philadelphia 76ers,PHI @ BOS,114,-7,Regular Season
22018,1610612762,UTA,Utah Jazz,0021800501,2018-12-25T00:00:00Z,UTA vs. POR,117,21,1610612757,POR,Portland Trail Blazers,POR @ UTA,96,-21,Regular Season
22018,1610612741,CHI,Chicago Bulls,0021800507,2018-12-26T00:00:00Z,CHI vs. MIN,94,-25,1610612750,MIN,Minnesota Timberwolves,MIN @ CHI,119,25,Regular Season
22018,1610612737,ATL,Atlanta Hawks,0021800504,2018-12-26T00:00:00Z,ATL vs. IND,121,-8,1610612754,IND,Indiana Pacers,IND @ ATL,129,8,Regular Season
22018,1610612742,DAL,Dallas Mavericks,0021800509,2018-12-26T00:00:00Z,DAL vs. NOP,122,3,1610612740,NOP,New Orleans Pelicans,NOP @ DAL,119,-3,Regular Season
22018,1610612753,ORL,Orlando Magic,0021800503,2018-12-26T00:00:00Z,ORL vs. PHX,120,-2,1610612756,PHX,Phoenix Suns,PHX @ ORL,122,2,Regular Season
22018,1610612763,MEM,Memphis Grizzlies,0021800508,2018-12-26T00:00:00Z,MEM vs. CLE,95,8,1610612739,CLE,Cleveland Cavaliers,CLE @ MEM,87,-8,Regular Season
22018,1610612748,MIA,Miami Heat,0021800506,2018-12-26T00:00:00Z,MIA vs. TOR,104,-2,1610612761,TOR,Toronto Raptors,TOR @ MIA,106,2,Regular Season
22018,1610612759,SAS,San Antonio Spurs,0021800510,2018-12-26T00:00:00Z,SAS vs. DEN,111,8,1610612743,DEN,Denver Nuggets,DEN @ SAS,103,-8,Regular Season
22018,1610612746,LAC,LA Clippers,0021800511,2018-12-26T00:00:00Z,LAC vs. SAC,127,9,1610612758,SAC,Sacramento Kings,SAC @ LAC,118,-9,Regular Season
22018,1610612765,DET,Detroit Pistons,0021800502,2018-12-26T00:00:00Z,DET vs. WAS,106,11,1610612764,WAS,Washington Wizards,WAS @ DET,95,-11,Regular Season
22018,1610612751,BKN,Brooklyn Nets,0021800505,2018-12-26T00:00:00Z,BKN vs. CHA,134,2,1610612766,CHA,Charlotte Hornets,CHA @ BKN,132,-2,Regular Season
22018,1610612744,GSW,Golden State Warriors,0021800516,2018-12-27T00:00:00Z,GSW vs. POR,109,-1,1610612757,POR,Portland Trail Blazers,POR @ GSW,110,1,Regular Season
22018,1610612749,MIL,Milwaukee Bucks,0021800513,2018-12-27T00:00:00Z,MIL vs. NYK,112,16,1610612752,NYK,New York Knicks,NYK @ MIL,96,-16,Regular Season
22018,1610612762,UTA,Utah Jazz,0021800515,2018-12-27T00:00:00Z,UTA vs. PHI,97,-17,1610612755,PHI,Philadelphia 76ers,PHI @ UTA,114,17,Regular Season
22018,1610612758,SAC,Sacramento Kings,0021800514,2018-12-27T00:00:00Z,SAC vs. LAL,117,1,1610612747,LAL,Los Angeles Lakers,LAL @ SAC,116,-1,Regular Season
22018,1610612745,HOU,Houston Rockets,0021800512,2018-12-27T00:00:00Z,HOU vs. BOS,127,14,1610612738,BOS,Boston Celtics,BOS @ HOU,113,-14,Regular Season
22018,1610612740,NOP,New Orleans Pelicans,0021800523,2018-12-28T00:00:00Z,NOP vs. DAL,114,2,1610612742,DAL,Dallas Mavericks,DAL @ NOP,112,-2,Regular Season
22018,1610612753,ORL,Orlando Magic,0021800519,2018-12-28T00:00:00Z,ORL vs. TOR,116,29,1610612761,TOR,Toronto Raptors,TOR @ ORL,87,-29,Regular Season
22018,1610612748,MIA,Miami Heat,0021800521,2018-12-28T00:00:00Z,MIA vs. CLE,118,24,1610612739,CLE,Cleveland Cavaliers,CLE @ MIA,94,-24,Regular Season
22018,1610612766,CHA,Charlotte Hornets,0021800517,2018-12-28T00:00:00Z,CHA vs. BKN,100,13,1610612751,BKN,Brooklyn Nets,BKN @ CHA,87,-13,Regular Season
22018,1610612764,WAS,Washington Wizards,0021800520,2018-12-28T00:00:00Z,WAS vs. CHI,92,-9,1610612741,CHI,Chicago Bulls,CHI @ WAS,101,9,Regular Season
22018,1610612747,LAL,Los Angeles Lakers,0021800526,2018-12-28T00:00:00Z,LAL vs. LAC,107,-11,1610612746,LAC,LA Clippers,LAC @ LAL,118,11,Regular Season
22018,1610612754,IND,Indiana Pacers,0021800518,2018-12-28T00:00:00Z,IND vs. DET,125,37,1610612765,DET,Detroit Pistons,DET @ IND,88,-37,Regular Season
22018,1610612756,PHX,Phoenix Suns,0021800525,2018-12-28T00:00:00Z,PHX vs. OKC,102,-16,1610612760,OKC,Oklahoma City Thunder,OKC @ PHX,118,16,Regular Season
22018,1610612743,DEN,Denver Nuggets,0021800524,2018-12-28T00:00:00Z,DEN vs. SAS,102,3,1610612759,SAS,San Antonio Spurs,SAS @ DEN,99,-3,Regular Season
22018,1610612750,MIN,Minnesota Timberwolves,0021800522,2018-12-28T00:00:00Z,MIN vs. ATL,120,-3,1610612737,ATL,Atlanta Hawks,ATL @ MIN,123,3,Regular Season
22018,1610612740,NOP,New Orleans Pelicans,0021800528,2018-12-29T00:00:00Z,NOP vs. HOU,104,-4,1610612745,HOU,Houston Rockets,HOU @ NOP,108,4,Regular Season
22018,1610612749,MIL,Milwaukee Bucks,0021800527,2018-12-29T00:00:00Z,MIL vs. BKN,129,14,1610612751,BKN,Brooklyn Nets,BKN @ MIL,115,-14,Regular Season
22018,1610612764,WAS,Washington Wizards,0021800530,2018-12-29T00:00:00Z,WAS vs. CHA,130,4,1610612766,CHA,Charlotte Hornets,CHA @ WAS,126,-4,Regular Season
22018,1610612746,LAC,LA Clippers,0021800535,2018-12-29T00:00:00Z,LAC vs. SAS,111,-11,1610612759,SAS,San Antonio Spurs,SAS @ LAC,122,11,Regular Season
22018,1610612762,UTA,Utah Jazz,0021800532,2018-12-29T00:00:00Z,UTA vs. NYK,129,32,1610612752,NYK,New York Knicks,NYK @ UTA,97,-32,Regular Season
22018,1610612756,PHX,Phoenix Suns,0021800533,2018-12-29T00:00:00Z,PHX vs. DEN,118,-4,1610612743,DEN,Denver Nuggets,DEN @ PHX,122,4,Regular Season
22018,1610612763,MEM,Memphis Grizzlies,0021800531,2018-12-29T00:00:00Z,MEM vs. BOS,103,-9,1610612738,BOS,Boston Celtics,BOS @ MEM,112,9,Regular Season
22018,1610612737,ATL,Atlanta Hawks,0021800529,2018-12-29T00:00:00Z,ATL vs. CLE,111,3,1610612739,CLE,Cleveland Cavaliers,CLE @ ATL,108,-3,Regular Season
22018,1610612757,POR,Portland Trail Blazers,0021800534,2018-12-29T00:00:00Z,POR vs. GSW,105,-10,1610612744,GSW,Golden State Warriors,GSW @ POR,115,10,Regular Season
22018,1610612761,TOR,Toronto Raptors,0021800538,2018-12-30T00:00:00Z,TOR vs. CHI,95,6,1610612741,CHI,Chicago Bulls,CHI @ TOR,89,-6,Regular Season
22018,1610612753,ORL,Orlando Magic,0021800536,2018-12-30T00:00:00Z,ORL vs. DET,109,2,1610612765,DET,Detroit Pistons,DET @ ORL,107,-2,Regular Season
22018,1610612747,LAL,Los Angeles Lakers,0021800541,2018-12-30T00:00:00Z,LAL vs. SAC,121,7,1610612758,SAC,Sacramento Kings,SAC @ LAL,114,-7,Regular Season
22018,1610612757,POR,Portland Trail Blazers,0021800540,2018-12-30T00:00:00Z,POR vs. PHI,129,34,1610612755,PHI,Philadelphia 76ers,PHI @ POR,95,-34,Regular Season
22018,1610612748,MIA,Miami Heat,0021800537,2018-12-30T00:00:00Z,MIA vs. MIN,104,-9,1610612750,MIN,Minnesota Timberwolves,MIN @ MIA,113,9,Regular Season
22018,1610612742,DAL,Dallas Mavericks,0021800539,2018-12-30T00:00:00Z,DAL vs. OKC,105,2,1610612760,OKC,Oklahoma City Thunder,OKC @ DAL,103,-2,Regular Season
22018,1610612766,CHA,Charlotte Hornets,0021800543,2018-12-31T00:00:00Z,CHA vs. ORL,125,25,1610612753,ORL,Orlando Magic,ORL @ CHA,100,-25,Regular Season
22018,1610612740,NOP,New Orleans Pelicans,0021800546,2018-12-31T00:00:00Z,NOP vs. MIN,123,9,1610612750,MIN,Minnesota Timberwolves,MIN @ NOP,114,-9,Regular Season
22018,1610612759,SAS,San Antonio Spurs,0021800545,2018-12-31T00:00:00Z,SAS vs. BOS,120,9,1610612738,BOS,Boston Celtics,BOS @ SAS,111,-9,Regular Season
22018,1610612756,PHX,Phoenix Suns,0021800548,2018-12-31T00:00:00Z,PHX vs. GSW,109,-23,1610612744,GSW,Golden State Warriors,GSW @ PHX,132,23,Regular Season
22018,1610612754,IND,Indiana Pacers,0021800542,2018-12-31T00:00:00Z,IND vs. ATL,116,8,1610612737,ATL,Atlanta Hawks,ATL @ IND,108,-8,Regular Season
22018,1610612745,HOU,Houston Rockets,0021800544,2018-12-31T00:00:00Z,HOU vs. MEM,113,12,1610612763,MEM,Memphis Grizzlies,MEM @ HOU,101,-12,Regular Season
22018,1610612760,OKC,Oklahoma City Thunder,0021800547,2018-12-31T00:00:00Z,OKC vs. DAL,122,20,1610612742,DAL,Dallas Mavericks,DAL @ OKC,102,-20,Regular Season
22018,1610612749,MIL,Milwaukee Bucks,0021800550,2019-01-01T00:00:00Z,MIL vs. DET,121,23,1610612765,DET,Detroit Pistons,DET @ MIL,98,-23,Regular Season
22018,1610612761,TOR,Toronto Raptors,0021800549,2019-01-01T00:00:00Z,TOR vs. UTA,122,6,1610612762,UTA,Utah Jazz,UTA @ TOR,116,-6,Regular Season
22018,1610612758,SAC,Sacramento Kings,0021800552,2019-01-01T00:00:00Z,SAC vs. POR,108,-5,1610612757,POR,Portland Trail Blazers,POR @ SAC,113,5,Regular Season
22018,1610612743,DEN,Denver Nuggets,0021800551,2019-01-01T00:00:00Z,DEN vs. NYK,115,7,1610612752,NYK,New York Knicks,NYK @ DEN,108,-7,Regular Season
22018,1610612746,LAC,LA Clippers,0021800553,2019-01-01T00:00:00Z,LAC vs. PHI,113,-6,1610612755,PHI,Philadelphia 76ers,PHI @ LAC,119,6,Regular Season
22018,1610612763,MEM,Memphis Grizzlies,0021800560,2019-01-02T00:00:00Z,MEM vs. DET,94,-7,1610612765,DET,Detroit Pistons,DET @ MEM,101,7,Regular Season
22018,1610612741,CHI,Chicago Bulls,0021800559,2019-01-02T00:00:00Z,CHI vs. ORL,84,-28,1610612753,ORL,Orlando Magic,ORL @ CHI,112,28,Regular Season
22018,1610612766,CHA,Charlotte Hornets,0021800554,2019-01-02T00:00:00Z,CHA vs. DAL,84,-38,1610612742,DAL,Dallas Mavericks,DAL @ CHA,122,38,Regular Season
22018,1610612764,WAS,Washington Wizards,0021800556,2019-01-02T00:00:00Z,WAS vs. ATL,114,16,1610612737,ATL,Atlanta Hawks,ATL @ WAS,98,-16,Regular Season
22018,1610612747,LAL,Los Angeles Lakers,0021800562,2019-01-02T00:00:00Z,LAL vs. OKC,100,-7,1610612760,OKC,Oklahoma City Thunder,OKC @ LAL,107,7,Regular Season
22018,1610612756,PHX,Phoenix Suns,0021800561,2019-01-02T00:00:00Z,PHX vs. PHI,127,-5,1610612755,PHI,Philadelphia 76ers,PHI @ PHX,132,5,Regular Season
22018,1610612751,BKN,Brooklyn Nets,0021800557,2019-01-02T00:00:00Z,BKN vs. NOP,126,5,1610612740,NOP,New Orleans Pelicans,NOP @ BKN,121,-5,Regular Season
22018,1610612738,BOS,Boston Celtics,0021800558,2019-01-02T00:00:00Z,BOS vs. MIN,115,13,1610612750,MIN,Minnesota Timberwolves,MIN @ BOS,102,-13,Regular Season
22018,1610612739,CLE,Cleveland Cavaliers,0021800555,2019-01-02T00:00:00Z,CLE vs. MIA,92,-25,1610612748,MIA,Miami Heat,MIA @ CLE,117,25,Regular Season
22018,1610612758,SAC,Sacramento Kings,0021800564,2019-01-03T00:00:00Z,SAC vs. DEN,113,-4,1610612743,DEN,Denver Nuggets,DEN @ SAC,117,4,Regular Season
22018,1610612759,SAS,San Antonio Spurs,0021800563,2019-01-03T00:00:00Z,SAS vs. TOR,125,18,1610612761,TOR,Toronto Raptors,TOR @ SAS,107,-18,Regular Season
22018,1610612744,GSW,Golden State Warriors,0021800565,2019-01-03T00:00:00Z,GSW vs. HOU,134,-1,1610612745,HOU,Houston Rockets,HOU @ GSW,135,1,Regular Season
22018,1610612747,LAL,Los Angeles Lakers,0021800574,2019-01-04T00:00:00Z,LAL vs. NYK,112,-7,1610612752,NYK,New York Knicks,NYK @ LAL,119,7,Regular Season
22018,1610612748,MIA,Miami Heat,0021800568,2019-01-04T00:00:00Z,MIA vs. WAS,115,6,1610612764,WAS,Washington Wizards,WAS @ MIA,109,-6,Regular Season
22018,1610612741,CHI,Chicago Bulls,0021800569,2019-01-04T00:00:00Z,CHI vs. IND,116,-3,1610612754,IND,Indiana Pacers,IND @ CHI,119,3,Regular Season
22018,1610612763,MEM,Memphis Grizzlies,0021800570,2019-01-04T00:00:00Z,MEM vs. BKN,100,-9,1610612751,BKN,Brooklyn Nets,BKN @ MEM,109,9,Regular Season
22018,1610612756,PHX,Phoenix Suns,0021800573,2019-01-04T00:00:00Z,PHX vs. LAC,111,-10,1610612746,LAC,LA Clippers,LAC @ PHX,121,10,Regular Season
22018,1610612757,POR,Portland Trail Blazers,0021800575,2019-01-04T00:00:00Z,POR vs. OKC,109,-2,1610612760,OKC,Oklahoma City Thunder,OKC @ POR,111,2,Regular Season
22018,1610612739,CLE,Cleveland Cavaliers,0021800567,2019-01-04T00:00:00Z,CLE vs. UTA,91,-26,1610612762,UTA,Utah Jazz,UTA @ CLE,117,26,Regular Season
22018,1610612750,MIN,Minnesota Timberwolves,0021800571,2019-01-04T00:00:00Z,MIN vs. ORL,120,17,1610612753,ORL,Orlando Magic,ORL @ MIN,103,-17,Regular Season
22018,1610612738,BOS,Boston Celtics,0021800566,2019-01-04T00:00:00Z,BOS vs. DAL,114,21,1610612742,DAL,Dallas Mavericks,DAL @ BOS,93,-21,Regular Season
22018,1610612749,MIL,Milwaukee Bucks,0021800572,2019-01-04T00:00:00Z,MIL vs. ATL,144,32,1610612737,ATL,Atlanta Hawks,ATL @ MIL,112,-32,Regular Season
22018,1610612765,DET,Detroit Pistons,0021800577,2019-01-05T00:00:00Z,DET vs. UTA,105,-5,1610612762,UTA,Utah Jazz,UTA @ DET,110,5,Regular Season
22018,1610612755,PHI,Philadelphia 76ers,0021800578,2019-01-05T00:00:00Z,PHI vs. DAL,106,6,1610612742,DAL,Dallas Mavericks,DAL @ PHI,100,-6,Regular Season
22018,1610612739,CLE,Cleveland Cavaliers,0021800579,2019-01-05T00:00:00Z,CLE vs. NOP,98,-35,1610612740,NOP,New Orleans Pelicans,NOP @ CLE,133,35,Regular Season
22018,1610612749,MIL,Milwaukee Bucks,0021800580,2019-01-05T00:00:00Z,MIL vs. TOR,116,-7,1610612761,TOR,Toronto Raptors,TOR @ MIL,123,7,Regular Season
22018,1610612758,SAC,Sacramento Kings,0021800583,2019-01-05T00:00:00Z,SAC vs. GSW,123,-4,1610612744,GSW,Golden State Warriors,GSW @ SAC,127,4,Regular Season
22018,1610612759,SAS,San Antonio Spurs,0021800581,2019-01-05T00:00:00Z,SAS vs. MEM,108,20,1610612763,MEM,Memphis Grizzlies,MEM @ SAS,88,-20,Regular Season
22018,1610612743,DEN,Denver Nuggets,0021800576,2019-01-05T00:00:00Z,DEN vs. CHA,123,13,1610612766,CHA,Charlotte Hornets,CHA @ DEN,110,-13,Regular Season
22018,1610612757,POR,Portland Trail Blazers,0021800582,2019-01-05T00:00:00Z,POR vs. HOU,110,9,1610612745,HOU,Houston Rockets,HOU @ POR,101,-9,Regular Season
22018,1610612756,PHX,Phoenix Suns,0021800590,2019-01-06T00:00:00Z,PHX vs. CHA,113,-6,1610612766,CHA,Charlotte Hornets,CHA @ PHX,119,6,Regular Season
22018,1610612746,LAC,LA Clippers,0021800586,2019-01-06T00:00:00Z,LAC vs. ORL,106,10,1610612753,ORL,Orlando Magic,ORL @ LAC,96,-10,Regular Season
22018,1610612741,CHI,Chicago Bulls,0021800584,2019-01-06T00:00:00Z,CHI vs. BKN,100,-17,1610612751,BKN,Brooklyn Nets,BKN @ CHI,117,17,Regular Season
22018,1610612760,OKC,Oklahoma City Thunder,0021800588,2019-01-06T00:00:00Z,OKC vs. WAS,98,-18,1610612764,WAS,Washington Wizards,WAS @ OKC,116,18,Regular Season
22018,1610612737,ATL,Atlanta Hawks,0021800587,2019-01-06T00:00:00Z,ATL vs. MIA,106,24,1610612748,MIA,Miami Heat,MIA @ ATL,82,-24,Regular Season
22018,1610612761,TOR,Toronto Raptors,0021800589,2019-01-06T00:00:00Z,TOR vs. IND,121,16,1610612754,IND,Indiana Pacers,IND @ TOR,105,-16,Regular Season
22018,1610612750,MIN,Minnesota Timberwolves,0021800585,2019-01-06T00:00:00Z,MIN vs. LAL,108,22,1610612747,LAL,Los Angeles Lakers,LAL @ MIN,86,-22,Regular Season
22018,1610612758,SAC,Sacramento Kings,0021800598,2019-01-07T00:00:00Z,SAC vs. ORL,111,16,1610612753,ORL,Orlando Magic,ORL @ SAC,95,-16,Regular Season
22018,1610612757,POR,Portland Trail Blazers,0021800597,2019-01-07T00:00:00Z,POR vs. NYK,111,10,1610612752,NYK,New York Knicks,NYK @ POR,101,-10,Regular Season
22018,1610612740,NOP,New Orleans Pelicans,0021800595,2019-01-07T00:00:00Z,NOP vs. MEM,114,19,1610612763,MEM,Memphis Grizzlies,MEM @ NOP,95,-19,Regular Season
22018,1610612745,HOU,Houston Rockets,0021800593,2019-01-07T00:00:00Z,HOU vs. DEN,125,12,1610612743,DEN,Denver Nuggets,DEN @ HOU,113,-12,Regular Season
22018,1610612738,BOS,Boston Celtics,0021800592,2019-01-07T00:00:00Z,BOS vs. BKN,116,21,1610612751,BKN,Brooklyn Nets,BKN @ BOS,95,-21,Regular Season
22018,1610612742,DAL,Dallas Mavericks,0021800596,2019-01-07T00:00:00Z,DAL vs. LAL,97,-10,1610612747,LAL,Los Angeles Lakers,LAL @ DAL,107,10,Regular Season
22018,1610612765,DET,Detroit Pistons,0021800591,2019-01-07T00:00:00Z,DET vs. SAS,107,-12,1610612759,SAS,San Antonio Spurs,SAS @ DET,119,12,Regular Season
22018,1610612749,MIL,Milwaukee Bucks,0021800594,2019-01-07T00:00:00Z,MIL vs. UTA,114,12,1610612762,UTA,Utah Jazz,UTA @ MIL,102,-12,Regular Season
22018,1610612760,OKC,Oklahoma City Thunder,0021800603,2019-01-08T00:00:00Z,OKC vs. MIN,117,-2,1610612750,MIN,Minnesota Timberwolves,MIN @ OKC,119,2,Regular Season
22018,1610612746,LAC,LA Clippers,0021800606,2019-01-08T00:00:00Z,LAC vs. CHA,128,19,1610612766,CHA,Charlotte Hornets,CHA @ LAC,109,-19,Regular Season
22018,1610612739,CLE,Cleveland Cavaliers,0021800599,2019-01-08T00:00:00Z,CLE vs. IND,115,-8,1610612754,IND,Indiana Pacers,IND @ CLE,123,8,Regular Season
22018,1610612755,PHI,Philadelphia 76ers,0021800600,2019-01-08T00:00:00Z,PHI vs. WAS,132,17,1610612764,WAS,Washington Wizards,WAS @ PHI,115,-17,Regular Season
22018,1610612761,TOR,Toronto Raptors,0021800602,2019-01-08T00:00:00Z,TOR vs. ATL,104,3,1610612737,ATL,Atlanta Hawks,ATL @ TOR,101,-3,Regular Season
22018,1610612756,PHX,Phoenix Suns,0021800604,2019-01-08T00:00:00Z,PHX vs. SAC,115,4,1610612758,SAC,Sacramento Kings,SAC @ PHX,111,-4,Regular Season
22018,1610612744,GSW,Golden State Warriors,0021800605,2019-01-08T00:00:00Z,GSW vs. NYK,122,27,1610612752,NYK,New York Knicks,NYK @ GSW,95,-27,Regular Season
22018,1610612748,MIA,Miami Heat,0021800601,2019-01-08T00:00:00Z,MIA vs. DEN,99,-4,1610612743,DEN,Denver Nuggets,DEN @ MIA,103,4,Regular Season
22018,1610612751,BKN,Brooklyn Nets,0021800609,2019-01-09T00:00:00Z,BKN vs. ATL,116,16,1610612737,ATL,Atlanta Hawks,ATL @ BKN,100,-16,Regular Season
22018,1610612745,HOU,Houston Rockets,0021800610,2019-01-09T00:00:00Z,HOU vs. MIL,109,-7,1610612749,MIL,Milwaukee Bucks,MIL @ HOU,116,7,Regular Season
22018,1610612764,WAS,Washington Wizards,0021800608,2019-01-09T00:00:00Z,WAS vs. PHI,123,17,1610612755,PHI,Philadelphia 76ers,PHI @ WAS,106,-17,Regular Season
22018,1610612740,NOP,New Orleans Pelicans,0021800612,2019-01-09T00:00:00Z,NOP vs. CLE,140,16,1610612739,CLE,Cleveland Cavaliers,CLE @ NOP,124,-16,Regular Season
22018,1610612738,BOS,Boston Celtics,0021800607,2019-01-09T00:00:00Z,BOS vs. IND,135,27,1610612754,IND,Indiana Pacers,IND @ BOS,108,-27,Regular Season
22018,1610612757,POR,Portland Trail Blazers,0021800615,2019-01-09T00:00:00Z,POR vs. CHI,124,12,1610612741,CHI,Chicago Bulls,CHI @ POR,112,-12,Regular Season
22018,1610612747,LAL,Los Angeles Lakers,0021800616,2019-01-09T00:00:00Z,LAL vs. DET,113,13,1610612765,DET,Detroit Pistons,DET @ LAL,100,-13,Regular Season
22018,1610612763,MEM,Memphis Grizzlies,0021800611,2019-01-09T00:00:00Z,MEM vs. SAS,96,10,1610612759,SAS,San Antonio Spurs,SAS @ MEM,86,-10,Regular Season
22018,1610612742,DAL,Dallas Mavericks,0021800613,2019-01-09T00:00:00Z,DAL vs. PHX,104,10,1610612756,PHX,Phoenix Suns,PHX @ DAL,94,-10,Regular Season
22018,1610612762,UTA,Utah Jazz,0021800614,2019-01-09T00:00:00Z,UTA vs. ORL,106,13,1610612753,ORL,Orlando Magic,ORL @ UTA,93,-13,Regular Season
22018,1610612743,DEN,Denver Nuggets,0021800618,2019-01-10T00:00:00Z,DEN vs. LAC,121,21,1610612746,LAC,LA Clippers,LAC @ DEN,100,-21,Regular Season
22018,1610612758,SAC,Sacramento Kings,0021800620,2019-01-10T00:00:00Z,SAC vs. DET,112,10,1610612765,DET,Detroit Pistons,DET @ SAC,102,-10,Regular Season
22018,1610612759,SAS,San Antonio Spurs,0021800619,2019-01-10T00:00:00Z,SAS vs. OKC,154,7,1610612760,OKC,Oklahoma City Thunder,OKC @ SAS,147,-7,Regular Season
22018,1610612748,MIA,Miami Heat,0021800617,2019-01-10T00:00:00Z,MIA vs. BOS,115,16,1610612738,BOS,Boston Celtics,BOS @ MIA,99,-16,Regular Season
22018,1610612764,WAS,Washington Wizards,0021800622,2019-01-11T00:00:00Z,WAS vs. MIL,113,7,1610612749,MIL,Milwaukee Bucks,MIL @ WAS,106,-7,Regular Season
22018,1610612755,PHI,Philadelphia 76ers,0021800621,2019-01-11T00:00:00Z,PHI vs. ATL,121,-2,1610612737,ATL,Atlanta Hawks,ATL @ PHI,123,2,Regular Season
22018,1610612757,POR,Portland Trail Blazers,0021800628,2019-01-11T00:00:00Z,POR vs. CHA,127,31,1610612766,CHA,Charlotte Hornets,CHA @ POR,96,-31,Regular Season
22018,1610612762,UTA,Utah Jazz,0021800627,2019-01-11T00:00:00Z,UTA vs. LAL,113,18,1610612747,LAL,Los Angeles Lakers,LAL @ UTA,95,-18,Regular Season
22018,1610612750,MIN,Minnesota Timberwolves,0021800626,2019-01-11T00:00:00Z,MIN vs. DAL,115,-4,1610612742,DAL,Dallas Mavericks,DAL @ MIN,119,4,Regular Season
22018,1610612745,HOU,Houston Rockets,0021800625,2019-01-11T00:00:00Z,HOU vs. CLE,141,28,1610612739,CLE,Cleveland Cavaliers,CLE @ HOU,113,-28,Regular Season
22018,1610612752,NYK,New York Knicks,0021800623,2019-01-11T00:00:00Z,NYK vs. IND,106,-15,1610612754,IND,Indiana Pacers,IND @ NYK,121,15,Regular Season
22018,1610612761,TOR,Toronto Raptors,0021800624,2019-01-11T00:00:00Z,TOR vs. BKN,122,17,1610612751,BKN,Brooklyn Nets,BKN @ TOR,105,-17,Regular Season
22018,1610612744,GSW,Golden State Warriors,0021800629,2019-01-11T00:00:00Z,GSW vs. CHI,146,37,1610612741,CHI,Chicago Bulls,CHI @ GSW,109,-37,Regular Season
22018,1610612750,MIN,Minnesota Timberwolves,0021800633,2019-01-12T00:00:00Z,MIN vs. NOP,110,4,1610612740,NOP,New Orleans Pelicans,NOP @ MIN,106,-4,Regular Season
22018,1610612753,ORL,Orlando Magic,0021800632,2019-01-12T00:00:00Z,ORL vs. BOS,105,2,1610612738,BOS,Boston Celtics,BOS @ ORL,103,-2,Regular Season
22018,1610612762,UTA,Utah Jazz,0021800637,2019-01-12T00:00:00Z,UTA vs. CHI,110,8,1610612741,CHI,Chicago Bulls,CHI @ UTA,102,-8,Regular Season
22018,1610612746,LAC,LA Clippers,0021800630,2019-01-12T00:00:00Z,LAC vs. DET,104,-5,1610612765,DET,Detroit Pistons,DET @ LAC,109,5,Regular Season
22018,1610612758,SAC,Sacramento Kings,0021800636,2019-01-12T00:00:00Z,SAC vs. CHA,104,7,1610612766,CHA,Charlotte Hornets,CHA @ SAC,97,-7,Regular Season
22018,1610612760,OKC,Oklahoma City Thunder,0021800634,2019-01-12T00:00:00Z,OKC vs. SAS,122,10,1610612759,SAS,San Antonio Spurs,SAS @ OKC,112,-10,Regular Season
22018,1610612756,PHX,Phoenix Suns,0021800635,2019-01-12T00:00:00Z,PHX vs. DEN,102,9,1610612743,DEN,Denver Nuggets,DEN @ PHX,93,-9,Regular Season
22018,1610612748,MIA,Miami Heat,0021800631,2019-01-12T00:00:00Z,MIA vs. MEM,112,4,1610612763,MEM,Memphis Grizzlies,MEM @ MIA,108,-4,Regular Season
22018,1610612737,ATL,Atlanta Hawks,0021800640,2019-01-13T00:00:00Z,ATL vs. MIL,114,-19,1610612749,MIL,Milwaukee Bucks,MIL @ ATL,133,19,Regular Season
22018,1610612764,WAS,Washington Wizards,0021800639,2019-01-13T00:00:00Z,WAS vs. TOR,138,-2,1610612761,TOR,Toronto Raptors,TOR @ WAS,140,2,Regular Season
22018,1610612742,DAL,Dallas Mavericks,0021800642,2019-01-13T00:00:00Z,DAL vs. GSW,114,-5,1610612744,GSW,Golden State Warriors,GSW @ DAL,119,5,Regular Season
22018,1610612747,LAL,Los Angeles Lakers,0021800644,2019-01-13T00:00:00Z,LAL vs. CLE,95,-6,1610612739,CLE,Cleveland Cavaliers,CLE @ LAL,101,6,Regular Season
22018,1610612743,DEN,Denver Nuggets,0021800643,2019-01-13T00:00:00Z,DEN vs. POR,116,3,1610612757,POR,Portland Trail Blazers,POR @ DEN,113,-3,Regular Season
22018,1610612753,ORL,Orlando Magic,0021800641,2019-01-13T00:00:00Z,ORL vs. HOU,116,7,1610612745,HOU,Houston Rockets,HOU @ ORL,109,-7,Regular Season
22018,1610612752,NYK,New York Knicks,0021800638,2019-01-13T00:00:00Z,NYK vs. PHI,105,-3,1610612755,PHI,Philadelphia 76ers,PHI @ NYK,108,3,Regular Season
22018,1610612758,SAC,Sacramento Kings,0021800649,2019-01-14T00:00:00Z,SAC vs. POR,115,8,1610612757,POR,Portland Trail Blazers,POR @ SAC,107,-8,Regular Season
22018,1610612759,SAS,San Antonio Spurs,0021800647,2019-01-14T00:00:00Z,SAS vs. CHA,93,-15,1610612766,CHA,Charlotte Hornets,CHA @ SAS,108,15,Regular Season
22018,1610612762,UTA,Utah Jazz,0021800648,2019-01-14T00:00:00Z,UTA vs. DET,100,6,1610612765,DET,Detroit Pistons,DET @ UTA,94,-6,Regular Season
22018,1610612751,BKN,Brooklyn Nets,0021800645,2019-01-14T00:00:00Z,BKN vs. BOS,109,7,1610612738,BOS,Boston Celtics,BOS @ BKN,102,-7,Regular Season
22018,1610612746,LAC,LA Clippers,0021800650,2019-01-14T00:00:00Z,LAC vs. NOP,117,-4,1610612740,NOP,New Orleans Pelicans,NOP @ LAC,121,4,Regular Season
22018,1610612745,HOU,Houston Rockets,0021800646,2019-01-14T00:00:00Z,HOU vs. MEM,112,18,1610612763,MEM,Memphis Grizzlies,MEM @ HOU,94,-18,Regular Season
22018,1610612755,PHI,Philadelphia 76ers,0021800652,2019-01-15T00:00:00Z,PHI vs. MIN,149,42,1610612750,MIN,Minnesota Timberwolves,MIN @ PHI,107,-42,Regular Season
22018,1610612743,DEN,Denver Nuggets,0021800655,2019-01-15T00:00:00Z,DEN vs. GSW,111,-31,1610612744,GSW,Golden State Warriors,GSW @ DEN,142,31,Regular Season
22018,1610612754,IND,Indiana Pacers,0021800651,2019-01-15T00:00:00Z,IND vs. PHX,131,34,1610612756,PHX,Phoenix Suns,PHX @ IND,97,-34,Regular Season
22018,1610612747,LAL,Los Angeles Lakers,0021800656,2019-01-15T00:00:00Z,LAL vs. CHI,107,7,1610612741,CHI,Chicago Bulls,CHI @ LAL,100,-7,Regular Season
22018,1610612749,MIL,Milwaukee Bucks,0021800654,2019-01-15T00:00:00Z,MIL vs. MIA,124,38,1610612748,MIA,Miami Heat,MIA @ MIL,86,-38,Regular Season
22018,1610612737,ATL,Atlanta Hawks,0021800653,2019-01-15T00:00:00Z,ATL vs. OKC,142,16,1610612760,OKC,Oklahoma City Thunder,OKC @ ATL,126,-16,Regular Season
22018,1610612742,DAL,Dallas Mavericks,0021800661,2019-01-16T00:00:00Z,DAL vs. SAS,101,-4,1610612759,SAS,San Antonio Spurs,SAS @ DAL,105,4,Regular Season
22018,1610612738,BOS,Boston Celtics,0021800658,2019-01-16T00:00:00Z,BOS vs. TOR,117,9,1610612761,TOR,Toronto Raptors,TOR @ BOS,108,-9,Regular Season
22018,1610612757,POR,Portland Trail Blazers,0021800662,2019-01-16T00:00:00Z,POR vs. CLE,129,17,1610612739,CLE,Cleveland Cavaliers,CLE @ POR,112,-17,Regular Season
22018,1610612765,DET,Detroit Pistons,0021800657,2019-01-16T00:00:00Z,DET vs. ORL,120,5,1610612753,ORL,Orlando Magic,ORL @ DET,115,-5,Regular Season
22018,1610612744,GSW,Golden State Warriors,0021800663,2019-01-16T00:00:00Z,GSW vs. NOP,147,7,1610612740,NOP,New Orleans Pelicans,NOP @ GSW,140,-7,Regular Season
22018,1610612745,HOU,Houston Rockets,0021800659,2019-01-16T00:00:00Z,HOU vs. BKN,142,-3,1610612751,BKN,Brooklyn Nets,BKN @ HOU,145,3,Regular Season
22018,1610612746,LAC,LA Clippers,0021800664,2019-01-16T00:00:00Z,LAC vs. UTA,109,-20,1610612762,UTA,Utah Jazz,UTA @ LAC,129,20,Regular Season
22018,1610612763,MEM,Memphis Grizzlies,0021800660,2019-01-16T00:00:00Z,MEM vs. MIL,101,-10,1610612749,MIL,Milwaukee Bucks,MIL @ MEM,111,10,Regular Season
22018,1610612761,TOR,Toronto Raptors,0021800668,2019-01-17T00:00:00Z,TOR vs. PHX,111,2,1610612756,PHX,Phoenix Suns,PHX @ TOR,109,-2,Regular Season
22018,1610612764,WAS,Washington Wizards,0021800665,2019-01-17T00:00:00Z,WAS vs. NYK,101,1,1610612752,NYK,New York Knicks,NYK @ WAS,100,-1,Regular Season
22018,1610612743,DEN,Denver Nuggets,0021800669,2019-01-17T00:00:00Z,DEN vs. CHI,135,30,1610612741,CHI,Chicago Bulls,CHI @ DEN,105,-30,Regular Season
22018,1610612760,OKC,Oklahoma City Thunder,0021800670,2019-01-17T00:00:00Z,OKC vs. LAL,128,-10,1610612747,LAL,Los Angeles Lakers,LAL @ OKC,138,10,Regular Season
22018,1610612766,CHA,Charlotte Hornets,0021800666,2019-01-17T00:00:00Z,CHA vs. SAC,114,19,1610612758,SAC,Sacramento Kings,SAC @ CHA,95,-19,Regular Season
22018,1610612754,IND,Indiana Pacers,0021800667,2019-01-17T00:00:00Z,IND vs. PHI,96,-24,1610612755,PHI,Philadelphia 76ers,PHI @ IND,120,24,Regular Season
22018,1610612762,UTA,Utah Jazz,0021800675,2019-01-18T00:00:00Z,UTA vs. CLE,115,16,1610612739,CLE,Cleveland Cavaliers,CLE @ UTA,99,-16,Regular Season
22018,1610612738,BOS,Boston Celtics,0021800671,2019-01-18T00:00:00Z,BOS vs. MEM,122,6,1610612763,MEM,Memphis Grizzlies,MEM @ BOS,116,-6,Regular Season
22018,1610612746,LAC,LA Clippers,0021800676,2019-01-18T00:00:00Z,LAC vs. GSW,94,-18,1610612744,GSW,Golden State Warriors,GSW @ LAC,112,18,Regular Season
22018,1610612750,MIN,Minnesota Timberwolves,0021800674,2019-01-18T00:00:00Z,MIN vs. SAS,113,-3,1610612759,SAS,San Antonio Spurs,SAS @ MIN,116,3,Regular Season
22018,1610612765,DET,Detroit Pistons,0021800672,2019-01-18T00:00:00Z,DET vs. MIA,98,5,1610612748,MIA,Miami Heat,MIA @ DET,93,-5,Regular Season
22018,1610612753,ORL,Orlando Magic,0021800673,2019-01-18T00:00:00Z,ORL vs. BKN,115,-2,1610612751,BKN,Brooklyn Nets,BKN @ ORL,117,2,Regular Season
22018,1610612757,POR,Portland Trail Blazers,0021800677,2019-01-18T00:00:00Z,POR vs. NOP,128,16,1610612740,NOP,New Orleans Pelicans,NOP @ POR,112,-16,Regular Season
22018,1610612745,HOU,Houston Rockets,0021800686,2019-01-19T00:00:00Z,HOU vs. LAL,138,4,1610612747,LAL,Los Angeles Lakers,LAL @ HOU,134,-4,Regular Season
22018,1610612753,ORL,Orlando Magic,0021800682,2019-01-19T00:00:00Z,ORL vs. MIL,108,-10,1610612749,MIL,Milwaukee Bucks,MIL @ ORL,118,10,Regular Season
22018,1610612765,DET,Detroit Pistons,0021800680,2019-01-19T00:00:00Z,DET vs. SAC,101,-2,1610612758,SAC,Sacramento Kings,SAC @ DET,103,2,Regular Season
22018,1610612761,TOR,Toronto Raptors,0021800684,2019-01-19T00:00:00Z,TOR vs. MEM,119,29,1610612763,MEM,Memphis Grizzlies,MEM @ TOR,90,-29,Regular Season
22018,1610612741,CHI,Chicago Bulls,0021800685,2019-01-19T00:00:00Z,CHI vs. MIA,103,-14,1610612748,MIA,Miami Heat,MIA @ CHI,117,14,Regular Season
22018,1610612743,DEN,Denver Nuggets,0021800687,2019-01-19T00:00:00Z,DEN vs. CLE,124,22,1610612739,CLE,Cleveland Cavaliers,CLE @ DEN,102,-22,Regular Season
22018,1610612754,IND,Indiana Pacers,0021800681,2019-01-19T00:00:00Z,IND vs. DAL,111,12,1610612742,DAL,Dallas Mavericks,DAL @ IND,99,-12,Regular Season
22018,1610612766,CHA,Charlotte Hornets,0021800679,2019-01-19T00:00:00Z,CHA vs. PHX,135,20,1610612756,PHX,Phoenix Suns,PHX @ CHA,115,-20,Regular Season
22018,1610612755,PHI,Philadelphia 76ers,0021800678,2019-01-19T00:00:00Z,PHI vs. OKC,115,-2,1610612760,OKC,Oklahoma City Thunder,OKC @ PHI,117,2,Regular Season
22018,1610612737,ATL,Atlanta Hawks,0021800683,2019-01-19T00:00:00Z,ATL vs. BOS,105,-8,1610612738,BOS,Boston Celtics,BOS @ ATL,113,8,Regular Season
22018,1610612754,IND,Indiana Pacers,0021800688,2019-01-20T00:00:00Z,IND vs. CHA,120,25,1610612766,CHA,Charlotte Hornets,CHA @ IND,95,-25,Regular Season
22018,1610612750,MIN,Minnesota Timberwolves,0021800689,2019-01-20T00:00:00Z,MIN vs. PHX,116,2,1610612756,PHX,Phoenix Suns,PHX @ MIN,114,-2,Regular Season
22018,1610612759,SAS,San Antonio Spurs,0021800690,2019-01-20T00:00:00Z,SAS vs. LAC,95,-8,1610612746,LAC,LA Clippers,LAC @ SAS,103,8,Regular Season
22018,1610612763,MEM,Memphis Grizzlies,0021800697,2019-01-21T00:00:00Z,MEM vs. NOP,85,-20,1610612740,NOP,New Orleans Pelicans,NOP @ MEM,105,20,Regular Season
22018,1610612747,LAL,Los Angeles Lakers,0021800701,2019-01-21T00:00:00Z,LAL vs. GSW,111,-19,1610612744,GSW,Golden State Warriors,GSW @ LAL,130,19,Regular Season
22018,1610612749,MIL,Milwaukee Bucks,0021800694,2019-01-21T00:00:00Z,MIL vs. DAL,116,10,1610612742,DAL,Dallas Mavericks,DAL @ MIL,106,-10,Regular Season
22018,1610612752,NYK,New York Knicks,0021800691,2019-01-21T00:00:00Z,NYK vs. OKC,109,-18,1610612760,OKC,Oklahoma City Thunder,OKC @ NYK,127,18,Regular Season
22018,1610612751,BKN,Brooklyn Nets,0021800696,2019-01-21T00:00:00Z,BKN vs. SAC,123,29,1610612758,SAC,Sacramento Kings,SAC @ BKN,94,-29,Regular Season
22018,1610612762,UTA,Utah Jazz,0021800700,2019-01-21T00:00:00Z,UTA vs. POR,104,-5,1610612757,POR,Portland Trail Blazers,POR @ UTA,109,5,Regular Season
22018,1610612737,ATL,Atlanta Hawks,0021800695,2019-01-21T00:00:00Z,ATL vs. ORL,103,-19,1610612753,ORL,Orlando Magic,ORL @ ATL,122,19,Regular Season
22018,1610612739,CLE,Cleveland Cavaliers,0021800692,2019-01-21T00:00:00Z,CLE vs. CHI,88,-16,1610612741,CHI,Chicago Bulls,CHI @ CLE,104,16,Regular Season
22018,1610612764,WAS,Washington Wizards,0021800693,2019-01-21T00:00:00Z,WAS vs. DET,101,14,1610612765,DET,Detroit Pistons,DET @ WAS,87,-14,Regular Season
22018,1610612755,PHI,Philadelphia 76ers,0021800699,2019-01-21T00:00:00Z,PHI vs. HOU,121,28,1610612745,HOU,Houston Rockets,HOU @ PHI,93,-28,Regular Season
22018,1610612738,BOS,Boston Celtics,0021800698,2019-01-21T00:00:00Z,BOS vs. MIA,107,8,1610612748,MIA,Miami Heat,MIA @ BOS,99,-8,Regular Season
22018,1610612760,OKC,Oklahoma City Thunder,0021800703,2019-01-22T00:00:00Z,OKC vs. POR,123,9,1610612757,POR,Portland Trail Blazers,POR @ OKC,114,-9,Regular Season
22018,1610612756,PHX,Phoenix Suns,0021800705,2019-01-22T00:00:00Z,PHX vs. MIN,91,-27,1610612750,MIN,Minnesota Timberwolves,MIN @ PHX,118,27,Regular Season
22018,1610612761,TOR,Toronto Raptors,0021800702,2019-01-22T00:00:00Z,TOR vs. SAC,120,15,1610612758,SAC,Sacramento Kings,SAC @ TOR,105,-15,Regular Season
22018,1610612742,DAL,Dallas Mavericks,0021800704,2019-01-22T00:00:00Z,DAL vs. LAC,106,8,1610612746,LAC,LA Clippers,LAC @ DAL,98,-8,Regular Season
22018,1610612748,MIA,Miami Heat,0021800709,2019-01-23T00:00:00Z,MIA vs. LAC,99,-12,1610612746,LAC,LA Clippers,LAC @ MIA,111,12,Regular Season
22018,1610612751,BKN,Brooklyn Nets,0021800708,2019-01-23T00:00:00Z,BKN vs. ORL,114,4,1610612753,ORL,Orlando Magic,ORL @ BKN,110,-4,Regular Season
22018,1610612762,UTA,Utah Jazz,0021800715,2019-01-23T00:00:00Z,UTA vs. DEN,114,6,1610612743,DEN,Denver Nuggets,DEN @ UTA,108,-6,Regular Season
22018,1610612741,CHI,Chicago Bulls,0021800712,2019-01-23T00:00:00Z,CHI vs. ATL,101,-20,1610612737,ATL,Atlanta Hawks,ATL @ CHI,121,20,Regular Season
22018,1610612763,MEM,Memphis Grizzlies,0021800713,2019-01-23T00:00:00Z,MEM vs. CHA,107,-11,1610612766,CHA,Charlotte Hornets,CHA @ MEM,118,11,Regular Season
22018,1610612755,PHI,Philadelphia 76ers,0021800711,2019-01-23T00:00:00Z,PHI vs. SAS,122,2,1610612759,SAS,San Antonio Spurs,SAS @ PHI,120,-2,Regular Season
22018,1610612754,IND,Indiana Pacers,0021800706,2019-01-23T00:00:00Z,IND vs. TOR,110,4,1610612761,TOR,Toronto Raptors,TOR @ IND,106,-4,Regular Season
22018,1610612738,BOS,Boston Celtics,0021800707,2019-01-23T00:00:00Z,BOS vs. CLE,123,20,1610612739,CLE,Cleveland Cavaliers,CLE @ BOS,103,-20,Regular Season
22018,1610612740,NOP,New Orleans Pelicans,0021800714,2019-01-23T00:00:00Z,NOP vs. DET,94,-4,1610612765,DET,Detroit Pistons,DET @ NOP,98,4,Regular Season
22018,1610612752,NYK,New York Knicks,0021800710,2019-01-23T00:00:00Z,NYK vs. HOU,110,-4,1610612745,HOU,Houston Rockets,HOU @ NYK,114,4,Regular Season
22018,1610612760,OKC,Oklahoma City Thunder,0021800717,2019-01-24T00:00:00Z,OKC vs. NOP,122,6,1610612740,NOP,New Orleans Pelicans,NOP @ OKC,116,-6,Regular Season
22018,1610612764,WAS,Washington Wizards,0021800716,2019-01-24T00:00:00Z,WAS vs. GSW,118,-8,1610612744,GSW,Golden State Warriors,GSW @ WAS,126,8,Regular Season
22018,1610612747,LAL,Los Angeles Lakers,0021800719,2019-01-24T00:00:00Z,LAL vs. MIN,105,-15,1610612750,MIN,Minnesota Timberwolves,MIN @ LAL,120,15,Regular Season
22018,1610612756,PHX,Phoenix Suns,0021800718,2019-01-24T00:00:00Z,PHX vs. POR,106,-14,1610612757,POR,Portland Trail Blazers,POR @ PHX,120,14,Regular Season
22018,1610612762,UTA,Utah Jazz,0021800729,2019-01-25T00:00:00Z,UTA vs. MIN,106,4,1610612750,MIN,Minnesota Timberwolves,MIN @ UTA,102,-4,Regular Season
22018,1610612741,CHI,Chicago Bulls,0021800723,2019-01-25T00:00:00Z,CHI vs. LAC,101,-5,1610612746,LAC,LA Clippers,LAC @ CHI,106,5,Regular Season
22018,1610612763,MEM,Memphis Grizzlies,0021800725,2019-01-25T00:00:00Z,MEM vs. SAC,96,-3,1610612758,SAC,Sacramento Kings,SAC @ MEM,99,3,Regular Season
22018,1610612742,DAL,Dallas Mavericks,0021800726,2019-01-25T00:00:00Z,DAL vs. DET,106,5,1610612765,DET,Detroit Pistons,DET @ DAL,101,-5,Regular Season
22018,1610612739,CLE,Cleveland Cavaliers,0021800722,2019-01-25T00:00:00Z,CLE vs. MIA,94,-6,1610612748,MIA,Miami Heat,MIA @ CLE,100,6,Regular Season
22018,1610612743,DEN,Denver Nuggets,0021800728,2019-01-25T00:00:00Z,DEN vs. PHX,132,37,1610612756,PHX,Phoenix Suns,PHX @ DEN,95,-37,Regular Season
22018,1610612751,BKN,Brooklyn Nets,0021800721,2019-01-25T00:00:00Z,BKN vs. NYK,109,10,1610612752,NYK,New York Knicks,NYK @ BKN,99,-10,Regular Season
22018,1610612749,MIL,Milwaukee Bucks,0021800727,2019-01-25T00:00:00Z,MIL vs. CHA,108,9,1610612766,CHA,Charlotte Hornets,CHA @ MIL,99,-9,Regular Season
22018,1610612745,HOU,Houston Rockets,0021800724,2019-01-25T00:00:00Z,HOU vs. TOR,121,2,1610612761,TOR,Toronto Raptors,TOR @ HOU,119,-2,Regular Season
22018,1610612753,ORL,Orlando Magic,0021800720,2019-01-25T00:00:00Z,ORL vs. WAS,91,-4,1610612764,WAS,Washington Wizards,WAS @ ORL,95,4,Regular Season
22018,1610612757,POR,Portland Trail Blazers,0021800734,2019-01-26T00:00:00Z,POR vs. ATL,120,9,1610612737,ATL,Atlanta Hawks,ATL @ POR,111,-9,Regular Season
22018,1610612763,MEM,Memphis Grizzlies,0021800731,2019-01-26T00:00:00Z,MEM vs. IND,106,3,1610612754,IND,Indiana Pacers,IND @ MEM,103,-3,Regular Season
22018,1610612743,DEN,Denver Nuggets,0021800733,2019-01-26T00:00:00Z,DEN vs. PHI,126,16,1610612755,PHI,Philadelphia 76ers,PHI @ DEN,110,-16,Regular Season
22018,1610612738,BOS,Boston Celtics,0021800732,2019-01-26T00:00:00Z,BOS vs. GSW,111,-4,1610612744,GSW,Golden State Warriors,GSW @ BOS,115,4,Regular Season
22018,1610612740,NOP,New Orleans Pelicans,0021800730,2019-01-26T00:00:00Z,NOP vs. SAS,114,-12,1610612759,SAS,San Antonio Spurs,SAS @ NOP,126,12,Regular Season
22018,1610612745,HOU,Houston Rockets,0021800737,2019-01-27T00:00:00Z,HOU vs. ORL,103,5,1610612753,ORL,Orlando Magic,ORL @ HOU,98,-5,Regular Season
22018,1610612747,LAL,Los Angeles Lakers,0021800743,2019-01-27T00:00:00Z,LAL vs. PHX,116,14,1610612756,PHX,Phoenix Suns,PHX @ LAL,102,-14,Regular Season
22018,1610612759,SAS,San Antonio Spurs,0021800742,2019-01-27T00:00:00Z,SAS vs. WAS,132,13,1610612764,WAS,Washington Wizards,WAS @ SAS,119,-13,Regular Season
22018,1610612742,DAL,Dallas Mavericks,0021800739,2019-01-27T00:00:00Z,DAL vs. TOR,120,-3,1610612761,TOR,Toronto Raptors,TOR @ DAL,123,3,Regular Season
22018,1610612752,NYK,New York Knicks,0021800741,2019-01-27T00:00:00Z,NYK vs. MIA,97,-9,1610612748,MIA,Miami Heat,MIA @ NYK,106,9,Regular Season
22018,1610612741,CHI,Chicago Bulls,0021800735,2019-01-27T00:00:00Z,CHI vs. CLE,101,-3,1610612739,CLE,Cleveland Cavaliers,CLE @ CHI,104,3,Regular Season
22018,1610612760,OKC,Oklahoma City Thunder,0021800738,2019-01-27T00:00:00Z,OKC vs. MIL,118,6,1610612749,MIL,Milwaukee Bucks,MIL @ OKC,112,-6,Regular Season
22018,1610612750,MIN,Minnesota Timberwolves,0021800740,2019-01-27T00:00:00Z,MIN vs. UTA,111,-14,1610612762,UTA,Utah Jazz,UTA @ MIN,125,14,Regular Season
22018,1610612746,LAC,LA Clippers,0021800736,2019-01-27T00:00:00Z,LAC vs. SAC,122,14,1610612758,SAC,Sacramento Kings,SAC @ LAC,108,-14,Regular Season
22018,1610612746,LAC,LA Clippers,0021800748,2019-01-28T00:00:00Z,LAC vs. ATL,118,-5,1610612737,ATL,Atlanta Hawks,ATL @ LAC,123,5,Regular Season
22018,1610612738,BOS,Boston Celtics,0021800746,2019-01-28T00:00:00Z,BOS vs. BKN,112,8,1610612751,BKN,Brooklyn Nets,BKN @ BOS,104,-8,Regular Season
22018,1610612763,MEM,Memphis Grizzlies,0021800747,2019-01-28T00:00:00Z,MEM vs. DEN,92,-3,1610612743,DEN,Denver Nuggets,DEN @ MEM,95,3,Regular Season
22018,1610612754,IND,Indiana Pacers,0021800745,2019-01-28T00:00:00Z,IND vs. GSW,100,-32,1610612744,GSW,Golden State Warriors,GSW @ IND,132,32,Regular Season
22018,1610612766,CHA,Charlotte Hornets,0021800744,2019-01-28T00:00:00Z,CHA vs. NYK,101,9,1610612752,NYK,New York Knicks,NYK @ CHA,92,-9,Regular Season
22018,1610612759,SAS,San Antonio Spurs,0021800754,2019-01-29T00:00:00Z,SAS vs. PHX,126,2,1610612756,PHX,Phoenix Suns,PHX @ SAS,124,-2,Regular Season
22018,1610612739,CLE,Cleveland Cavaliers,0021800749,2019-01-29T00:00:00Z,CLE vs. WAS,116,3,1610612764,WAS,Washington Wizards,WAS @ CLE,113,-3,Regular Season
22018,1610612765,DET,Detroit Pistons,0021800750,2019-01-29T00:00:00Z,DET vs. MIL,105,-10,1610612749,MIL,Milwaukee Bucks,MIL @ DET,115,10,Regular Season
22018,1610612747,LAL,Los Angeles Lakers,0021800755,2019-01-29T00:00:00Z,LAL vs. PHI,105,-16,1610612755,PHI,Philadelphia 76ers,PHI @ LAL,121,16,Regular Season
22018,1610612753,ORL,Orlando Magic,0021800751,2019-01-29T00:00:00Z,ORL vs. OKC,117,-9,1610612760,OKC,Oklahoma City Thunder,OKC @ ORL,126,9,Regular Season
22018,1610612751,BKN,Brooklyn Nets,0021800752,2019-01-29T00:00:00Z,BKN vs. CHI,122,5,1610612741,CHI,Chicago Bulls,CHI @ BKN,117,-5,Regular Season
22018,1610612745,HOU,Houston Rockets,0021800753,2019-01-29T00:00:00Z,HOU vs. NOP,116,-5,1610612740,NOP,New Orleans Pelicans,NOP @ HOU,121,5,Regular Season
22018,1610612748,MIA,Miami Heat,0021800757,2019-01-30T00:00:00Z,MIA vs. CHI,89,-16,1610612741,CHI,Chicago Bulls,CHI @ MIA,105,16,Regular Season
22018,1610612740,NOP,New Orleans Pelicans,0021800761,2019-01-30T00:00:00Z,NOP vs. DEN,99,-6,1610612743,DEN,Denver Nuggets,DEN @ NOP,105,6,Regular Season
22018,1610612752,NYK,New York Knicks,0021800758,2019-01-30T00:00:00Z,NYK vs. DAL,90,-24,1610612742,DAL,Dallas Mavericks,DAL @ NYK,114,24,Regular Season
22018,1610612764,WAS,Washington Wizards,0021800759,2019-01-30T00:00:00Z,WAS vs. IND,107,18,1610612754,IND,Indiana Pacers,IND @ WAS,89,-18,Regular Season
22018,1610612738,BOS,Boston Celtics,0021800756,2019-01-30T00:00:00Z,BOS vs. CHA,126,32,1610612766,CHA,Charlotte Hornets,CHA @ BOS,94,-32,Regular Season
22018,1610612757,POR,Portland Trail Blazers,0021800763,2019-01-30T00:00:00Z,POR vs. UTA,132,27,1610612762,UTA,Utah Jazz,UTA @ POR,105,-27,Regular Season
22018,1610612758,SAC,Sacramento Kings,0021800762,2019-01-30T00:00:00Z,SAC vs. ATL,135,22,1610612737,ATL,Atlanta Hawks,ATL @ SAC,113,-22,Regular Season
22018,1610612750,MIN,Minnesota Timberwolves,0021800760,2019-01-30T00:00:00Z,MIN vs. MEM,99,2,1610612763,MEM,Memphis Grizzlies,MEM @ MIN,97,-2,Regular Season
22018,1610612753,ORL,Orlando Magic,0021800765,2019-01-31T00:00:00Z,ORL vs. IND,107,7,1610612754,IND,Indiana Pacers,IND @ ORL,100,-7,Regular Season
22018,1610612765,DET,Detroit Pistons,0021800764,2019-01-31T00:00:00Z,DET vs. DAL,93,4,1610612742,DAL,Dallas Mavericks,DAL @ DET,89,-4,Regular Season
22018,1610612744,GSW,Golden State Warriors,0021800768,2019-01-31T00:00:00Z,GSW vs. PHI,104,-9,1610612755,PHI,Philadelphia 76ers,PHI @ GSW,113,9,Regular Season
22018,1610612759,SAS,San Antonio Spurs,0021800767,2019-01-31T00:00:00Z,SAS vs. BKN,117,3,1610612751,BKN,Brooklyn Nets,BKN @ SAS,114,-3,Regular Season
22018,1610612761,TOR,Toronto Raptors,0021800766,2019-01-31T00:00:00Z,TOR vs. MIL,92,-13,1610612749,MIL,Milwaukee Bucks,MIL @ TOR,105,13,Regular Season
22018,1610612746,LAC,LA Clippers,0021800769,2019-01-31T00:00:00Z,LAC vs. LAL,120,-3,1610612747,LAL,Los Angeles Lakers,LAL @ LAC,123,3,Regular Season
22018,1610612743,DEN,Denver Nuggets,0021800774,2019-02-01T00:00:00Z,DEN vs. HOU,136,14,1610612745,HOU,Houston Rockets,HOU @ DEN,122,-14,Regular Season
22018,1610612748,MIA,Miami Heat,0021800772,2019-02-01T00:00:00Z,MIA vs. OKC,102,-16,1610612760,OKC,Oklahoma City Thunder,OKC @ MIA,118,16,Regular Season
22018,1610612752,NYK,New York Knicks,0021800771,2019-02-01T00:00:00Z,NYK vs. BOS,99,-14,1610612738,BOS,Boston Celtics,BOS @ NYK,113,14,Regular Season
22018,1610612766,CHA,Charlotte Hornets,0021800770,2019-02-01T00:00:00Z,CHA vs. MEM,100,8,1610612763,MEM,Memphis Grizzlies,MEM @ CHA,92,-8,Regular Season
22018,1610612762,UTA,Utah Jazz,0021800773,2019-02-01T00:00:00Z,UTA vs. ATL,128,16,1610612737,ATL,Atlanta Hawks,ATL @ UTA,112,-16,Regular Season
22018,1610612766,CHA,Charlotte Hornets,0021800776,2019-02-02T00:00:00Z,CHA vs. CHI,125,7,1610612741,CHI,Chicago Bulls,CHI @ CHA,118,-7,Regular Season
22018,1610612758,SAC,Sacramento Kings,0021800785,2019-02-02T00:00:00Z,SAC vs. PHI,115,7,1610612755,PHI,Philadelphia 76ers,PHI @ SAC,108,-7,Regular Season
22018,1610612759,SAS,San Antonio Spurs,0021800779,2019-02-02T00:00:00Z,SAS vs. NOP,113,5,1610612740,NOP,New Orleans Pelicans,NOP @ SAS,108,-5,Regular Season
22018,1610612764,WAS,Washington Wizards,0021800778,2019-02-02T00:00:00Z,WAS vs. MIL,115,-16,1610612749,MIL,Milwaukee Bucks,MIL @ WAS,131,16,Regular Season
22018,1610612753,ORL,Orlando Magic,0021800777,2019-02-02T00:00:00Z,ORL vs. BKN,102,13,1610612751,BKN,Brooklyn Nets,BKN @ ORL,89,-13,Regular Season
22018,1610612739,CLE,Cleveland Cavaliers,0021800780,2019-02-02T00:00:00Z,CLE vs. DAL,98,-13,1610612742,DAL,Dallas Mavericks,DAL @ CLE,111,13,Regular Season
22018,1610612744,GSW,Golden State Warriors,0021800782,2019-02-02T00:00:00Z,GSW vs. LAL,115,14,1610612747,LAL,Los Angeles Lakers,LAL @ GSW,101,-14,Regular Season
22018,1610612748,MIA,Miami Heat,0021800781,2019-02-02T00:00:00Z,MIA vs. IND,88,-7,1610612754,IND,Indiana Pacers,IND @ MIA,95,7,Regular Season
22018,1610612750,MIN,Minnesota Timberwolves,0021800783,2019-02-02T00:00:00Z,MIN vs. DEN,106,-1,1610612743,DEN,Denver Nuggets,DEN @ MIN,107,1,Regular Season
22018,1610612756,PHX,Phoenix Suns,0021800784,2019-02-02T00:00:00Z,PHX vs. ATL,112,-6,1610612737,ATL,Atlanta Hawks,ATL @ PHX,118,6,Regular Season
22018,1610612762,UTA,Utah Jazz,0021800786,2019-02-02T00:00:00Z,UTA vs. HOU,98,-27,1610612745,HOU,Houston Rockets,HOU @ UTA,125,27,Regular Season
22018,1610612765,DET,Detroit Pistons,0021800775,2019-02-02T00:00:00Z,DET vs. LAC,101,-10,1610612746,LAC,LA Clippers,LAC @ DET,111,10,Regular Season
22018,1610612738,BOS,Boston Celtics,0021800788,2019-02-03T00:00:00Z,BOS vs. OKC,134,5,1610612760,OKC,Oklahoma City Thunder,OKC @ BOS,129,-5,Regular Season
22018,1610612752,NYK,New York Knicks,0021800787,2019-02-03T00:00:00Z,NYK vs. MEM,84,-12,1610612763,MEM,Memphis Grizzlies,MEM @ NYK,96,12,Regular Season
22018,1610612761,TOR,Toronto Raptors,0021800789,2019-02-03T00:00:00Z,TOR vs. LAC,121,18,1610612746,LAC,LA Clippers,LAC @ TOR,103,-18,Regular Season
22018,1610612758,SAC,Sacramento Kings,0021800795,2019-02-04T00:00:00Z,SAC vs. SAS,127,15,1610612759,SAS,San Antonio Spurs,SAS @ SAC,112,-15,Regular Season
22018,1610612751,BKN,Brooklyn Nets,0021800792,2019-02-04T00:00:00Z,BKN vs. MIL,94,-19,1610612749,MIL,Milwaukee Bucks,MIL @ BKN,113,19,Regular Season
22018,1610612764,WAS,Washington Wizards,0021800791,2019-02-04T00:00:00Z,WAS vs. ATL,129,-8,1610612737,ATL,Atlanta Hawks,ATL @ WAS,137,8,Regular Season
22018,1610612765,DET,Detroit Pistons,0021800790,2019-02-04T00:00:00Z,DET vs. DEN,129,26,1610612743,DEN,Denver Nuggets,DEN @ DET,103,-26,Regular Season
22018,1610612740,NOP,New Orleans Pelicans,0021800793,2019-02-04T00:00:00Z,NOP vs. IND,107,-2,1610612754,IND,Indiana Pacers,IND @ NOP,109,2,Regular Season
22018,1610612756,PHX,Phoenix Suns,0021800794,2019-02-04T00:00:00Z,PHX vs. HOU,110,-8,1610612745,HOU,Houston Rockets,HOU @ PHX,118,8,Regular Season
22018,1610612739,CLE,Cleveland Cavaliers,0021800797,2019-02-05T00:00:00Z,CLE vs. BOS,96,-7,1610612738,BOS,Boston Celtics,BOS @ CLE,103,7,Regular Season
22018,1610612752,NYK,New York Knicks,0021800799,2019-02-05T00:00:00Z,NYK vs. DET,92,-13,1610612765,DET,Detroit Pistons,DET @ NYK,105,13,Regular Season
22018,1610612766,CHA,Charlotte Hornets,0021800796,2019-02-05T00:00:00Z,CHA vs. LAC,115,-2,1610612746,LAC,LA Clippers,LAC @ CHA,117,2,Regular Season
22018,1610612763,MEM,Memphis Grizzlies,0021800801,2019-02-05T00:00:00Z,MEM vs. MIN,108,2,1610612750,MIN,Minnesota Timberwolves,MIN @ MEM,106,-2,Regular Season
22018,1610612760,OKC,Oklahoma City Thunder,0021800802,2019-02-05T00:00:00Z,OKC vs. ORL,132,10,1610612753,ORL,Orlando Magic,ORL @ OKC,122,-10,Regular Season
22018,1610612754,IND,Indiana Pacers,0021800798,2019-02-05T00:00:00Z,IND vs. LAL,136,42,1610612747,LAL,Los Angeles Lakers,LAL @ IND,94,-42,Regular Season
22018,1610612755,PHI,Philadelphia 76ers,0021800800,2019-02-05T00:00:00Z,PHI vs. TOR,107,-12,1610612761,TOR,Toronto Raptors,TOR @ PHI,119,12,Regular Season
22018,1610612757,POR,Portland Trail Blazers,0021800803,2019-02-05T00:00:00Z,POR vs. MIA,108,-10,1610612748,MIA,Miami Heat,MIA @ POR,118,10,Regular Season
22018,1610612742,DAL,Dallas Mavericks,0021800807,2019-02-06T00:00:00Z,DAL vs. CHA,99,6,1610612766,CHA,Charlotte Hornets,CHA @ DAL,93,-6,Regular Season
22018,1610612741,CHI,Chicago Bulls,0021800805,2019-02-06T00:00:00Z,CHI vs. NOP,120,-5,1610612740,NOP,New Orleans Pelicans,NOP @ CHI,125,5,Regular Season
22018,1610612751,BKN,Brooklyn Nets,0021800804,2019-02-06T00:00:00Z,BKN vs. DEN,135,5,1610612743,DEN,Denver Nuggets,DEN @ BKN,130,-5,Regular Season
22018,1610612758,SAC,Sacramento Kings,0021800809,2019-02-06T00:00:00Z,SAC vs. HOU,101,-26,1610612745,HOU,Houston Rockets,HOU @ SAC,127,26,Regular Season
22018,1610612762,UTA,Utah Jazz,0021800808,2019-02-06T00:00:00Z,UTA vs. PHX,116,28,1610612756,PHX,Phoenix Suns,PHX @ UTA,88,-28,Regular Season
22018,1610612744,GSW,Golden State Warriors,0021800810,2019-02-06T00:00:00Z,GSW vs. SAS,141,39,1610612759,SAS,San Antonio Spurs,SAS @ GSW,102,-39,Regular Season
22018,1610612749,MIL,Milwaukee Bucks,0021800806,2019-02-06T00:00:00Z,MIL vs. WAS,148,19,1610612764,WAS,Washington Wizards,WAS @ MIL,129,-19,Regular Season
22018,1610612760,OKC,Oklahoma City Thunder,0021800815,2019-02-07T00:00:00Z,OKC vs. MEM,117,22,1610612763,MEM,Memphis Grizzlies,MEM @ OKC,95,-22,Regular Season
22018,1610612757,POR,Portland Trail Blazers,0021800816,2019-02-07T00:00:00Z,POR vs. SAS,127,9,1610612759,SAS,San Antonio Spurs,SAS @ POR,118,-9,Regular Season
22018,1610612738,BOS,Boston Celtics,0021800814,2019-02-07T00:00:00Z,BOS vs. LAL,128,-1,1610612747,LAL,Los Angeles Lakers,LAL @ BOS,129,1,Regular Season
22018,1610612754,IND,Indiana Pacers,0021800811,2019-02-07T00:00:00Z,IND vs. LAC,116,24,1610612746,LAC,LA Clippers,LAC @ IND,92,-24,Regular Season
22018,1610612753,ORL,Orlando Magic,0021800812,2019-02-07T00:00:00Z,ORL vs. MIN,122,10,1610612750,MIN,Minnesota Timberwolves,MIN @ ORL,112,-10,Regular Season
22018,1610612737,ATL,Atlanta Hawks,0021800813,2019-02-07T00:00:00Z,ATL vs. TOR,101,-18,1610612761,TOR,Toronto Raptors,TOR @ ATL,119,18,Regular Season
22018,1610612756,PHX,Phoenix Suns,0021800822,2019-02-08T00:00:00Z,PHX vs. GSW,107,-10,1610612744,GSW,Golden State Warriors,GSW @ PHX,117,10,Regular Season
22018,1610612740,NOP,New Orleans Pelicans,0021800823,2019-02-08T00:00:00Z,NOP vs. MIN,122,5,1610612750,MIN,Minnesota Timberwolves,MIN @ NOP,117,-5,Regular Season
22018,1610612755,PHI,Philadelphia 76ers,0021800818,2019-02-08T00:00:00Z,PHI vs. DEN,117,7,1610612743,DEN,Denver Nuggets,DEN @ PHI,110,-7,Regular Season
22018,1610612765,DET,Detroit Pistons,0021800817,2019-02-08T00:00:00Z,DET vs. NYK,120,17,1610612752,NYK,New York Knicks,NYK @ DET,103,-17,Regular Season
22018,1610612764,WAS,Washington Wizards,0021800819,2019-02-08T00:00:00Z,WAS vs. CLE,119,13,1610612739,CLE,Cleveland Cavaliers,CLE @ WAS,106,-13,Regular Season
22018,1610612758,SAC,Sacramento Kings,0021800824,2019-02-08T00:00:00Z,SAC vs. MIA,102,6,1610612748,MIA,Miami Heat,MIA @ SAC,96,-6,Regular Season
22018,1610612742,DAL,Dallas Mavericks,0021800821,2019-02-08T00:00:00Z,DAL vs. MIL,107,-15,1610612749,MIL,Milwaukee Bucks,MIL @ DAL,122,15,Regular Season
22018,1610612751,BKN,Brooklyn Nets,0021800820,2019-02-08T00:00:00Z,BKN vs. CHI,106,-19,1610612741,CHI,Chicago Bulls,CHI @ BKN,125,19,Regular Season
22018,1610612738,BOS,Boston Celtics,0021800829,2019-02-09T00:00:00Z,BOS vs. LAC,112,-11,1610612746,LAC,LA Clippers,LAC @ BOS,123,11,Regular Season
22018,1610612763,MEM,Memphis Grizzlies,0021800831,2019-02-09T00:00:00Z,MEM vs. NOP,99,9,1610612740,NOP,New Orleans Pelicans,NOP @ MEM,90,-9,Regular Season
22018,1610612745,HOU,Houston Rockets,0021800832,2019-02-09T00:00:00Z,HOU vs. OKC,112,-5,1610612760,OKC,Oklahoma City Thunder,OKC @ HOU,117,5,Regular Season
22018,1610612741,CHI,Chicago Bulls,0021800830,2019-02-09T00:00:00Z,CHI vs. WAS,125,-9,1610612764,WAS,Washington Wizards,WAS @ CHI,134,9,Regular Season
22018,1610612752,NYK,New York Knicks,0021800828,2019-02-09T00:00:00Z,NYK vs. TOR,99,-5,1610612761,TOR,Toronto Raptors,TOR @ NYK,104,5,Regular Season
22018,1610612762,UTA,Utah Jazz,0021800825,2019-02-09T00:00:00Z,UTA vs. SAS,125,20,1610612759,SAS,San Antonio Spurs,SAS @ UTA,105,-20,Regular Season
22018,1610612754,IND,Indiana Pacers,0021800826,2019-02-09T00:00:00Z,IND vs. CLE,105,15,1610612739,CLE,Cleveland Cavaliers,CLE @ IND,90,-15,Regular Season
22018,1610612737,ATL,Atlanta Hawks,0021800827,2019-02-09T00:00:00Z,ATL vs. CHA,120,-9,1610612766,CHA,Charlotte Hornets,CHA @ ATL,129,9,Regular Season
22018,1610612749,MIL,Milwaukee Bucks,0021800833,2019-02-09T00:00:00Z,MIL vs. ORL,83,-20,1610612753,ORL,Orlando Magic,ORL @ MIL,103,20,Regular Season
22018,1610612755,PHI,Philadelphia 76ers,0021800835,2019-02-10T00:00:00Z,PHI vs. LAL,143,23,1610612747,LAL,Los Angeles Lakers,LAL @ PHI,120,-23,Regular Season
22018,1610612737,ATL,Atlanta Hawks,0021800837,2019-02-10T00:00:00Z,ATL vs. ORL,108,-16,1610612753,ORL,Orlando Magic,ORL @ ATL,124,16,Regular Season
22018,1610612744,GSW,Golden State Warriors,0021800838,2019-02-10T00:00:00Z,GSW vs. MIA,120,2,1610612748,MIA,Miami Heat,MIA @ GSW,118,-2,Regular Season
22018,1610612742,DAL,Dallas Mavericks,0021800834,2019-02-10T00:00:00Z,DAL vs. POR,102,1,1610612757,POR,Portland Trail Blazers,POR @ DAL,101,-1,Regular Season
22018,1610612758,SAC,Sacramento Kings,0021800836,2019-02-10T00:00:00Z,SAC vs. PHX,117,13,1610612756,PHX,Phoenix Suns,PHX @ SAC,104,-13,Regular Season
22018,1610612741,CHI,Chicago Bulls,0021800843,2019-02-11T00:00:00Z,CHI vs. MIL,99,-13,1610612749,MIL,Milwaukee Bucks,MIL @ CHI,112,13,Regular Season
22018,1610612739,CLE,Cleveland Cavaliers,0021800839,2019-02-11T00:00:00Z,CLE vs. NYK,107,3,1610612752,NYK,New York Knicks,NYK @ CLE,104,-3,Regular Season
22018,1610612745,HOU,Houston Rockets,0021800844,2019-02-11T00:00:00Z,HOU vs. DAL,120,16,1610612742,DAL,Dallas Mavericks,DAL @ HOU,104,-16,Regular Season
22018,1610612750,MIN,Minnesota Timberwolves,0021800845,2019-02-11T00:00:00Z,MIN vs. LAC,130,10,1610612746,LAC,LA Clippers,LAC @ MIN,120,-10,Regular Season
22018,1610612743,DEN,Denver Nuggets,0021800847,2019-02-11T00:00:00Z,DEN vs. MIA,103,16,1610612748,MIA,Miami Heat,MIA @ DEN,87,-16,Regular Season
22018,1610612765,DET,Detroit Pistons,0021800840,2019-02-11T00:00:00Z,DET vs. WAS,121,9,1610612764,WAS,Washington Wizards,WAS @ DET,112,-9,Regular Season
22018,1610612761,TOR,Toronto Raptors,0021800842,2019-02-11T00:00:00Z,TOR vs. BKN,127,2,1610612751,BKN,Brooklyn Nets,BKN @ TOR,125,-2,Regular Season
22018,1610612754,IND,Indiana Pacers,0021800841,2019-02-11T00:00:00Z,IND vs. CHA,99,9,1610612766,CHA,Charlotte Hornets,CHA @ IND,90,-9,Regular Season
22018,1610612760,OKC,Oklahoma City Thunder,0021800846,2019-02-11T00:00:00Z,OKC vs. POR,120,9,1610612757,POR,Portland Trail Blazers,POR @ OKC,111,-9,Regular Season
22018,1610612755,PHI,Philadelphia 76ers,0021800849,2019-02-12T00:00:00Z,PHI vs. BOS,109,-3,1610612738,BOS,Boston Celtics,BOS @ PHI,112,3,Regular Season
22018,1610612744,GSW,Golden State Warriors,0021800852,2019-02-12T00:00:00Z,GSW vs. UTA,115,7,1610612762,UTA,Utah Jazz,UTA @ GSW,108,-7,Regular Season
22018,1610612740,NOP,New Orleans Pelicans,0021800851,2019-02-12T00:00:00Z,NOP vs. ORL,88,-30,1610612753,ORL,Orlando Magic,ORL @ NOP,118,30,Regular Season
22018,1610612737,ATL,Atlanta Hawks,0021800848,2019-02-12T00:00:00Z,ATL vs. LAL,117,4,1610612747,LAL,Los Angeles Lakers,LAL @ ATL,113,-4,Regular Season
22018,1610612763,MEM,Memphis Grizzlies,0021800850,2019-02-12T00:00:00Z,MEM vs. SAS,107,-1,1610612759,SAS,San Antonio Spurs,SAS @ MEM,108,1,Regular Season
22018,1610612750,MIN,Minnesota Timberwolves,0021800861,2019-02-13T00:00:00Z,MIN vs. HOU,121,10,1610612745,HOU,Houston Rockets,HOU @ MIN,111,-10,Regular Season
22018,1610612754,IND,Indiana Pacers,0021800854,2019-02-13T00:00:00Z,IND vs. MIL,97,-9,1610612749,MIL,Milwaukee Bucks,MIL @ IND,106,9,Regular Season
22018,1610612739,CLE,Cleveland Cavaliers,0021800853,2019-02-13T00:00:00Z,CLE vs. BKN,139,-9,1610612751,BKN,Brooklyn Nets,BKN @ CLE,148,9,Regular Season
22018,1610612741,CHI,Chicago Bulls,0021800858,2019-02-13T00:00:00Z,CHI vs. MEM,122,12,1610612763,MEM,Memphis Grizzlies,MEM @ CHI,110,-12,Regular Season
22018,1610612743,DEN,Denver Nuggets,0021800860,2019-02-13T00:00:00Z,DEN vs. SAC,120,2,1610612758,SAC,Sacramento Kings,SAC @ DEN,118,-2,Regular Season
22018,1610612742,DAL,Dallas Mavericks,0021800859,2019-02-13T00:00:00Z,DAL vs. MIA,101,-11,1610612748,MIA,Miami Heat,MIA @ DAL,112,11,Regular Season
22018,1610612757,POR,Portland Trail Blazers,0021800862,2019-02-13T00:00:00Z,POR vs. GSW,129,22,1610612744,GSW,Golden State Warriors,GSW @ POR,107,-22,Regular Season
22018,1610612738,BOS,Boston Celtics,0021800855,2019-02-13T00:00:00Z,BOS vs. DET,118,8,1610612765,DET,Detroit Pistons,DET @ BOS,110,-8,Regular Season
22018,1610612752,NYK,New York Knicks,0021800856,2019-02-13T00:00:00Z,NYK vs. PHI,111,-15,1610612755,PHI,Philadelphia 76ers,PHI @ NYK,126,15,Regular Season
22018,1610612761,TOR,Toronto Raptors,0021800857,2019-02-13T00:00:00Z,TOR vs. WAS,129,9,1610612764,WAS,Washington Wizards,WAS @ TOR,120,-9,Regular Season
22018,1610612746,LAC,LA Clippers,0021800863,2019-02-13T00:00:00Z,LAC vs. PHX,134,27,1610612756,PHX,Phoenix Suns,PHX @ LAC,107,-27,Regular Season
22018,1610612740,NOP,New Orleans Pelicans,0021800866,2019-02-14T00:00:00Z,NOP vs. OKC,131,9,1610612760,OKC,Oklahoma City Thunder,OKC @ NOP,122,-9,Regular Season
22018,1610612753,ORL,Orlando Magic,0021800864,2019-02-14T00:00:00Z,ORL vs. CHA,127,38,1610612766,CHA,Charlotte Hornets,CHA @ ORL,89,-38,Regular Season
22018,1610612737,ATL,Atlanta Hawks,0021800865,2019-02-14T00:00:00Z,ATL vs. NYK,91,-15,1610612752,NYK,New York Knicks,NYK @ ATL,106,15,Regular Season
22018,1610612751,BKN,Brooklyn Nets,0021800869,2019-02-21T00:00:00Z,BKN vs. POR,99,-14,1610612757,POR,Portland Trail Blazers,POR @ BKN,113,14,Regular Season
22018,1610612739,CLE,Cleveland Cavaliers,0021800867,2019-02-21T00:00:00Z,CLE vs. PHX,111,13,1610612756,PHX,Phoenix Suns,PHX @ CLE,98,-13,Regular Season
22018,1610612744,GSW,Golden State Warriors,0021800871,2019-02-21T00:00:00Z,GSW vs. SAC,125,2,1610612758,SAC,Sacramento Kings,SAC @ GSW,123,-2,Regular Season
22018,1610612747,LAL,Los Angeles Lakers,0021800872,2019-02-21T00:00:00Z,LAL vs. HOU,111,5,1610612745,HOU,Houston Rockets,HOU @ LAL,106,-5,Regular Season
22018,1610612749,MIL,Milwaukee Bucks,0021800870,2019-02-21T00:00:00Z,MIL vs. BOS,98,1,1610612738,BOS,Boston Celtics,BOS @ MIL,97,-1,Regular Season
22018,1610612755,PHI,Philadelphia 76ers,0021800868,2019-02-21T00:00:00Z,PHI vs. MIA,106,4,1610612748,MIA,Miami Heat,MIA @ PHI,102,-4,Regular Season
22018,1610612763,MEM,Memphis Grizzlies,0021800879,2019-02-22T00:00:00Z,MEM vs. LAC,106,-6,1610612746,LAC,LA Clippers,LAC @ MEM,112,6,Regular Season
22018,1610612753,ORL,Orlando Magic,0021800875,2019-02-22T00:00:00Z,ORL vs. CHI,109,-1,1610612741,CHI,Chicago Bulls,CHI @ ORL,110,1,Regular Season
22018,1610612742,DAL,Dallas Mavericks,0021800880,2019-02-22T00:00:00Z,DAL vs. DEN,104,-10,1610612743,DEN,Denver Nuggets,DEN @ DAL,114,10,Regular Season
22018,1610612752,NYK,New York Knicks,0021800878,2019-02-22T00:00:00Z,NYK vs. MIN,104,-11,1610612750,MIN,Minnesota Timberwolves,MIN @ NYK,115,11,Regular Season
22018,1610612766,CHA,Charlotte Hornets,0021800873,2019-02-22T00:00:00Z,CHA vs. WAS,123,13,1610612764,WAS,Washington Wizards,WAS @ CHA,110,-13,Regular Season
22018,1610612737,ATL,Atlanta Hawks,0021800877,2019-02-22T00:00:00Z,ATL vs. DET,122,-3,1610612765,DET,Detroit Pistons,DET @ ATL,125,3,Regular Season
22018,1610612760,OKC,Oklahoma City Thunder,0021800881,2019-02-22T00:00:00Z,OKC vs. UTA,148,1,1610612762,UTA,Utah Jazz,UTA @ OKC,147,-1,Regular Season
22018,1610612754,IND,Indiana Pacers,0021800874,2019-02-22T00:00:00Z,IND vs. NOP,126,15,1610612740,NOP,New Orleans Pelicans,NOP @ IND,111,-15,Regular Season
22018,1610612761,TOR,Toronto Raptors,0021800876,2019-02-22T00:00:00Z,TOR vs. SAS,120,3,1610612759,SAS,San Antonio Spurs,SAS @ TOR,117,-3,Regular Season
22018,1610612740,NOP,New Orleans Pelicans,0021800887,2019-02-23T00:00:00Z,NOP vs. LAL,128,13,1610612747,LAL,Los Angeles Lakers,LAL @ NOP,115,-13,Regular Season
22018,1610612749,MIL,Milwaukee Bucks,0021800891,2019-02-23T00:00:00Z,MIL vs. MIN,140,12,1610612750,MIN,Minnesota Timberwolves,MIN @ MIL,128,-12,Regular Season
22018,1610612760,OKC,Oklahoma City Thunder,0021800890,2019-02-23T00:00:00Z,OKC vs. SAC,116,-3,1610612758,SAC,Sacramento Kings,SAC @ OKC,119,3,Regular Season
22018,1610612739,CLE,Cleveland Cavaliers,0021800885,2019-02-23T00:00:00Z,CLE vs. MEM,112,5,1610612763,MEM,Memphis Grizzlies,MEM @ CLE,107,-5,Regular Season
22018,1610612764,WAS,Washington Wizards,0021800886,2019-02-23T00:00:00Z,WAS vs. IND,112,-7,1610612754,IND,Indiana Pacers,IND @ WAS,119,7,Regular Season
22018,1610612766,CHA,Charlotte Hornets,0021800884,2019-02-23T00:00:00Z,CHA vs. BKN,115,-2,1610612751,BKN,Brooklyn Nets,BKN @ CHA,117,2,Regular Season
22018,1610612737,ATL,Atlanta Hawks,0021800883,2019-02-23T00:00:00Z,ATL vs. PHX,120,8,1610612756,PHX,Phoenix Suns,PHX @ ATL,112,-8,Regular Season
22018,1610612744,GSW,Golden State Warriors,0021800892,2019-02-23T00:00:00Z,GSW vs. HOU,112,-6,1610612745,HOU,Houston Rockets,HOU @ GSW,118,6,Regular Season
22018,1610612748,MIA,Miami Heat,0021800888,2019-02-23T00:00:00Z,MIA vs. DET,96,-23,1610612765,DET,Detroit Pistons,DET @ MIA,119,23,Regular Season
22018,1610612741,CHI,Chicago Bulls,0021800889,2019-02-23T00:00:00Z,CHI vs. BOS,126,10,1610612738,BOS,Boston Celtics,BOS @ CHI,116,-10,Regular Season
22018,1610612762,UTA,Utah Jazz,0021800893,2019-02-23T00:00:00Z,UTA vs. DAL,125,16,1610612742,DAL,Dallas Mavericks,DAL @ UTA,109,-16,Regular Season
22018,1610612755,PHI,Philadelphia 76ers,0021800882,2019-02-23T00:00:00Z,PHI vs. POR,115,-15,1610612757,POR,Portland Trail Blazers,POR @ PHI,130,15,Regular Season
22018,1610612743,DEN,Denver Nuggets,0021800895,2019-02-24T00:00:00Z,DEN vs. LAC,123,27,1610612746,LAC,LA Clippers,LAC @ DEN,96,-27,Regular Season
22018,1610612752,NYK,New York Knicks,0021800896,2019-02-24T00:00:00Z,NYK vs. SAS,130,12,1610612759,SAS,San Antonio Spurs,SAS @ NYK,118,-12,Regular Season
22018,1610612761,TOR,Toronto Raptors,0021800894,2019-02-24T00:00:00Z,TOR vs. ORL,98,-15,1610612753,ORL,Orlando Magic,ORL @ TOR,113,15,Regular Season
22018,1610612748,MIA,Miami Heat,0021800901,2019-02-25T00:00:00Z,MIA vs. PHX,121,-3,1610612756,PHX,Phoenix Suns,PHX @ MIA,124,3,Regular Season
22018,1610612739,CLE,Cleveland Cavaliers,0021800898,2019-02-25T00:00:00Z,CLE vs. POR,110,-13,1610612757,POR,Portland Trail Blazers,POR @ CLE,123,13,Regular Season
22018,1610612765,DET,Detroit Pistons,0021800899,2019-02-25T00:00:00Z,DET vs. IND,113,4,1610612754,IND,Indiana Pacers,IND @ DET,109,-4,Regular Season
22018,1610612750,MIN,Minnesota Timberwolves,0021800905,2019-02-25T00:00:00Z,MIN vs. SAC,112,7,1610612758,SAC,Sacramento Kings,SAC @ MIN,105,-7,Regular Season
22018,1610612746,LAC,LA Clippers,0021800907,2019-02-25T00:00:00Z,LAC vs. DAL,121,9,1610612742,DAL,Dallas Mavericks,DAL @ LAC,112,-9,Regular Season
22018,1610612751,BKN,Brooklyn Nets,0021800900,2019-02-25T00:00:00Z,BKN vs. SAS,101,16,1610612759,SAS,San Antonio Spurs,SAS @ BKN,85,-16,Regular Season
22018,1610612766,CHA,Charlotte Hornets,0021800897,2019-02-25T00:00:00Z,CHA vs. GSW,110,-11,1610612744,GSW,Golden State Warriors,GSW @ CHA,121,11,Regular Season
22018,1610612763,MEM,Memphis Grizzlies,0021800904,2019-02-25T00:00:00Z,MEM vs. LAL,110,5,1610612747,LAL,Los Angeles Lakers,LAL @ MEM,105,-5,Regular Season
22018,1610612745,HOU,Houston Rockets,0021800903,2019-02-25T00:00:00Z,HOU vs. ATL,119,8,1610612737,ATL,Atlanta Hawks,ATL @ HOU,111,-8,Regular Season
22018,1610612740,NOP,New Orleans Pelicans,0021800906,2019-02-25T00:00:00Z,NOP vs. PHI,110,-1,1610612755,PHI,Philadelphia 76ers,PHI @ NOP,111,1,Regular Season
22018,1610612741,CHI,Chicago Bulls,0021800902,2019-02-25T00:00:00Z,CHI vs. MIL,106,-11,1610612749,MIL,Milwaukee Bucks,MIL @ CHI,117,11,Regular Season
22018,1610612743,DEN,Denver Nuggets,0021800910,2019-02-26T00:00:00Z,DEN vs. OKC,121,9,1610612760,OKC,Oklahoma City Thunder,OKC @ DEN,112,-9,Regular Season
22018,1610612761,TOR,Toronto Raptors,0021800909,2019-02-26T00:00:00Z,TOR vs. BOS,118,23,1610612738,BOS,Boston Celtics,BOS @ TOR,95,-23,Regular Season
22018,1610612752,NYK,New York Knicks,0021800908,2019-02-26T00:00:00Z,NYK vs. ORL,108,5,1610612753,ORL,Orlando Magic,ORL @ NYK,103,-5,Regular Season
22018,1610612747,LAL,Los Angeles Lakers,0021800921,2019-02-27T00:00:00Z,LAL vs. NOP,125,6,1610612740,NOP,New Orleans Pelicans,NOP @ LAL,119,-6,Regular Season
22018,1610612763,MEM,Memphis Grizzlies,0021800916,2019-02-27T00:00:00Z,MEM vs. CHI,107,-2,1610612741,CHI,Chicago Bulls,CHI @ MEM,109,2,Regular Season
22018,1610612758,SAC,Sacramento Kings,0021800920,2019-02-27T00:00:00Z,SAC vs. MIL,140,-1,1610612749,MIL,Milwaukee Bucks,MIL @ SAC,141,1,Regular Season
22018,1610612759,SAS,San Antonio Spurs,0021800917,2019-02-27T00:00:00Z,SAS vs. DET,105,12,1610612765,DET,Detroit Pistons,DET @ SAS,93,-12,Regular Season
22018,1610612762,UTA,Utah Jazz,0021800919,2019-02-27T00:00:00Z,UTA vs. LAC,111,6,1610612746,LAC,LA Clippers,LAC @ UTA,105,-6,Regular Season
22018,1610612742,DAL,Dallas Mavericks,0021800918,2019-02-27T00:00:00Z,DAL vs. IND,110,9,1610612754,IND,Indiana Pacers,IND @ DAL,101,-9,Regular Season
22018,1610612748,MIA,Miami Heat,0021800915,2019-02-27T00:00:00Z,MIA vs. GSW,126,1,1610612744,GSW,Golden State Warriors,GSW @ MIA,125,-1,Regular Season
22018,1610612766,CHA,Charlotte Hornets,0021800911,2019-02-27T00:00:00Z,CHA vs. HOU,113,-5,1610612745,HOU,Houston Rockets,HOU @ CHA,118,5,Regular Season
22018,1610612738,BOS,Boston Celtics,0021800913,2019-02-27T00:00:00Z,BOS vs. POR,92,-5,1610612757,POR,Portland Trail Blazers,POR @ BOS,97,5,Regular Season
22018,1610612737,ATL,Atlanta Hawks,0021800912,2019-02-27T00:00:00Z,ATL vs. MIN,131,8,1610612750,MIN,Minnesota Timberwolves,MIN @ ATL,123,-8,Regular Season
22018,1610612751,BKN,Brooklyn Nets,0021800914,2019-02-27T00:00:00Z,BKN vs. WAS,116,-9,1610612764,WAS,Washington Wizards,WAS @ BKN,125,9,Regular Season
22018,1610612760,OKC,Oklahoma City Thunder,0021800927,2019-02-28T00:00:00Z,OKC vs. PHI,104,-4,1610612755,PHI,Philadelphia 76ers,PHI @ OKC,108,4,Regular Season
22018,1610612752,NYK,New York Knicks,0021800924,2019-02-28T00:00:00Z,NYK vs. CLE,118,-7,1610612739,CLE,Cleveland Cavaliers,CLE @ NYK,125,7,Regular Season
22018,1610612745,HOU,Houston Rockets,0021800925,2019-02-28T00:00:00Z,HOU vs. MIA,121,3,1610612748,MIA,Miami Heat,MIA @ HOU,118,-3,Regular Season
22018,1610612743,DEN,Denver Nuggets,0021800926,2019-02-28T00:00:00Z,DEN vs. UTA,104,-7,1610612762,UTA,Utah Jazz,UTA @ DEN,111,7,Regular Season
22018,1610612753,ORL,Orlando Magic,0021800923,2019-02-28T00:00:00Z,ORL vs. GSW,103,7,1610612744,GSW,Golden State Warriors,GSW @ ORL,96,-7,Regular Season
22018,1610612754,IND,Indiana Pacers,0021800922,2019-02-28T00:00:00Z,IND vs. MIN,122,7,1610612750,MIN,Minnesota Timberwolves,MIN @ IND,115,-7,Regular Season
22018,1610612758,SAC,Sacramento Kings,0021800933,2019-03-01T00:00:00Z,SAC vs. LAC,109,-7,1610612746,LAC,LA Clippers,LAC @ SAC,116,7,Regular Season
22018,1610612761,TOR,Toronto Raptors,0021800930,2019-03-01T00:00:00Z,TOR vs. POR,119,2,1610612757,POR,Portland Trail Blazers,POR @ TOR,117,-2,Regular Season
22018,1610612738,BOS,Boston Celtics,0021800931,2019-03-01T00:00:00Z,BOS vs. WAS,107,11,1610612764,WAS,Washington Wizards,WAS @ BOS,96,-11,Regular Season
22018,1610612737,ATL,Atlanta Hawks,0021800928,2019-03-01T00:00:00Z,ATL vs. CHI,161,-7,1610612741,CHI,Chicago Bulls,CHI @ ATL,168,7,Regular Season
22018,1610612751,BKN,Brooklyn Nets,0021800929,2019-03-01T00:00:00Z,BKN vs. CHA,112,-11,1610612766,CHA,Charlotte Hornets,CHA @ BKN,123,11,Regular Season
22018,1610612747,LAL,Los Angeles Lakers,0021800934,2019-03-01T00:00:00Z,LAL vs. MIL,120,-11,1610612749,MIL,Milwaukee Bucks,MIL @ LAL,131,11,Regular Season
22018,1610612756,PHX,Phoenix Suns,0021800932,2019-03-01T00:00:00Z,PHX vs. NOP,116,-14,1610612740,NOP,New Orleans Pelicans,NOP @ PHX,130,14,Regular Season
22018,1610612743,DEN,Denver Nuggets,0021800941,2019-03-02T00:00:00Z,DEN vs. NOP,112,-8,1610612740,NOP,New Orleans Pelicans,NOP @ DEN,120,8,Regular Season
22018,1610612748,MIA,Miami Heat,0021800937,2019-03-02T00:00:00Z,MIA vs. BKN,117,29,1610612751,BKN,Brooklyn Nets,BKN @ MIA,88,-29,Regular Season
22018,1610612739,CLE,Cleveland Cavaliers,0021800935,2019-03-02T00:00:00Z,CLE vs. DET,93,-36,1610612765,DET,Detroit Pistons,DET @ CLE,129,36,Regular Season
22018,1610612755,PHI,Philadelphia 76ers,0021800938,2019-03-02T00:00:00Z,PHI vs. GSW,117,-3,1610612744,GSW,Golden State Warriors,GSW @ PHI,120,3,Regular Season
22018,1610612762,UTA,Utah Jazz,0021800943,2019-03-02T00:00:00Z,UTA vs. MIL,115,4,1610612749,MIL,Milwaukee Bucks,MIL @ UTA,111,-4,Regular Season
22018,1610612754,IND,Indiana Pacers,0021800936,2019-03-02T00:00:00Z,IND vs. ORL,112,-5,1610612753,ORL,Orlando Magic,ORL @ IND,117,5,Regular Season
22018,1610612742,DAL,Dallas Mavericks,0021800939,2019-03-02T00:00:00Z,DAL vs. MEM,81,-30,1610612763,MEM,Memphis Grizzlies,MEM @ DAL,111,30,Regular Season
22018,1610612759,SAS,San Antonio Spurs,0021800940,2019-03-02T00:00:00Z,SAS vs. OKC,116,14,1610612760,OKC,Oklahoma City Thunder,OKC @ SAS,102,-14,Regular Season
22018,1610612756,PHX,Phoenix Suns,0021800942,2019-03-02T00:00:00Z,PHX vs. LAL,118,9,1610612747,LAL,Los Angeles Lakers,LAL @ PHX,109,-9,Regular Season
22018,1610612765,DET,Detroit Pistons,0021800949,2019-03-03T00:00:00Z,DET vs. TOR,112,5,1610612761,TOR,Toronto Raptors,TOR @ DET,107,-5,Regular Season
22018,1610612746,LAC,LA Clippers,0021800947,2019-03-03T00:00:00Z,LAC vs. NYK,128,21,1610612752,NYK,New York Knicks,NYK @ LAC,107,-21,Regular Season
22018,1610612760,OKC,Oklahoma City Thunder,0021800951,2019-03-03T00:00:00Z,OKC vs. MEM,99,4,1610612763,MEM,Memphis Grizzlies,MEM @ OKC,95,-4,Regular Season
22018,1610612741,CHI,Chicago Bulls,0021800946,2019-03-03T00:00:00Z,CHI vs. ATL,118,-5,1610612737,ATL,Atlanta Hawks,ATL @ CHI,123,5,Regular Season
22018,1610612766,CHA,Charlotte Hornets,0021800944,2019-03-03T00:00:00Z,CHA vs. POR,108,-10,1610612757,POR,Portland Trail Blazers,POR @ CHA,118,10,Regular Season
22018,1610612738,BOS,Boston Celtics,0021800945,2019-03-03T00:00:00Z,BOS vs. HOU,104,-11,1610612745,HOU,Houston Rockets,HOU @ BOS,115,11,Regular Season
22018,1610612764,WAS,Washington Wizards,0021800950,2019-03-03T00:00:00Z,WAS vs. MIN,135,14,1610612750,MIN,Minnesota Timberwolves,MIN @ WAS,121,-14,Regular Season
22018,1610612739,CLE,Cleveland Cavaliers,0021800948,2019-03-03T00:00:00Z,CLE vs. ORL,107,14,1610612753,ORL,Orlando Magic,ORL @ CLE,93,-14,Regular Season
22018,1610612758,SAC,Sacramento Kings,0021800957,2019-03-04T00:00:00Z,SAC vs. NYK,115,7,1610612752,NYK,New York Knicks,NYK @ SAC,108,-7,Regular Season
22018,1610612759,SAS,San Antonio Spurs,0021800954,2019-03-04T00:00:00Z,SAS vs. DEN,104,1,1610612743,DEN,Denver Nuggets,DEN @ SAS,103,-1,Regular Season
22018,1610612756,PHX,Phoenix Suns,0021800955,2019-03-04T00:00:00Z,PHX vs. MIL,114,9,1610612749,MIL,Milwaukee Bucks,MIL @ PHX,105,-9,Regular Season
22018,1610612751,BKN,Brooklyn Nets,0021800952,2019-03-04T00:00:00Z,BKN vs. DAL,127,39,1610612742,DAL,Dallas Mavericks,DAL @ BKN,88,-39,Regular Season
22018,1610612762,UTA,Utah Jazz,0021800956,2019-03-04T00:00:00Z,UTA vs. NOP,112,-3,1610612740,NOP,New Orleans Pelicans,NOP @ UTA,115,3,Regular Season
22018,1610612748,MIA,Miami Heat,0021800953,2019-03-04T00:00:00Z,MIA vs. ATL,114,1,1610612737,ATL,Atlanta Hawks,ATL @ MIA,113,-1,Regular Season
22018,1610612747,LAL,Los Angeles Lakers,0021800958,2019-03-04T00:00:00Z,LAL vs. LAC,105,-8,1610612746,LAC,LA Clippers,LAC @ LAL,113,8,Regular Season
22018,1610612744,GSW,Golden State Warriors,0021800964,2019-03-05T00:00:00Z,GSW vs. BOS,95,-33,1610612738,BOS,Boston Celtics,BOS @ GSW,128,33,Regular Season
22018,1610612755,PHI,Philadelphia 76ers,0021800960,2019-03-05T00:00:00Z,PHI vs. ORL,114,8,1610612753,ORL,Orlando Magic,ORL @ PHI,106,-8,Regular Season
22018,1610612761,TOR,Toronto Raptors,0021800961,2019-03-05T00:00:00Z,TOR vs. HOU,95,-12,1610612745,HOU,Houston Rockets,HOU @ TOR,107,12,Regular Season
22018,1610612763,MEM,Memphis Grizzlies,0021800962,2019-03-05T00:00:00Z,MEM vs. POR,120,9,1610612757,POR,Portland Trail Blazers,POR @ MEM,111,-9,Regular Season
22018,1610612754,IND,Indiana Pacers,0021800959,2019-03-05T00:00:00Z,IND vs. CHI,105,9,1610612741,CHI,Chicago Bulls,CHI @ IND,96,-9,Regular Season
22018,1610612750,MIN,Minnesota Timberwolves,0021800963,2019-03-05T00:00:00Z,MIN vs. OKC,131,11,1610612760,OKC,Oklahoma City Thunder,OKC @ MIN,120,-11,Regular Season
22018,1610612737,ATL,Atlanta Hawks,0021800968,2019-03-06T00:00:00Z,ATL vs. SAS,104,-7,1610612759,SAS,San Antonio Spurs,SAS @ ATL,111,7,Regular Season
22018,1610612751,BKN,Brooklyn Nets,0021800969,2019-03-06T00:00:00Z,BKN vs. CLE,113,6,1610612739,CLE,Cleveland Cavaliers,CLE @ BKN,107,-6,Regular Season
22018,1610612758,SAC,Sacramento Kings,0021800973,2019-03-06T00:00:00Z,SAC vs. BOS,109,-2,1610612738,BOS,Boston Celtics,BOS @ SAC,111,2,Regular Season
22018,1610612747,LAL,Los Angeles Lakers,0021800974,2019-03-06T00:00:00Z,LAL vs. DEN,99,-16,1610612743,DEN,Denver Nuggets,DEN @ LAL,115,16,Regular Season
22018,1610612766,CHA,Charlotte Hornets,0021800965,2019-03-06T00:00:00Z,CHA vs. MIA,84,-7,1610612748,MIA,Miami Heat,MIA @ CHA,91,7,Regular Season
22018,1610612756,PHX,Phoenix Suns,0021800972,2019-03-06T00:00:00Z,PHX vs. NYK,107,11,1610612752,NYK,New York Knicks,NYK @ PHX,96,-11,Regular Season
22018,1610612764,WAS,Washington Wizards,0021800967,2019-03-06T00:00:00Z,WAS vs. DAL,132,9,1610612742,DAL,Dallas Mavericks,DAL @ WAS,123,-9,Regular Season
22018,1610612740,NOP,New Orleans Pelicans,0021800971,2019-03-06T00:00:00Z,NOP vs. UTA,104,-10,1610612762,UTA,Utah Jazz,UTA @ NOP,114,10,Regular Season
22018,1610612765,DET,Detroit Pistons,0021800966,2019-03-06T00:00:00Z,DET vs. MIN,131,17,1610612750,MIN,Minnesota Timberwolves,MIN @ DET,114,-17,Regular Season
22018,1610612741,CHI,Chicago Bulls,0021800970,2019-03-06T00:00:00Z,CHI vs. PHI,108,1,1610612755,PHI,Philadelphia 76ers,PHI @ CHI,107,-1,Regular Season
22018,1610612757,POR,Portland Trail Blazers,0021800976,2019-03-07T00:00:00Z,POR vs. OKC,121,-8,1610612760,OKC,Oklahoma City Thunder,OKC @ POR,129,8,Regular Season
22018,1610612749,MIL,Milwaukee Bucks,0021800975,2019-03-07T00:00:00Z,MIL vs. IND,117,19,1610612754,IND,Indiana Pacers,IND @ MIL,98,-19,Regular Season
22018,1610612746,LAC,LA Clippers,0021800985,2019-03-08T00:00:00Z,LAC vs. OKC,118,8,1610612760,OKC,Oklahoma City Thunder,OKC @ LAC,110,-8,Regular Season
22018,1610612748,MIA,Miami Heat,0021800979,2019-03-08T00:00:00Z,MIA vs. CLE,126,16,1610612739,CLE,Cleveland Cavaliers,CLE @ MIA,110,-16,Regular Season
22018,1610612744,GSW,Golden State Warriors,0021800984,2019-03-08T00:00:00Z,GSW vs. DEN,122,17,1610612743,DEN,Denver Nuggets,DEN @ GSW,105,-17,Regular Season
22018,1610612753,ORL,Orlando Magic,0021800978,2019-03-08T00:00:00Z,ORL vs. DAL,111,5,1610612742,DAL,Dallas Mavericks,DAL @ ORL,106,-5,Regular Season
22018,1610612763,MEM,Memphis Grizzlies,0021800982,2019-03-08T00:00:00Z,MEM vs. UTA,114,10,1610612762,UTA,Utah Jazz,UTA @ MEM,104,-10,Regular Season
22018,1610612766,CHA,Charlotte Hornets,0021800977,2019-03-08T00:00:00Z,CHA vs. WAS,112,1,1610612764,WAS,Washington Wizards,WAS @ CHA,111,-1,Regular Season
22018,1610612741,CHI,Chicago Bulls,0021800980,2019-03-08T00:00:00Z,CHI vs. DET,104,-8,1610612765,DET,Detroit Pistons,DET @ CHI,112,8,Regular Season
22018,1610612740,NOP,New Orleans Pelicans,0021800983,2019-03-08T00:00:00Z,NOP vs. TOR,104,-23,1610612761,TOR,Toronto Raptors,TOR @ NOP,127,23,Regular Season
22018,1610612745,HOU,Houston Rockets,0021800981,2019-03-08T00:00:00Z,HOU vs. PHI,107,16,1610612755,PHI,Philadelphia 76ers,PHI @ HOU,91,-16,Regular Season
22018,1610612749,MIL,Milwaukee Bucks,0021800990,2019-03-09T00:00:00Z,MIL vs. CHA,131,17,1610612766,CHA,Charlotte Hornets,CHA @ MIL,114,-17,Regular Season
22018,1610612752,NYK,New York Knicks,0021800986,2019-03-09T00:00:00Z,NYK vs. SAC,94,-8,1610612758,SAC,Sacramento Kings,SAC @ NYK,102,8,Regular Season
22018,1610612747,LAL,Los Angeles Lakers,0021800989,2019-03-09T00:00:00Z,LAL vs. BOS,107,-13,1610612738,BOS,Boston Celtics,BOS @ LAL,120,13,Regular Season
22018,1610612737,ATL,Atlanta Hawks,0021800987,2019-03-09T00:00:00Z,ATL vs. BKN,112,-2,1610612751,BKN,Brooklyn Nets,BKN @ ATL,114,2,Regular Season
22018,1610612757,POR,Portland Trail Blazers,0021800991,2019-03-09T00:00:00Z,POR vs. PHX,127,7,1610612756,PHX,Phoenix Suns,PHX @ POR,120,-7,Regular Season
22018,1610612750,MIN,Minnesota Timberwolves,0021800988,2019-03-09T00:00:00Z,MIN vs. WAS,135,5,1610612764,WAS,Washington Wizards,WAS @ MIN,130,-5,Regular Season
22018,1610612765,DET,Detroit Pistons,0021800992,2019-03-10T00:00:00Z,DET vs. CHI,131,23,1610612741,CHI,Chicago Bulls,CHI @ DET,108,-23,Regular Season
22018,1610612763,MEM,Memphis Grizzlies,0021800996,2019-03-10T00:00:00Z,MEM vs. ORL,105,8,1610612753,ORL,Orlando Magic,ORL @ MEM,97,-8,Regular Season
22018,1610612750,MIN,Minnesota Timberwolves,0021800998,2019-03-10T00:00:00Z,MIN vs. NYK,103,11,1610612752,NYK,New York Knicks,NYK @ MIN,92,-11,Regular Season
22018,1610612759,SAS,San Antonio Spurs,0021800999,2019-03-10T00:00:00Z,SAS vs. MIL,121,7,1610612749,MIL,Milwaukee Bucks,MIL @ SAS,114,-7,Regular Season
22018,1610612744,GSW,Golden State Warriors,0021801000,2019-03-10T00:00:00Z,GSW vs. PHX,111,-4,1610612756,PHX,Phoenix Suns,PHX @ GSW,115,4,Regular Season
22018,1610612755,PHI,Philadelphia 76ers,0021800994,2019-03-10T00:00:00Z,PHI vs. IND,106,17,1610612754,IND,Indiana Pacers,IND @ PHI,89,-17,Regular Season
22018,1610612742,DAL,Dallas Mavericks,0021800997,2019-03-10T00:00:00Z,DAL vs. HOU,93,-1,1610612745,HOU,Houston Rockets,HOU @ DAL,94,1,Regular Season
22018,1610612748,MIA,Miami Heat,0021800993,2019-03-10T00:00:00Z,MIA vs. TOR,104,-21,1610612761,TOR,Toronto Raptors,TOR @ MIA,125,21,Regular Season
22018,1610612737,ATL,Atlanta Hawks,0021800995,2019-03-10T00:00:00Z,ATL vs. NOP,128,12,1610612740,NOP,New Orleans Pelicans,NOP @ ATL,116,-12,Regular Season
22018,1610612764,WAS,Washington Wizards,0021801002,2019-03-11T00:00:00Z,WAS vs. SAC,121,6,1610612758,SAC,Sacramento Kings,SAC @ WAS,115,-6,Regular Season
22018,1610612762,UTA,Utah Jazz,0021801005,2019-03-11T00:00:00Z,UTA vs. OKC,89,-9,1610612760,OKC,Oklahoma City Thunder,OKC @ UTA,98,9,Regular Season
22018,1610612745,HOU,Houston Rockets,0021801004,2019-03-11T00:00:00Z,HOU vs. CHA,118,12,1610612766,CHA,Charlotte Hornets,CHA @ HOU,106,-12,Regular Season
22018,1610612746,LAC,LA Clippers,0021801006,2019-03-11T00:00:00Z,LAC vs. BOS,140,25,1610612738,BOS,Boston Celtics,BOS @ LAC,115,-25,Regular Season
22018,1610612739,CLE,Cleveland Cavaliers,0021801001,2019-03-11T00:00:00Z,CLE vs. TOR,126,25,1610612761,TOR,Toronto Raptors,TOR @ CLE,101,-25,Regular Season
22018,1610612751,BKN,Brooklyn Nets,0021801003,2019-03-11T00:00:00Z,BKN vs. DET,103,28,1610612765,DET,Detroit Pistons,DET @ BKN,75,-28,Regular Season
22018,1610612746,LAC,LA Clippers,0021801013,2019-03-12T00:00:00Z,LAC vs. POR,104,-21,1610612757,POR,Portland Trail Blazers,POR @ LAC,125,21,Regular Season
22018,1610612742,DAL,Dallas Mavericks,0021801011,2019-03-12T00:00:00Z,DAL vs. SAS,105,-7,1610612759,SAS,San Antonio Spurs,SAS @ DAL,112,7,Regular Season
22018,1610612755,PHI,Philadelphia 76ers,0021801008,2019-03-12T00:00:00Z,PHI vs. CLE,106,7,1610612739,CLE,Cleveland Cavaliers,CLE @ PHI,99,-7,Regular Season
22018,1610612740,NOP,New Orleans Pelicans,0021801010,2019-03-12T00:00:00Z,NOP vs. MIL,113,-17,1610612749,MIL,Milwaukee Bucks,MIL @ NOP,130,17,Regular Season
22018,1610612754,IND,Indiana Pacers,0021801007,2019-03-12T00:00:00Z,IND vs. NYK,103,5,1610612752,NYK,New York Knicks,NYK @ IND,98,-5,Regular Season
22018,1610612743,DEN,Denver Nuggets,0021801012,2019-03-12T00:00:00Z,DEN vs. MIN,133,26,1610612750,MIN,Minnesota Timberwolves,MIN @ DEN,107,-26,Regular Season
22018,1610612741,CHI,Chicago Bulls,0021801009,2019-03-12T00:00:00Z,CHI vs. LAL,107,-16,1610612747,LAL,Los Angeles Lakers,LAL @ CHI,123,16,Regular Season
22018,1610612748,MIA,Miami Heat,0021801014,2019-03-13T00:00:00Z,MIA vs. DET,108,34,1610612765,DET,Detroit Pistons,DET @ MIA,74,-34,Regular Season
22018,1610612764,WAS,Washington Wizards,0021801015,2019-03-13T00:00:00Z,WAS vs. ORL,100,10,1610612753,ORL,Orlando Magic,ORL @ WAS,90,-10,Regular Season
22018,1610612760,OKC,Oklahoma City Thunder,0021801017,2019-03-13T00:00:00Z,OKC vs. BKN,108,12,1610612751,BKN,Brooklyn Nets,BKN @ OKC,96,-12,Regular Season
22018,1610612745,HOU,Houston Rockets,0021801018,2019-03-13T00:00:00Z,HOU vs. GSW,104,-2,1610612744,GSW,Golden State Warriors,GSW @ HOU,106,2,Regular Season
22018,1610612756,PHX,Phoenix Suns,0021801019,2019-03-13T00:00:00Z,PHX vs. UTA,97,-17,1610612762,UTA,Utah Jazz,UTA @ PHX,114,17,Regular Season
22018,1610612737,ATL,Atlanta Hawks,0021801016,2019-03-13T00:00:00Z,ATL vs. MEM,132,21,1610612763,MEM,Memphis Grizzlies,MEM @ ATL,111,-21,Regular Season
22018,1610612738,BOS,Boston Celtics,0021801022,2019-03-14T00:00:00Z,BOS vs. SAC,126,6,1610612758,SAC,Sacramento Kings,SAC @ BOS,120,-6,Regular Season
22018,1610612761,TOR,Toronto Raptors,0021801023,2019-03-14T00:00:00Z,TOR vs. LAL,111,13,1610612747,LAL,Los Angeles Lakers,LAL @ TOR,98,-13,Regular Season
22018,1610612754,IND,Indiana Pacers,0021801020,2019-03-14T00:00:00Z,IND vs. OKC,108,2,1610612760,OKC,Oklahoma City Thunder,OKC @ IND,106,-2,Regular Season
22018,1610612762,UTA,Utah Jazz,0021801024,2019-03-14T00:00:00Z,UTA vs. MIN,120,20,1610612750,MIN,Minnesota Timberwolves,MIN @ UTA,100,-20,Regular Season
22018,1610612753,ORL,Orlando Magic,0021801021,2019-03-14T00:00:00Z,ORL vs. CLE,120,29,1610612739,CLE,Cleveland Cavaliers,CLE @ ORL,91,-29,Regular Season
22018,1610612743,DEN,Denver Nuggets,0021801025,2019-03-14T00:00:00Z,DEN vs. DAL,100,1,1610612742,DAL,Dallas Mavericks,DAL @ DEN,99,-1,Regular Season
22018,1610612759,SAS,San Antonio Spurs,0021801032,2019-03-15T00:00:00Z,SAS vs. NYK,109,26,1610612752,NYK,New York Knicks,NYK @ SAS,83,-26,Regular Season
22018,1610612748,MIA,Miami Heat,0021801029,2019-03-15T00:00:00Z,MIA vs. MIL,98,-15,1610612749,MIL,Milwaukee Bucks,MIL @ MIA,113,15,Regular Season
22018,1610612745,HOU,Houston Rockets,0021801030,2019-03-15T00:00:00Z,HOU vs. PHX,108,6,1610612756,PHX,Phoenix Suns,PHX @ HOU,102,-6,Regular Season
22018,1610612755,PHI,Philadelphia 76ers,0021801027,2019-03-15T00:00:00Z,PHI vs. SAC,123,9,1610612758,SAC,Sacramento Kings,SAC @ PHI,114,-9,Regular Season
22018,1610612765,DET,Detroit Pistons,0021801026,2019-03-15T00:00:00Z,DET vs. LAL,111,14,1610612747,LAL,Los Angeles Lakers,LAL @ DET,97,-14,Regular Season
22018,1610612740,NOP,New Orleans Pelicans,0021801031,2019-03-15T00:00:00Z,NOP vs. POR,110,-12,1610612757,POR,Portland Trail Blazers,POR @ NOP,122,12,Regular Season
22018,1610612764,WAS,Washington Wizards,0021801028,2019-03-15T00:00:00Z,WAS vs. CHA,110,-6,1610612766,CHA,Charlotte Hornets,CHA @ WAS,116,6,Regular Season
22018,1610612746,LAC,LA Clippers,0021801033,2019-03-15T00:00:00Z,LAC vs. CHI,128,7,1610612741,CHI,Chicago Bulls,CHI @ LAC,121,-7,Regular Season
22018,1610612742,DAL,Dallas Mavericks,0021801037,2019-03-16T00:00:00Z,DAL vs. CLE,121,5,1610612739,CLE,Cleveland Cavaliers,CLE @ DAL,116,-5,Regular Season
22018,1610612738,BOS,Boston Celtics,0021801034,2019-03-16T00:00:00Z,BOS vs. ATL,129,9,1610612737,ATL,Atlanta Hawks,ATL @ BOS,120,-9,Regular Season
22018,1610612764,WAS,Washington Wizards,0021801035,2019-03-16T00:00:00Z,WAS vs. MEM,135,7,1610612763,MEM,Memphis Grizzlies,MEM @ WAS,128,-7,Regular Season
22018,1610612743,DEN,Denver Nuggets,0021801040,2019-03-16T00:00:00Z,DEN vs. IND,102,2,1610612754,IND,Indiana Pacers,IND @ DEN,100,-2,Regular Season
22018,1610612762,UTA,Utah Jazz,0021801041,2019-03-16T00:00:00Z,UTA vs. BKN,114,16,1610612751,BKN,Brooklyn Nets,BKN @ UTA,98,-16,Regular Season
22018,1610612760,OKC,Oklahoma City Thunder,0021801038,2019-03-16T00:00:00Z,OKC vs. GSW,88,-22,1610612744,GSW,Golden State Warriors,GSW @ OKC,110,22,Regular Season
22018,1610612740,NOP,New Orleans Pelicans,0021801036,2019-03-16T00:00:00Z,NOP vs. PHX,136,-2,1610612756,PHX,Phoenix Suns,PHX @ NOP,138,2,Regular Season
22018,1610612759,SAS,San Antonio Spurs,0021801039,2019-03-16T00:00:00Z,SAS vs. POR,108,5,1610612757,POR,Portland Trail Blazers,POR @ SAS,103,-5,Regular Season
22018,1610612746,LAC,LA Clippers,0021801049,2019-03-17T00:00:00Z,LAC vs. BKN,119,3,1610612751,BKN,Brooklyn Nets,BKN @ LAC,116,-3,Regular Season
22018,1610612745,HOU,Houston Rockets,0021801048,2019-03-17T00:00:00Z,HOU vs. MIN,117,15,1610612750,MIN,Minnesota Timberwolves,MIN @ HOU,102,-15,Regular Season
22018,1610612753,ORL,Orlando Magic,0021801046,2019-03-17T00:00:00Z,ORL vs. ATL,101,10,1610612737,ATL,Atlanta Hawks,ATL @ ORL,91,-10,Regular Season
22018,1610612752,NYK,New York Knicks,0021801042,2019-03-17T00:00:00Z,NYK vs. LAL,124,1,1610612747,LAL,Los Angeles Lakers,LAL @ NYK,123,-1,Regular Season
22018,1610612749,MIL,Milwaukee Bucks,0021801043,2019-03-17T00:00:00Z,MIL vs. PHI,125,-5,1610612755,PHI,Philadelphia 76ers,PHI @ MIL,130,5,Regular Season
22018,1610612748,MIA,Miami Heat,0021801045,2019-03-17T00:00:00Z,MIA vs. CHA,93,18,1610612766,CHA,Charlotte Hornets,CHA @ MIA,75,-18,Regular Season
22018,1610612758,SAC,Sacramento Kings,0021801047,2019-03-17T00:00:00Z,SAC vs. CHI,129,27,1610612741,CHI,Chicago Bulls,CHI @ SAC,102,-27,Regular Season
22018,1610612765,DET,Detroit Pistons,0021801044,2019-03-17T00:00:00Z,DET vs. TOR,110,3,1610612761,TOR,Toronto Raptors,TOR @ DET,107,-3,Regular Season
22018,1610612738,BOS,Boston Celtics,0021801052,2019-03-18T00:00:00Z,BOS vs. DEN,105,-9,1610612743,DEN,Denver Nuggets,DEN @ BOS,114,9,Regular Season
22018,1610612761,TOR,Toronto Raptors,0021801053,2019-03-18T00:00:00Z,TOR vs. NYK,128,36,1610612752,NYK,New York Knicks,NYK @ TOR,92,-36,Regular Season
22018,1610612759,SAS,San Antonio Spurs,0021801055,2019-03-18T00:00:00Z,SAS vs. GSW,111,6,1610612744,GSW,Golden State Warriors,GSW @ SAS,105,-6,Regular Season
22018,1610612764,WAS,Washington Wizards,0021801051,2019-03-18T00:00:00Z,WAS vs. UTA,95,-21,1610612762,UTA,Utah Jazz,UTA @ WAS,116,21,Regular Season
22018,1610612757,POR,Portland Trail Blazers,0021801058,2019-03-18T00:00:00Z,POR vs. IND,106,8,1610612754,IND,Indiana Pacers,IND @ POR,98,-8,Regular Season
22018,1610612739,CLE,Cleveland Cavaliers,0021801050,2019-03-18T00:00:00Z,CLE vs. DET,126,7,1610612765,DET,Detroit Pistons,DET @ CLE,119,-7,Regular Season
22018,1610612756,PHX,Phoenix Suns,0021801057,2019-03-18T00:00:00Z,PHX vs. CHI,101,-15,1610612741,CHI,Chicago Bulls,CHI @ PHX,116,15,Regular Season
22018,1610612742,DAL,Dallas Mavericks,0021801056,2019-03-18T00:00:00Z,DAL vs. NOP,125,-4,1610612740,NOP,New Orleans Pelicans,NOP @ DAL,129,4,Regular Season
22018,1610612760,OKC,Oklahoma City Thunder,0021801054,2019-03-18T00:00:00Z,OKC vs. MIA,107,-9,1610612748,MIA,Miami Heat,MIA @ OKC,116,9,Regular Season
22018,1610612746,LAC,LA Clippers,0021801064,2019-03-19T00:00:00Z,LAC vs. IND,115,6,1610612754,IND,Indiana Pacers,IND @ LAC,109,-6,Regular Season
22018,1610612737,ATL,Atlanta Hawks,0021801060,2019-03-19T00:00:00Z,ATL vs. HOU,105,-16,1610612745,HOU,Houston Rockets,HOU @ ATL,121,16,Regular Season
22018,1610612766,CHA,Charlotte Hornets,0021801059,2019-03-19T00:00:00Z,CHA vs. PHI,114,-4,1610612755,PHI,Philadelphia 76ers,PHI @ CHA,118,4,Regular Season
22018,1610612750,MIN,Minnesota Timberwolves,0021801062,2019-03-19T00:00:00Z,MIN vs. GSW,107,-10,1610612744,GSW,Golden State Warriors,GSW @ MIN,117,10,Regular Season
22018,1610612749,MIL,Milwaukee Bucks,0021801061,2019-03-19T00:00:00Z,MIL vs. LAL,115,14,1610612747,LAL,Los Angeles Lakers,LAL @ MIL,101,-14,Regular Season
22018,1610612758,SAC,Sacramento Kings,0021801063,2019-03-19T00:00:00Z,SAC vs. BKN,121,-2,1610612751,BKN,Brooklyn Nets,BKN @ SAC,123,2,Regular Season
22018,1610612763,MEM,Memphis Grizzlies,0021801070,2019-03-20T00:00:00Z,MEM vs. HOU,126,1,1610612745,HOU,Houston Rockets,HOU @ MEM,125,-1,Regular Season
22018,1610612741,CHI,Chicago Bulls,0021801069,2019-03-20T00:00:00Z,CHI vs. WAS,126,6,1610612764,WAS,Washington Wizards,WAS @ CHI,120,-6,Regular Season
22018,1610612760,OKC,Oklahoma City Thunder,0021801072,2019-03-20T00:00:00Z,OKC vs. TOR,114,-9,1610612761,TOR,Toronto Raptors,TOR @ OKC,123,9,Regular Season
22018,1610612755,PHI,Philadelphia 76ers,0021801067,2019-03-20T00:00:00Z,PHI vs. BOS,118,3,1610612738,BOS,Boston Celtics,BOS @ PHI,115,-3,Regular Season
22018,1610612759,SAS,San Antonio Spurs,0021801071,2019-03-20T00:00:00Z,SAS vs. MIA,105,-5,1610612748,MIA,Miami Heat,MIA @ SAS,110,5,Regular Season
22018,1610612757,POR,Portland Trail Blazers,0021801073,2019-03-20T00:00:00Z,POR vs. DAL,126,8,1610612742,DAL,Dallas Mavericks,DAL @ POR,118,-8,Regular Season
22018,1610612753,ORL,Orlando Magic,0021801066,2019-03-20T00:00:00Z,ORL vs. NOP,119,23,1610612740,NOP,New Orleans Pelicans,NOP @ ORL,96,-23,Regular Season
22018,1610612739,CLE,Cleveland Cavaliers,0021801065,2019-03-20T00:00:00Z,CLE vs. MIL,107,5,1610612749,MIL,Milwaukee Bucks,MIL @ CLE,102,-5,Regular Season
22018,1610612752,NYK,New York Knicks,0021801068,2019-03-20T00:00:00Z,NYK vs. UTA,116,-21,1610612762,UTA,Utah Jazz,UTA @ NYK,137,21,Regular Season
22018,1610612758,SAC,Sacramento Kings,0021801078,2019-03-21T00:00:00Z,SAC vs. DAL,116,16,1610612742,DAL,Dallas Mavericks,DAL @ SAC,100,-16,Regular Season
22018,1610612744,GSW,Golden State Warriors,0021801079,2019-03-21T00:00:00Z,GSW vs. IND,112,23,1610612754,IND,Indiana Pacers,IND @ GSW,89,-23,Regular Season
22018,1610612764,WAS,Washington Wizards,0021801075,2019-03-21T00:00:00Z,WAS vs. DEN,108,-5,1610612743,DEN,Denver Nuggets,DEN @ WAS,113,5,Regular Season
22018,1610612737,ATL,Atlanta Hawks,0021801076,2019-03-21T00:00:00Z,ATL vs. UTA,117,3,1610612762,UTA,Utah Jazz,UTA @ ATL,114,-3,Regular Season
22018,1610612766,CHA,Charlotte Hornets,0021801074,2019-03-21T00:00:00Z,CHA vs. MIN,113,7,1610612750,MIN,Minnesota Timberwolves,MIN @ CHA,106,-7,Regular Season
22018,1610612756,PHX,Phoenix Suns,0021801077,2019-03-21T00:00:00Z,PHX vs. DET,98,-20,1610612765,DET,Detroit Pistons,DET @ PHX,118,20,Regular Season
22018,1610612753,ORL,Orlando Magic,0021801080,2019-03-22T00:00:00Z,ORL vs. MEM,123,4,1610612763,MEM,Memphis Grizzlies,MEM @ ORL,119,-4,Regular Season
22018,1610612752,NYK,New York Knicks,0021801082,2019-03-22T00:00:00Z,NYK vs. DEN,93,-18,1610612743,DEN,Denver Nuggets,DEN @ NYK,111,18,Regular Season
22018,1610612761,TOR,Toronto Raptors,0021801083,2019-03-22T00:00:00Z,TOR vs. OKC,109,-7,1610612760,OKC,Oklahoma City Thunder,OKC @ TOR,116,7,Regular Season
22018,1610612745,HOU,Houston Rockets,0021801084,2019-03-22T00:00:00Z,HOU vs. SAS,111,6,1610612759,SAS,San Antonio Spurs,SAS @ HOU,105,-6,Regular Season
22018,1610612739,CLE,Cleveland Cavaliers,0021801081,2019-03-22T00:00:00Z,CLE vs. LAC,108,-2,1610612746,LAC,LA Clippers,LAC @ CLE,110,2,Regular Season
22018,1610612747,LAL,Los Angeles Lakers,0021801086,2019-03-22T00:00:00Z,LAL vs. BKN,106,-5,1610612751,BKN,Brooklyn Nets,BKN @ LAL,111,5,Regular Season
22018,1610612749,MIL,Milwaukee Bucks,0021801085,2019-03-22T00:00:00Z,MIL vs. MIA,116,29,1610612748,MIA,Miami Heat,MIA @ MIL,87,-29,Regular Season
22018,1610612764,WAS,Washington Wizards,0021801089,2019-03-23T00:00:00Z,WAS vs. MIA,108,-5,1610612748,MIA,Miami Heat,MIA @ WAS,113,5,Regular Season
22018,1610612766,CHA,Charlotte Hornets,0021801087,2019-03-23T00:00:00Z,CHA vs. BOS,124,7,1610612738,BOS,Boston Celtics,BOS @ CHA,117,-7,Regular Season
22018,1610612737,ATL,Atlanta Hawks,0021801088,2019-03-23T00:00:00Z,ATL vs. PHI,129,2,1610612755,PHI,Philadelphia 76ers,PHI @ ATL,127,-2,Regular Season
22018,1610612757,POR,Portland Trail Blazers,0021801093,2019-03-23T00:00:00Z,POR vs. DET,117,5,1610612765,DET,Detroit Pistons,DET @ POR,112,-5,Regular Season
22018,1610612763,MEM,Memphis Grizzlies,0021801091,2019-03-23T00:00:00Z,MEM vs. MIN,99,-13,1610612750,MIN,Minnesota Timberwolves,MIN @ MEM,112,13,Regular Season
22018,1610612744,GSW,Golden State Warriors,0021801092,2019-03-23T00:00:00Z,GSW vs. DAL,91,-35,1610612742,DAL,Dallas Mavericks,DAL @ GSW,126,35,Regular Season
22018,1610612741,CHI,Chicago Bulls,0021801090,2019-03-23T00:00:00Z,CHI vs. UTA,83,-31,1610612762,UTA,Utah Jazz,UTA @ CHI,114,31,Regular Season
22018,1610612758,SAC,Sacramento Kings,0021801094,2019-03-23T00:00:00Z,SAC vs. PHX,112,9,1610612756,PHX,Phoenix Suns,PHX @ SAC,103,-9,Regular Season
22018,1610612754,IND,Indiana Pacers,0021801097,2019-03-24T00:00:00Z,IND vs. DEN,124,36,1610612743,DEN,Denver Nuggets,DEN @ IND,88,-36,Regular Season
22018,1610612738,BOS,Boston Celtics,0021801100,2019-03-24T00:00:00Z,BOS vs. SAS,96,-19,1610612759,SAS,San Antonio Spurs,SAS @ BOS,115,19,Regular Season
22018,1610612761,TOR,Toronto Raptors,0021801098,2019-03-24T00:00:00Z,TOR vs. CHA,114,-1,1610612766,CHA,Charlotte Hornets,CHA @ TOR,115,1,Regular Season
22018,1610612752,NYK,New York Knicks,0021801095,2019-03-24T00:00:00Z,NYK vs. LAC,113,-11,1610612746,LAC,LA Clippers,LAC @ NYK,124,11,Regular Season
22018,1610612740,NOP,New Orleans Pelicans,0021801099,2019-03-24T00:00:00Z,NOP vs. HOU,90,-23,1610612745,HOU,Houston Rockets,HOU @ NOP,113,23,Regular Season
22018,1610612749,MIL,Milwaukee Bucks,0021801096,2019-03-24T00:00:00Z,MIL vs. CLE,127,22,1610612739,CLE,Cleveland Cavaliers,CLE @ MIL,105,-22,Regular Season
22018,1610612744,GSW,Golden State Warriors,0021801101,2019-03-24T00:00:00Z,GSW vs. DET,121,7,1610612765,DET,Detroit Pistons,DET @ GSW,114,-7,Regular Season
22018,1610612747,LAL,Los Angeles Lakers,0021801102,2019-03-24T00:00:00Z,LAL vs. SAC,111,5,1610612758,SAC,Sacramento Kings,SAC @ LAL,106,-5,Regular Season
22018,1610612757,POR,Portland Trail Blazers,0021801106,2019-03-25T00:00:00Z,POR vs. BKN,148,4,1610612751,BKN,Brooklyn Nets,BKN @ POR,144,-4,Regular Season
22018,1610612753,ORL,Orlando Magic,0021801103,2019-03-25T00:00:00Z,ORL vs. PHI,119,21,1610612755,PHI,Philadelphia 76ers,PHI @ ORL,98,-21,Regular Season
22018,1610612763,MEM,Memphis Grizzlies,0021801104,2019-03-25T00:00:00Z,MEM vs. OKC,115,12,1610612760,OKC,Oklahoma City Thunder,OKC @ MEM,103,-12,Regular Season
22018,1610612762,UTA,Utah Jazz,0021801105,2019-03-25T00:00:00Z,UTA vs. PHX,125,33,1610612756,PHX,Phoenix Suns,PHX @ UTA,92,-33,Regular Season
22018,1610612749,MIL,Milwaukee Bucks,0021801111,2019-03-26T00:00:00Z,MIL vs. HOU,108,14,1610612745,HOU,Houston Rockets,HOU @ MIL,94,-14,Regular Season
22018,1610612743,DEN,Denver Nuggets,0021801115,2019-03-26T00:00:00Z,DEN vs. DET,95,3,1610612765,DET,Detroit Pistons,DET @ DEN,92,-3,Regular Season
22018,1610612742,DAL,Dallas Mavericks,0021801114,2019-03-26T00:00:00Z,DAL vs. SAC,121,-4,1610612758,SAC,Sacramento Kings,SAC @ DAL,125,4,Regular Season
22018,1610612740,NOP,New Orleans Pelicans,0021801113,2019-03-26T00:00:00Z,NOP vs. ATL,120,-10,1610612737,ATL,Atlanta Hawks,ATL @ NOP,130,10,Regular Season
22018,1610612761,TOR,Toronto Raptors,0021801110,2019-03-26T00:00:00Z,TOR vs. CHI,112,9,1610612741,CHI,Chicago Bulls,CHI @ TOR,103,-9,Regular Season
22018,1610612750,MIN,Minnesota Timberwolves,0021801112,2019-03-26T00:00:00Z,MIN vs. LAC,111,-11,1610612746,LAC,LA Clippers,LAC @ MIN,122,11,Regular Season
22018,1610612766,CHA,Charlotte Hornets,0021801107,2019-03-26T00:00:00Z,CHA vs. SAS,125,9,1610612759,SAS,San Antonio Spurs,SAS @ CHA,116,-9,Regular Season
22018,1610612739,CLE,Cleveland Cavaliers,0021801108,2019-03-26T00:00:00Z,CLE vs. BOS,106,-10,1610612738,BOS,Boston Celtics,BOS @ CLE,116,10,Regular Season
22018,1610612748,MIA,Miami Heat,0021801109,2019-03-26T00:00:00Z,MIA vs. ORL,99,-5,1610612753,ORL,Orlando Magic,ORL @ MIA,104,5,Regular Season
22018,1610612747,LAL,Los Angeles Lakers,0021801116,2019-03-26T00:00:00Z,LAL vs. WAS,124,18,1610612764,WAS,Washington Wizards,WAS @ LAL,106,-18,Regular Season
22018,1610612741,CHI,Chicago Bulls,0021801117,2019-03-27T00:00:00Z,CHI vs. POR,98,-20,1610612757,POR,Portland Trail Blazers,POR @ CHI,118,20,Regular Season
22018,1610612756,PHX,Phoenix Suns,0021801120,2019-03-27T00:00:00Z,PHX vs. WAS,121,-3,1610612764,WAS,Washington Wizards,WAS @ PHX,124,3,Regular Season
22018,1610612760,OKC,Oklahoma City Thunder,0021801119,2019-03-27T00:00:00Z,OKC vs. IND,107,8,1610612754,IND,Indiana Pacers,IND @ OKC,99,-8,Regular Season
22018,1610612762,UTA,Utah Jazz,0021801121,2019-03-27T00:00:00Z,UTA vs. LAL,115,15,1610612747,LAL,Los Angeles Lakers,LAL @ UTA,100,-15,Regular Season
22018,1610612763,MEM,Memphis Grizzlies,0021801118,2019-03-27T00:00:00Z,MEM vs. GSW,103,-15,1610612744,GSW,Golden State Warriors,GSW @ MEM,118,15,Regular Season
22018,1610612748,MIA,Miami Heat,0021801124,2019-03-28T00:00:00Z,MIA vs. DAL,105,6,1610612742,DAL,Dallas Mavericks,DAL @ MIA,99,-6,Regular Season
22018,1610612752,NYK,New York Knicks,0021801125,2019-03-28T00:00:00Z,NYK vs. TOR,92,-25,1610612761,TOR,Toronto Raptors,TOR @ NYK,117,25,Regular Season
22018,1610612745,HOU,Houston Rockets,0021801126,2019-03-28T00:00:00Z,HOU vs. DEN,112,27,1610612743,DEN,Denver Nuggets,DEN @ HOU,85,-27,Regular Season
22018,1610612755,PHI,Philadelphia 76ers,0021801123,2019-03-28T00:00:00Z,PHI vs. BKN,123,13,1610612751,BKN,Brooklyn Nets,BKN @ PHI,110,-13,Regular Season
22018,1610612765,DET,Detroit Pistons,0021801122,2019-03-28T00:00:00Z,DET vs. ORL,115,17,1610612753,ORL,Orlando Magic,ORL @ DET,98,-17,Regular Season
22018,1610612749,MIL,Milwaukee Bucks,0021801127,2019-03-28T00:00:00Z,MIL vs. LAC,128,10,1610612746,LAC,LA Clippers,LAC @ MIL,118,-10,Regular Season
22018,1610612759,SAS,San Antonio Spurs,0021801129,2019-03-28T00:00:00Z,SAS vs. CLE,116,6,1610612739,CLE,Cleveland Cavaliers,CLE @ SAS,110,-6,Regular Season
22018,1610612740,NOP,New Orleans Pelicans,0021801128,2019-03-28T00:00:00Z,NOP vs. SAC,121,3,1610612758,SAC,Sacramento Kings,SAC @ NOP,118,-3,Regular Season
22018,1610612760,OKC,Oklahoma City Thunder,0021801133,2019-03-29T00:00:00Z,OKC vs. DEN,105,-10,1610612743,DEN,Denver Nuggets,DEN @ OKC,115,10,Regular Season
22018,1610612750,MIN,Minnesota Timberwolves,0021801132,2019-03-29T00:00:00Z,MIN vs. GSW,131,1,1610612744,GSW,Golden State Warriors,GSW @ MIN,130,-1,Regular Season
22018,1610612762,UTA,Utah Jazz,0021801134,2019-03-29T00:00:00Z,UTA vs. WAS,128,4,1610612764,WAS,Washington Wizards,WAS @ UTA,124,-4,Regular Season
22018,1610612747,LAL,Los Angeles Lakers,0021801135,2019-03-29T00:00:00Z,LAL vs. CHA,129,14,1610612766,CHA,Charlotte Hornets,CHA @ LAL,115,-14,Regular Season
22018,1610612738,BOS,Boston Celtics,0021801130,2019-03-29T00:00:00Z,BOS vs. IND,114,2,1610612754,IND,Indiana Pacers,IND @ BOS,112,-2,Regular Season
22018,1610612737,ATL,Atlanta Hawks,0021801131,2019-03-29T00:00:00Z,ATL vs. POR,98,-20,1610612757,POR,Portland Trail Blazers,POR @ ATL,118,20,Regular Season
22018,1610612765,DET,Detroit Pistons,0021801139,2019-03-30T00:00:00Z,DET vs. POR,99,9,1610612757,POR,Portland Trail Blazers,POR @ DET,90,-9,Regular Season
22018,1610612746,LAC,LA Clippers,0021801136,2019-03-30T00:00:00Z,LAC vs. CLE,132,24,1610612739,CLE,Cleveland Cavaliers,CLE @ LAC,108,-24,Regular Season
22018,1610612751,BKN,Brooklyn Nets,0021801137,2019-03-30T00:00:00Z,BKN vs. BOS,110,14,1610612738,BOS,Boston Celtics,BOS @ BKN,96,-14,Regular Season
22018,1610612741,CHI,Chicago Bulls,0021801142,2019-03-30T00:00:00Z,CHI vs. TOR,101,-23,1610612761,TOR,Toronto Raptors,TOR @ CHI,124,23,Regular Season
22018,1610612756,PHX,Phoenix Suns,0021801144,2019-03-30T00:00:00Z,PHX vs. MEM,115,-5,1610612763,MEM,Memphis Grizzlies,MEM @ PHX,120,5,Regular Season
22018,1610612752,NYK,New York Knicks,0021801141,2019-03-30T00:00:00Z,NYK vs. MIA,92,-8,1610612748,MIA,Miami Heat,MIA @ NYK,100,8,Regular Season
22018,1610612750,MIN,Minnesota Timberwolves,0021801143,2019-03-30T00:00:00Z,MIN vs. PHI,109,-9,1610612755,PHI,Philadelphia 76ers,PHI @ MIN,118,9,Regular Season
22018,1610612754,IND,Indiana Pacers,0021801140,2019-03-30T00:00:00Z,IND vs. ORL,116,-5,1610612753,ORL,Orlando Magic,ORL @ IND,121,5,Regular Season
22018,1610612745,HOU,Houston Rockets,0021801138,2019-03-30T00:00:00Z,HOU vs. SAC,119,11,1610612758,SAC,Sacramento Kings,SAC @ HOU,108,-11,Regular Season
22018,1610612759,SAS,San Antonio Spurs,0021801149,2019-03-31T00:00:00Z,SAS vs. SAC,106,-7,1610612758,SAC,Sacramento Kings,SAC @ SAS,113,7,Regular Season
22018,1610612760,OKC,Oklahoma City Thunder,0021801146,2019-03-31T00:00:00Z,OKC vs. DAL,103,-3,1610612742,DAL,Dallas Mavericks,DAL @ OKC,106,3,Regular Season
22018,1610612737,ATL,Atlanta Hawks,0021801145,2019-03-31T00:00:00Z,ATL vs. MIL,136,1,1610612749,MIL,Milwaukee Bucks,MIL @ ATL,135,-1,Regular Season
22018,1610612743,DEN,Denver Nuggets,0021801148,2019-03-31T00:00:00Z,DEN vs. WAS,90,-5,1610612764,WAS,Washington Wizards,WAS @ DEN,95,5,Regular Season
22018,1610612744,GSW,Golden State Warriors,0021801150,2019-03-31T00:00:00Z,GSW vs. CHA,137,47,1610612766,CHA,Charlotte Hornets,CHA @ GSW,90,-47,Regular Season
22018,1610612740,NOP,New Orleans Pelicans,0021801147,2019-03-31T00:00:00Z,NOP vs. LAL,102,-28,1610612747,LAL,Los Angeles Lakers,LAL @ NOP,130,28,Regular Season
22018,1610612746,LAC,LA Clippers,0021801151,2019-03-31T00:00:00Z,LAC vs. MEM,113,17,1610612763,MEM,Memphis Grizzlies,MEM @ LAC,96,-17,Regular Season
22018,1610612761,TOR,Toronto Raptors,0021801156,2019-04-01T00:00:00Z,TOR vs. ORL,121,12,1610612753,ORL,Orlando Magic,ORL @ TOR,109,-12,Regular Season
22018,1610612738,BOS,Boston Celtics,0021801153,2019-04-01T00:00:00Z,BOS vs. MIA,110,5,1610612748,MIA,Miami Heat,MIA @ BOS,105,-5,Regular Season
22018,1610612762,UTA,Utah Jazz,0021801159,2019-04-01T00:00:00Z,UTA vs. CHA,111,9,1610612766,CHA,Charlotte Hornets,CHA @ UTA,102,-9,Regular Season
22018,1610612750,MIN,Minnesota Timberwolves,0021801157,2019-04-01T00:00:00Z,MIN vs. POR,122,-10,1610612757,POR,Portland Trail Blazers,POR @ MIN,132,10,Regular Season
22018,1610612754,IND,Indiana Pacers,0021801152,2019-04-01T00:00:00Z,IND vs. DET,111,9,1610612765,DET,Detroit Pistons,DET @ IND,102,-9,Regular Season
22018,1610612751,BKN,Brooklyn Nets,0021801154,2019-04-01T00:00:00Z,BKN vs. MIL,121,-10,1610612749,MIL,Milwaukee Bucks,MIL @ BKN,131,10,Regular Season
22018,1610612756,PHX,Phoenix Suns,0021801160,2019-04-01T00:00:00Z,PHX vs. CLE,122,9,1610612739,CLE,Cleveland Cavaliers,CLE @ PHX,113,-9,Regular Season
22018,1610612752,NYK,New York Knicks,0021801155,2019-04-01T00:00:00Z,NYK vs. CHI,113,8,1610612741,CHI,Chicago Bulls,CHI @ NYK,105,-8,Regular Season
22018,1610612742,DAL,Dallas Mavericks,0021801158,2019-04-01T00:00:00Z,DAL vs. PHI,122,20,1610612755,PHI,Philadelphia 76ers,PHI @ DAL,102,-20,Regular Season
22018,1610612758,SAC,Sacramento Kings,0021801163,2019-04-02T00:00:00Z,SAC vs. HOU,105,-25,1610612745,HOU,Houston Rockets,HOU @ SAC,130,25,Regular Season
22018,1610612759,SAS,San Antonio Spurs,0021801162,2019-04-02T00:00:00Z,SAS vs. ATL,117,6,1610612737,ATL,Atlanta Hawks,ATL @ SAS,111,-6,Regular Season
22018,1610612760,OKC,Oklahoma City Thunder,0021801161,2019-04-02T00:00:00Z,OKC vs. LAL,119,16,1610612747,LAL,Los Angeles Lakers,LAL @ OKC,103,-16,Regular Season
22018,1610612744,GSW,Golden State Warriors,0021801164,2019-04-02T00:00:00Z,GSW vs. DEN,116,14,1610612743,DEN,Denver Nuggets,DEN @ GSW,102,-14,Regular Season
22018,1610612748,MIA,Miami Heat,0021801170,2019-04-03T00:00:00Z,MIA vs. BOS,102,-10,1610612738,BOS,Boston Celtics,BOS @ MIA,112,10,Regular Season
22018,1610612737,ATL,Atlanta Hawks,0021801168,2019-04-03T00:00:00Z,ATL vs. PHI,130,8,1610612755,PHI,Philadelphia 76ers,PHI @ ATL,122,-8,Regular Season
22018,1610612764,WAS,Washington Wizards,0021801167,2019-04-03T00:00:00Z,WAS vs. CHI,114,-1,1610612741,CHI,Chicago Bulls,CHI @ WAS,115,1,Regular Season
22018,1610612746,LAC,LA Clippers,0021801176,2019-04-03T00:00:00Z,LAC vs. HOU,103,-32,1610612745,HOU,Houston Rockets,HOU @ LAC,135,32,Regular Season
22018,1610612740,NOP,New Orleans Pelicans,0021801171,2019-04-03T00:00:00Z,NOP vs. CHA,109,-6,1610612766,CHA,Charlotte Hornets,CHA @ NOP,115,6,Regular Season
22018,1610612756,PHX,Phoenix Suns,0021801174,2019-04-03T00:00:00Z,PHX vs. UTA,97,-21,1610612762,UTA,Utah Jazz,UTA @ PHX,118,21,Regular Season
22018,1610612765,DET,Detroit Pistons,0021801165,2019-04-03T00:00:00Z,DET vs. IND,89,-19,1610612754,IND,Indiana Pacers,IND @ DET,108,19,Regular Season
22018,1610612753,ORL,Orlando Magic,0021801166,2019-04-03T00:00:00Z,ORL vs. NYK,114,14,1610612752,NYK,New York Knicks,NYK @ ORL,100,-14,Regular Season
22018,1610612757,POR,Portland Trail Blazers,0021801175,2019-04-03T00:00:00Z,POR vs. MEM,116,27,1610612763,MEM,Memphis Grizzlies,MEM @ POR,89,-27,Regular Season
22018,1610612743,DEN,Denver Nuggets,0021801173,2019-04-03T00:00:00Z,DEN vs. SAS,113,28,1610612759,SAS,San Antonio Spurs,SAS @ DEN,85,-28,Regular Season
22018,1610612751,BKN,Brooklyn Nets,0021801169,2019-04-03T00:00:00Z,BKN vs. TOR,105,-10,1610612761,TOR,Toronto Raptors,TOR @ BKN,115,10,Regular Season
22018,1610612742,DAL,Dallas Mavericks,0021801172,2019-04-03T00:00:00Z,DAL vs. MIN,108,-2,1610612750,MIN,Minnesota Timberwolves,MIN @ DAL,110,2,Regular Season
22018,1610612755,PHI,Philadelphia 76ers,0021801177,2019-04-04T00:00:00Z,PHI vs. MIL,122,-6,1610612749,MIL,Milwaukee Bucks,MIL @ PHI,128,6,Regular Season
22018,1610612747,LAL,Los Angeles Lakers,0021801179,2019-04-04T00:00:00Z,LAL vs. GSW,90,-18,1610612744,GSW,Golden State Warriors,GSW @ LAL,108,18,Regular Season
22018,1610612758,SAC,Sacramento Kings,0021801178,2019-04-04T00:00:00Z,SAC vs. CLE,117,13,1610612739,CLE,Cleveland Cavaliers,CLE @ SAC,104,-13,Regular Season
22018,1610612742,DAL,Dallas Mavericks,0021801187,2019-04-05T00:00:00Z,DAL vs. MEM,112,-10,1610612763,MEM,Memphis Grizzlies,MEM @ DAL,122,10,Regular Season
22018,1610612754,IND,Indiana Pacers,0021801183,2019-04-05T00:00:00Z,IND vs. BOS,97,-20,1610612738,BOS,Boston Celtics,BOS @ IND,117,20,Regular Season
22018,1610612756,PHX,Phoenix Suns,0021801189,2019-04-05T00:00:00Z,PHX vs. NOP,133,7,1610612740,NOP,New Orleans Pelicans,NOP @ PHX,126,-7,Regular Season
22018,1610612750,MIN,Minnesota Timberwolves,0021801185,2019-04-05T00:00:00Z,MIN vs. MIA,111,2,1610612748,MIA,Miami Heat,MIA @ MIN,109,-2,Regular Season
22018,1610612746,LAC,LA Clippers,0021801192,2019-04-05T00:00:00Z,LAC vs. LAL,117,-5,1610612747,LAL,Los Angeles Lakers,LAL @ LAC,122,5,Regular Season
22018,1610612743,DEN,Denver Nuggets,0021801190,2019-04-05T00:00:00Z,DEN vs. POR,119,9,1610612757,POR,Portland Trail Blazers,POR @ DEN,110,-9,Regular Season
22018,1610612766,CHA,Charlotte Hornets,0021801180,2019-04-05T00:00:00Z,CHA vs. TOR,113,2,1610612761,TOR,Toronto Raptors,TOR @ CHA,111,-2,Regular Season
22018,1610612762,UTA,Utah Jazz,0021801188,2019-04-05T00:00:00Z,UTA vs. SAC,119,21,1610612758,SAC,Sacramento Kings,SAC @ UTA,98,-21,Regular Season
22018,1610612753,ORL,Orlando Magic,0021801181,2019-04-05T00:00:00Z,ORL vs. ATL,149,36,1610612737,ATL,Atlanta Hawks,ATL @ ORL,113,-36,Regular Season
22018,1610612744,GSW,Golden State Warriors,0021801191,2019-04-05T00:00:00Z,GSW vs. CLE,120,6,1610612739,CLE,Cleveland Cavaliers,CLE @ GSW,114,-6,Regular Season
22018,1610612760,OKC,Oklahoma City Thunder,0021801186,2019-04-05T00:00:00Z,OKC vs. DET,123,13,1610612765,DET,Detroit Pistons,DET @ OKC,110,-13,Regular Season
22018,1610612764,WAS,Washington Wizards,0021801182,2019-04-05T00:00:00Z,WAS vs. SAS,112,-17,1610612759,SAS,San Antonio Spurs,SAS @ WAS,129,17,Regular Season
22018,1610612745,HOU,Houston Rockets,0021801184,2019-04-05T00:00:00Z,HOU vs. NYK,120,24,1610612752,NYK,New York Knicks,NYK @ HOU,96,-24,Regular Season
22018,1610612741,CHI,Chicago Bulls,0021801194,2019-04-06T00:00:00Z,CHI vs. PHI,96,-20,1610612755,PHI,Philadelphia 76ers,PHI @ CHI,116,20,Regular Season
22018,1610612749,MIL,Milwaukee Bucks,0021801193,2019-04-06T00:00:00Z,MIL vs. BKN,128,-5,1610612751,BKN,Brooklyn Nets,BKN @ MIL,133,5,Regular Season
22018,1610612739,CLE,Cleveland Cavaliers,0021801196,2019-04-07T00:00:00Z,CLE vs. SAS,90,-22,1610612759,SAS,San Antonio Spurs,SAS @ CLE,112,22,Regular Season
22018,1610612754,IND,Indiana Pacers,0021801199,2019-04-07T00:00:00Z,IND vs. BKN,96,-12,1610612751,BKN,Brooklyn Nets,BKN @ IND,108,12,Regular Season
22018,1610612738,BOS,Boston Celtics,0021801203,2019-04-07T00:00:00Z,BOS vs. ORL,108,-8,1610612753,ORL,Orlando Magic,ORL @ BOS,116,8,Regular Season
22018,1610612765,DET,Detroit Pistons,0021801198,2019-04-07T00:00:00Z,DET vs. CHA,91,-13,1610612766,CHA,Charlotte Hornets,CHA @ DET,104,13,Regular Season
22018,1610612758,SAC,Sacramento Kings,0021801207,2019-04-07T00:00:00Z,SAC vs. NOP,129,-4,1610612740,NOP,New Orleans Pelicans,NOP @ SAC,133,4,Regular Season
22018,1610612747,LAL,Los Angeles Lakers,0021801208,2019-04-07T00:00:00Z,LAL vs. UTA,113,4,1610612762,UTA,Utah Jazz,UTA @ LAL,109,-4,Regular Season
22018,1610612757,POR,Portland Trail Blazers,0021801206,2019-04-07T00:00:00Z,POR vs. DEN,115,7,1610612743,DEN,Denver Nuggets,DEN @ POR,108,-7,Regular Season
22018,1610612744,GSW,Golden State Warriors,0021801205,2019-04-07T00:00:00Z,GSW vs. LAC,131,27,1610612746,LAC,LA Clippers,LAC @ GSW,104,-27,Regular Season
22018,1610612761,TOR,Toronto Raptors,0021801195,2019-04-07T00:00:00Z,TOR vs. MIA,117,8,1610612748,MIA,Miami Heat,MIA @ TOR,109,-8,Regular Season
22018,1610612763,MEM,Memphis Grizzlies,0021801201,2019-04-07T00:00:00Z,MEM vs. DAL,127,-2,1610612742,DAL,Dallas Mavericks,DAL @ MEM,129,2,Regular Season
22018,1610612745,HOU,Houston Rockets,0021801200,2019-04-07T00:00:00Z,HOU vs. PHX,149,36,1610612756,PHX,Phoenix Suns,PHX @ HOU,113,-36,Regular Season
22018,1610612752,NYK,New York Knicks,0021801204,2019-04-07T00:00:00Z,NYK vs. WAS,113,3,1610612764,WAS,Washington Wizards,WAS @ NYK,110,-3,Regular Season
22018,1610612750,MIN,Minnesota Timberwolves,0021801197,2019-04-07T00:00:00Z,MIN vs. OKC,126,-6,1610612760,OKC,Oklahoma City Thunder,OKC @ MIN,132,6,Regular Season
22018,1610612749,MIL,Milwaukee Bucks,0021801202,2019-04-07T00:00:00Z,MIL vs. ATL,115,8,1610612737,ATL,Atlanta Hawks,ATL @ MIL,107,-8,Regular Season
22018,1610612764,WAS,Washington Wizards,0021801211,2019-04-09T00:00:00Z,WAS vs. BOS,110,-6,1610612738,BOS,Boston Celtics,BOS @ WAS,116,6,Regular Season
22018,1610612740,NOP,New Orleans Pelicans,0021801215,2019-04-09T00:00:00Z,NOP vs. GSW,103,-9,1610612744,GSW,Golden State Warriors,GSW @ NOP,112,9,Regular Season
22018,1610612750,MIN,Minnesota Timberwolves,0021801214,2019-04-09T00:00:00Z,MIN vs. TOR,100,-20,1610612761,TOR,Toronto Raptors,TOR @ MIN,120,20,Regular Season
22018,1610612742,DAL,Dallas Mavericks,0021801216,2019-04-09T00:00:00Z,DAL vs. PHX,120,11,1610612756,PHX,Phoenix Suns,PHX @ DAL,109,-11,Regular Season
22018,1610612760,OKC,Oklahoma City Thunder,0021801218,2019-04-09T00:00:00Z,OKC vs. HOU,112,1,1610612745,HOU,Houston Rockets,HOU @ OKC,111,-1,Regular Season
22018,1610612741,CHI,Chicago Bulls,0021801213,2019-04-09T00:00:00Z,CHI vs. NYK,86,-10,1610612752,NYK,New York Knicks,NYK @ CHI,96,10,Regular Season
22018,1610612739,CLE,Cleveland Cavaliers,0021801209,2019-04-09T00:00:00Z,CLE vs. CHA,97,-27,1610612766,CHA,Charlotte Hornets,CHA @ CLE,124,27,Regular Season
22018,1610612747,LAL,Los Angeles Lakers,0021801219,2019-04-09T00:00:00Z,LAL vs. POR,101,-3,1610612757,POR,Portland Trail Blazers,POR @ LAL,104,3,Regular Season
22018,1610612762,UTA,Utah Jazz,0021801217,2019-04-09T00:00:00Z,UTA vs. DEN,118,10,1610612743,DEN,Denver Nuggets,DEN @ UTA,108,-10,Regular Season
22018,1610612748,MIA,Miami Heat,0021801212,2019-04-09T00:00:00Z,MIA vs. PHI,122,23,1610612755,PHI,Philadelphia 76ers,PHI @ MIA,99,-23,Regular Season
22018,1610612765,DET,Detroit Pistons,0021801210,2019-04-09T00:00:00Z,DET vs. MEM,100,7,1610612763,MEM,Memphis Grizzlies,MEM @ DET,93,-7,Regular Season
22018,1610612752,NYK,New York Knicks,0021801223,2019-04-10T00:00:00Z,NYK vs. DET,89,-26,1610612765,DET,Detroit Pistons,DET @ NYK,115,26,Regular Season
22018,1610612759,SAS,San Antonio Spurs,0021801227,2019-04-10T00:00:00Z,SAS vs. DAL,105,11,1610612742,DAL,Dallas Mavericks,DAL @ SAS,94,-11,Regular Season
22018,1610612751,BKN,Brooklyn Nets,0021801221,2019-04-10T00:00:00Z,BKN vs. MIA,113,19,1610612748,MIA,Miami Heat,MIA @ BKN,94,-19,Regular Season
22018,1610612766,CHA,Charlotte Hornets,0021801222,2019-04-10T00:00:00Z,CHA vs. ORL,114,-8,1610612753,ORL,Orlando Magic,ORL @ CHA,122,8,Regular Season
22018,1610612746,LAC,LA Clippers,0021801229,2019-04-10T00:00:00Z,LAC vs. UTA,143,6,1610612762,UTA,Utah Jazz,UTA @ LAC,137,-6,Regular Season
22018,1610612755,PHI,Philadelphia 76ers,0021801224,2019-04-10T00:00:00Z,PHI vs. CHI,125,16,1610612741,CHI,Chicago Bulls,CHI @ PHI,109,-16,Regular Season
22018,1610612743,DEN,Denver Nuggets,0021801228,2019-04-10T00:00:00Z,DEN vs. MIN,99,4,1610612750,MIN,Minnesota Timberwolves,MIN @ DEN,95,-4,Regular Season
22018,1610612757,POR,Portland Trail Blazers,0021801230,2019-04-10T00:00:00Z,POR vs. SAC,136,5,1610612758,SAC,Sacramento Kings,SAC @ POR,131,-5,Regular Season
22018,1610612749,MIL,Milwaukee Bucks,0021801226,2019-04-10T00:00:00Z,MIL vs. OKC,116,-11,1610612760,OKC,Oklahoma City Thunder,OKC @ MIL,127,11,Regular Season
22018,1610612763,MEM,Memphis Grizzlies,0021801225,2019-04-10T00:00:00Z,MEM vs. GSW,132,15,1610612744,GSW,Golden State Warriors,GSW @ MEM,117,-15,Regular Season
22018,1610612737,ATL,Atlanta Hawks,0021801220,2019-04-10T00:00:00Z,ATL vs. IND,134,-1,1610612754,IND,Indiana Pacers,IND @ ATL,135,1,Regular Season
42018,1610612744,GSW,Golden State Warriors,0041800141,2019-04-13T00:00:00Z,GSW vs. LAC,121,17,1610612746,LAC,LA Clippers,LAC @ GSW,104,-17,Playoffs
42018,1610612761,TOR,Toronto Raptors,0041800111,2019-04-13T00:00:00Z,TOR vs. ORL,101,-3,1610612753,ORL,Orlando Magic,ORL @ TOR,104,3,Playoffs
42018,1610612755,PHI,Philadelphia 76ers,0041800121,2019-04-13T00:00:00Z,PHI vs. BKN,102,-9,1610612751,BKN,Brooklyn Nets,BKN @ PHI,111,9,Playoffs
42018,1610612743,DEN,Denver Nuggets,0041800151,2019-04-13T00:00:00Z,DEN vs. SAS,96,-5,1610612759,SAS,San Antonio Spurs,SAS @ DEN,101,5,Playoffs
42018,1610612738,BOS,Boston Celtics,0041800131,2019-04-14T00:00:00Z,BOS vs. IND,84,10,1610612754,IND,Indiana Pacers,IND @ BOS,74,-10,Playoffs
42018,1610612757,POR,Portland Trail Blazers,0041800161,2019-04-14T00:00:00Z,POR vs. OKC,104,5,1610612760,OKC,Oklahoma City Thunder,OKC @ POR,99,-5,Playoffs
42018,1610612749,MIL,Milwaukee Bucks,0041800101,2019-04-14T00:00:00Z,MIL vs. DET,121,35,1610612765,DET,Detroit Pistons,DET @ MIL,86,-35,Playoffs
42018,1610612745,HOU,Houston Rockets,0041800171,2019-04-14T00:00:00Z,HOU vs. UTA,122,32,1610612762,UTA,Utah Jazz,UTA @ HOU,90,-32,Playoffs
42018,1610612744,GSW,Golden State Warriors,0041800142,2019-04-15T00:00:00Z,GSW vs. LAC,131,-4,1610612746,LAC,LA Clippers,LAC @ GSW,135,4,Playoffs
42018,1610612755,PHI,Philadelphia 76ers,0041800122,2019-04-15T00:00:00Z,PHI vs. BKN,145,22,1610612751,BKN,Brooklyn Nets,BKN @ PHI,123,-22,Playoffs
42018,1610612761,TOR,Toronto Raptors,0041800112,2019-04-16T00:00:00Z,TOR vs. ORL,111,29,1610612753,ORL,Orlando Magic,ORL @ TOR,82,-29,Playoffs
42018,1610612743,DEN,Denver Nuggets,0041800152,2019-04-16T00:00:00Z,DEN vs. SAS,114,9,1610612759,SAS,San Antonio Spurs,SAS @ DEN,105,-9,Playoffs
42018,1610612757,POR,Portland Trail Blazers,0041800162,2019-04-16T00:00:00Z,POR vs. OKC,114,20,1610612760,OKC,Oklahoma City Thunder,OKC @ POR,94,-20,Playoffs
42018,1610612738,BOS,Boston Celtics,0041800132,2019-04-17T00:00:00Z,BOS vs. IND,99,8,1610612754,IND,Indiana Pacers,IND @ BOS,91,-8,Playoffs
42018,1610612745,HOU,Houston Rockets,0041800172,2019-04-17T00:00:00Z,HOU vs. UTA,118,20,1610612762,UTA,Utah Jazz,UTA @ HOU,98,-20,Playoffs
42018,1610612749,MIL,Milwaukee Bucks,0041800102,2019-04-17T00:00:00Z,MIL vs. DET,120,21,1610612765,DET,Detroit Pistons,DET @ MIL,99,-21,Playoffs
42018,1610612746,LAC,LA Clippers,0041800143,2019-04-18T00:00:00Z,LAC vs. GSW,105,-27,1610612744,GSW,Golden State Warriors,GSW @ LAC,132,27,Playoffs
42018,1610612759,SAS,San Antonio Spurs,0041800153,2019-04-18T00:00:00Z,SAS vs. DEN,118,10,1610612743,DEN,Denver Nuggets,DEN @ SAS,108,-10,Playoffs
42018,1610612751,BKN,Brooklyn Nets,0041800123,2019-04-18T00:00:00Z,BKN vs. PHI,115,-16,1610612755,PHI,Philadelphia 76ers,PHI @ BKN,131,16,Playoffs
42018,1610612760,OKC,Oklahoma City Thunder,0041800163,2019-04-19T00:00:00Z,OKC vs. POR,120,12,1610612757,POR,Portland Trail Blazers,POR @ OKC,108,-12,Playoffs
42018,1610612753,ORL,Orlando Magic,0041800113,2019-04-19T00:00:00Z,ORL vs. TOR,93,-5,1610612761,TOR,Toronto Raptors,TOR @ ORL,98,5,Playoffs
42018,1610612754,IND,Indiana Pacers,0041800133,2019-04-19T00:00:00Z,IND vs. BOS,96,-8,1610612738,BOS,Boston Celtics,BOS @ IND,104,8,Playoffs
42018,1610612765,DET,Detroit Pistons,0041800103,2019-04-20T00:00:00Z,DET vs. MIL,103,-16,1610612749,MIL,Milwaukee Bucks,MIL @ DET,119,16,Playoffs
42018,1610612762,UTA,Utah Jazz,0041800173,2019-04-20T00:00:00Z,UTA vs. HOU,101,-3,1610612745,HOU,Houston Rockets,HOU @ UTA,104,3,Playoffs
42018,1610612759,SAS,San Antonio Spurs,0041800154,2019-04-20T00:00:00Z,SAS vs. DEN,103,-14,1610612743,DEN,Denver Nuggets,DEN @ SAS,117,14,Playoffs
42018,1610612751,BKN,Brooklyn Nets,0041800124,2019-04-20T00:00:00Z,BKN vs. PHI,108,-4,1610612755,PHI,Philadelphia 76ers,PHI @ BKN,112,4,Playoffs
42018,1610612754,IND,Indiana Pacers,0041800134,2019-04-21T00:00:00Z,IND vs. BOS,106,-4,1610612738,BOS,Boston Celtics,BOS @ IND,110,4,Playoffs
42018,1610612746,LAC,LA Clippers,0041800144,2019-04-21T00:00:00Z,LAC vs. GSW,105,-8,1610612744,GSW,Golden State Warriors,GSW @ LAC,113,8,Playoffs
42018,1610612753,ORL,Orlando Magic,0041800114,2019-04-21T00:00:00Z,ORL vs. TOR,85,-22,1610612761,TOR,Toronto Raptors,TOR @ ORL,107,22,Playoffs
42018,1610612760,OKC,Oklahoma City Thunder,0041800164,2019-04-21T00:00:00Z,OKC vs. POR,98,-13,1610612757,POR,Portland Trail Blazers,POR @ OKC,111,13,Playoffs
42018,1610612762,UTA,Utah Jazz,0041800174,2019-04-22T00:00:00Z,UTA vs. HOU,107,16,1610612745,HOU,Houston Rockets,HOU @ UTA,91,-16,Playoffs
42018,1610612765,DET,Detroit Pistons,0041800104,2019-04-22T00:00:00Z,DET vs. MIL,104,-23,1610612749,MIL,Milwaukee Bucks,MIL @ DET,127,23,Playoffs
42018,1610612761,TOR,Toronto Raptors,0041800115,2019-04-23T00:00:00Z,TOR vs. ORL,115,19,1610612753,ORL,Orlando Magic,ORL @ TOR,96,-19,Playoffs
42018,1610612755,PHI,Philadelphia 76ers,0041800125,2019-04-23T00:00:00Z,PHI vs. BKN,122,22,1610612751,BKN,Brooklyn Nets,BKN @ PHI,100,-22,Playoffs
42018,1610612757,POR,Portland Trail Blazers,0041800165,2019-04-23T00:00:00Z,POR vs. OKC,118,3,1610612760,OKC,Oklahoma City Thunder,OKC @ POR,115,-3,Playoffs
42018,1610612743,DEN,Denver Nuggets,0041800155,2019-04-23T00:00:00Z,DEN vs. SAS,108,18,1610612759,SAS,San Antonio Spurs,SAS @ DEN,90,-18,Playoffs
42018,1610612745,HOU,Houston Rockets,0041800175,2019-04-24T00:00:00Z,HOU vs. UTA,100,7,1610612762,UTA,Utah Jazz,UTA @ HOU,93,-7,Playoffs
42018,1610612744,GSW,Golden State Warriors,0041800145,2019-04-24T00:00:00Z,GSW vs. LAC,121,-8,1610612746,LAC,LA Clippers,LAC @ GSW,129,8,Playoffs
42018,1610612759,SAS,San Antonio Spurs,0041800156,2019-04-25T00:00:00Z,SAS vs. DEN,120,17,1610612743,DEN,Denver Nuggets,DEN @ SAS,103,-17,Playoffs
42018,1610612746,LAC,LA Clippers,0041800146,2019-04-26T00:00:00Z,LAC vs. GSW,110,-19,1610612744,GSW,Golden State Warriors,GSW @ LAC,129,19,Playoffs
42018,1610612761,TOR,Toronto Raptors,0041800211,2019-04-27T00:00:00Z,TOR vs. PHI,108,13,1610612755,PHI,Philadelphia 76ers,PHI @ TOR,95,-13,Playoffs
42018,1610612743,DEN,Denver Nuggets,0041800157,2019-04-27T00:00:00Z,DEN vs. SAS,90,4,1610612759,SAS,San Antonio Spurs,SAS @ DEN,86,-4,Playoffs
42018,1610612749,MIL,Milwaukee Bucks,0041800201,2019-04-28T00:00:00Z,MIL vs. BOS,90,-22,1610612738,BOS,Boston Celtics,BOS @ MIL,112,22,Playoffs
42018,1610612744,GSW,Golden State Warriors,0041800221,2019-04-28T00:00:00Z,GSW vs. HOU,104,4,1610612745,HOU,Houston Rockets,HOU @ GSW,100,-4,Playoffs
42018,1610612761,TOR,Toronto Raptors,0041800212,2019-04-29T00:00:00Z,TOR vs. PHI,89,-5,1610612755,PHI,Philadelphia 76ers,PHI @ TOR,94,5,Playoffs
42018,1610612743,DEN,Denver Nuggets,0041800231,2019-04-29T00:00:00Z,DEN vs. POR,121,8,1610612757,POR,Portland Trail Blazers,POR @ DEN,113,-8,Playoffs
42018,1610612744,GSW,Golden State Warriors,0041800222,2019-04-30T00:00:00Z,GSW vs. HOU,115,6,1610612745,HOU,Houston Rockets,HOU @ GSW,109,-6,Playoffs
42018,1610612749,MIL,Milwaukee Bucks,0041800202,2019-04-30T00:00:00Z,MIL vs. BOS,123,21,1610612738,BOS,Boston Celtics,BOS @ MIL,102,-21,Playoffs
42018,1610612743,DEN,Denver Nuggets,0041800232,2019-05-01T00:00:00Z,DEN vs. POR,90,-7,1610612757,POR,Portland Trail Blazers,POR @ DEN,97,7,Playoffs
42018,1610612755,PHI,Philadelphia 76ers,0041800213,2019-05-02T00:00:00Z,PHI vs. TOR,116,21,1610612761,TOR,Toronto Raptors,TOR @ PHI,95,-21,Playoffs
42018,1610612757,POR,Portland Trail Blazers,0041800233,2019-05-03T00:00:00Z,POR vs. DEN,140,3,1610612743,DEN,Denver Nuggets,DEN @ POR,137,-3,Playoffs
42018,1610612738,BOS,Boston Celtics,0041800203,2019-05-03T00:00:00Z,BOS vs. MIL,116,-7,1610612749,MIL,Milwaukee Bucks,MIL @ BOS,123,7,Playoffs
42018,1610612745,HOU,Houston Rockets,0041800223,2019-05-04T00:00:00Z,HOU vs. GSW,126,5,1610612744,GSW,Golden State Warriors,GSW @ HOU,121,-5,Playoffs
42018,1610612757,POR,Portland Trail Blazers,0041800234,2019-05-05T00:00:00Z,POR vs. DEN,112,-4,1610612743,DEN,Denver Nuggets,DEN @ POR,116,4,Playoffs
42018,1610612755,PHI,Philadelphia 76ers,0041800214,2019-05-05T00:00:00Z,PHI vs. TOR,96,-5,1610612761,TOR,Toronto Raptors,TOR @ PHI,101,5,Playoffs
42018,1610612738,BOS,Boston Celtics,0041800204,2019-05-06T00:00:00Z,BOS vs. MIL,101,-12,1610612749,MIL,Milwaukee Bucks,MIL @ BOS,113,12,Playoffs
42018,1610612745,HOU,Houston Rockets,0041800224,2019-05-06T00:00:00Z,HOU vs. GSW,112,4,1610612744,GSW,Golden State Warriors,GSW @ HOU,108,-4,Playoffs
42018,1610612761,TOR,Toronto Raptors,0041800215,2019-05-07T00:00:00Z,TOR vs. PHI,125,36,1610612755,PHI,Philadelphia 76ers,PHI @ TOR,89,-36,Playoffs
42018,1610612743,DEN,Denver Nuggets,0041800235,2019-05-07T00:00:00Z,DEN vs. POR,124,26,1610612757,POR,Portland Trail Blazers,POR @ DEN,98,-26,Playoffs
42018,1610612744,GSW,Golden State Warriors,0041800225,2019-05-08T00:00:00Z,GSW vs. HOU,104,5,1610612745,HOU,Houston Rockets,HOU @ GSW,99,-5,Playoffs
42018,1610612749,MIL,Milwaukee Bucks,0041800205,2019-05-08T00:00:00Z,MIL vs. BOS,116,25,1610612738,BOS,Boston Celtics,BOS @ MIL,91,-25,Playoffs
42018,1610612757,POR,Portland Trail Blazers,0041800236,2019-05-09T00:00:00Z,POR vs. DEN,119,11,1610612743,DEN,Denver Nuggets,DEN @ POR,108,-11,Playoffs
42018,1610612755,PHI,Philadelphia 76ers,0041800216,2019-05-09T00:00:00Z,PHI vs. TOR,112,11,1610612761,TOR,Toronto Raptors,TOR @ PHI,101,-11,Playoffs
42018,1610612745,HOU,Houston Rockets,0041800226,2019-05-10T00:00:00Z,HOU vs. GSW,113,-5,1610612744,GSW,Golden State Warriors,GSW @ HOU,118,5,Playoffs
42018,1610612761,TOR,Toronto Raptors,0041800217,2019-05-12T00:00:00Z,TOR vs. PHI,92,2,1610612755,PHI,Philadelphia 76ers,PHI @ TOR,90,-2,Playoffs
42018,1610612743,DEN,Denver Nuggets,0041800237,2019-05-12T00:00:00Z,DEN vs. POR,96,-4,1610612757,POR,Portland Trail Blazers,POR @ DEN,100,4,Playoffs
42018,1610612744,GSW,Golden State Warriors,0041800311,2019-05-14T00:00:00Z,GSW vs. POR,116,22,1610612757,POR,Portland Trail Blazers,POR @ GSW,94,-22,Playoffs
42018,1610612749,MIL,Milwaukee Bucks,0041800301,2019-05-15T00:00:00Z,MIL vs. TOR,108,8,1610612761,TOR,Toronto Raptors,TOR @ MIL,100,-8,Playoffs
42018,1610612744,GSW,Golden State Warriors,0041800312,2019-05-16T00:00:00Z,GSW vs. POR,114,3,1610612757,POR,Portland Trail Blazers,POR @ GSW,111,-3,Playoffs
42018,1610612749,MIL,Milwaukee Bucks,0041800302,2019-05-17T00:00:00Z,MIL vs. TOR,125,22,1610612761,TOR,Toronto Raptors,TOR @ MIL,103,-22,Playoffs
42018,1610612757,POR,Portland Trail Blazers,0041800313,2019-05-18T00:00:00Z,POR vs. GSW,99,-11,1610612744,GSW,Golden State Warriors,GSW @ POR,110,11,Playoffs
42018,1610612761,TOR,Toronto Raptors,0041800303,2019-05-19T00:00:00Z,TOR vs. MIL,118,6,1610612749,MIL,Milwaukee Bucks,MIL @ TOR,112,-6,Playoffs
42018,1610612757,POR,Portland Trail Blazers,0041800314,2019-05-20T00:00:00Z,POR vs. GSW,117,-2,1610612744,GSW,Golden State Warriors,GSW @ POR,119,2,Playoffs
42018,1610612761,TOR,Toronto Raptors,0041800304,2019-05-21T00:00:00Z,TOR vs. MIL,120,18,1610612749,MIL,Milwaukee Bucks,MIL @ TOR,102,-18,Playoffs
42018,1610612749,MIL,Milwaukee Bucks,0041800305,2019-05-23T00:00:00Z,MIL vs. TOR,99,-6,1610612761,TOR,Toronto Raptors,TOR @ MIL,105,6,Playoffs
42018,1610612761,TOR,Toronto Raptors,0041800306,2019-05-25T00:00:00Z,TOR vs. MIL,100,6,1610612749,MIL,Milwaukee Bucks,MIL @ TOR,94,-6,Playoffs
42018,1610612761,TOR,Toronto Raptors,0041800401,2019-05-30T00:00:00Z,TOR vs. GSW,118,9,1610612744,GSW,Golden State Warriors,GSW @ TOR,109,-9,Playoffs
42018,1610612761,TOR,Toronto Raptors,0041800402,2019-06-02T00:00:00Z,TOR vs. GSW,104,-5,1610612744,GSW,Golden State Warriors,GSW @ TOR,109,5,Playoffs
42018,1610612744,GSW,Golden State Warriors,0041800403,2019-06-05T00:00:00Z,GSW vs. TOR,109,-14,1610612761,TOR,Toronto Raptors,TOR @ GSW,123,14,Playoffs
42018,1610612744,GSW,Golden State Warriors,0041800404,2019-06-07T00:00:00Z,GSW vs. TOR,92,-13,1610612761,TOR,Toronto Raptors,TOR @ GSW,105,13,Playoffs
42018,1610612761,TOR,Toronto Raptors,0041800405,2019-06-10T00:00:00Z,TOR vs. GSW,105,-1,1610612744,GSW,Golden State Warriors,GSW @ TOR,106,1,Playoffs
42018,1610612744,GSW,Golden State Warriors,0041800406,2019-06-13T00:00:00Z,GSW vs. TOR,110,-4,1610612761,TOR,Toronto Raptors,TOR @ GSW,114,4,Playoffs
32018,1610616833,GNS,Team Giannis,0031800001,2019-02-17T00:00:00Z,GNS vs. LBN,164,-14,1610616834,LBN,Team LeBron,LBN @ GNS,178,14,All-Star
32018,1610616833,GNS,Team Giannis,0031800001,2019-02-17T00:00:00Z,GNS vs. LBN,164,-14,1610616834,LBN,Team LeBron,LBN @ GNS,178,14,All Star
22019,1610612746,LAC,LA Clippers,0021900002,2019-10-22T00:00:00Z,LAC vs. LAL,112,10,1610612747,LAL,Los Angeles Lakers,LAL @ LAC,102,-10,Regular Season
22019,1610612761,TOR,Toronto Raptors,0021900001,2019-10-22T00:00:00Z,TOR vs. NOP,130,8,1610612740,NOP,New Orleans Pelicans,NOP @ TOR,122,-8,Regular Season
22019,1610612754,IND,Indiana Pacers,0021900004,2019-10-23T00:00:00Z,IND vs. DET,110,-9,1610612765,DET,Detroit Pistons,DET @ IND,119,9,Regular Season
22019,1610612748,MIA,Miami Heat,0021900007,2019-10-23T00:00:00Z,MIA vs. MEM,120,19,1610612763,MEM,Memphis Grizzlies,MEM @ MIA,101,-19,Regular Season
22019,1610612755,PHI,Philadelphia 76ers,0021900008,2019-10-23T00:00:00Z,PHI vs. BOS,107,14,1610612738,BOS,Boston Celtics,BOS @ PHI,93,-14,Regular Season
22019,1610612766,CHA,Charlotte Hornets,0021900003,2019-10-23T00:00:00Z,CHA vs. CHI,126,1,1610612741,CHI,Chicago Bulls,CHI @ CHA,125,-1,Regular Season
22019,1610612753,ORL,Orlando Magic,0021900005,2019-10-23T00:00:00Z,ORL vs. CLE,94,9,1610612739,CLE,Cleveland Cavaliers,CLE @ ORL,85,-9,Regular Season
22019,1610612762,UTA,Utah Jazz,0021900011,2019-10-23T00:00:00Z,UTA vs. OKC,100,5,1610612760,OKC,Oklahoma City Thunder,OKC @ UTA,95,-5,Regular Season
22019,1610612756,PHX,Phoenix Suns,0021900012,2019-10-23T00:00:00Z,PHX vs. SAC,124,29,1610612758,SAC,Sacramento Kings,SAC @ PHX,95,-29,Regular Season
22019,1610612757,POR,Portland Trail Blazers,0021900013,2019-10-23T00:00:00Z,POR vs. DEN,100,-8,1610612743,DEN,Denver Nuggets,DEN @ POR,108,8,Regular Season
22019,1610612742,DAL,Dallas Mavericks,0021900009,2019-10-23T00:00:00Z,DAL vs. WAS,108,8,1610612764,WAS,Washington Wizards,WAS @ DAL,100,-8,Regular Season
22019,1610612751,BKN,Brooklyn Nets,0021900006,2019-10-23T00:00:00Z,BKN vs. MIN,126,-1,1610612750,MIN,Minnesota Timberwolves,MIN @ BKN,127,1,Regular Season
22019,1610612759,SAS,San Antonio Spurs,0021900010,2019-10-23T00:00:00Z,SAS vs. NYK,120,9,1610612752,NYK,New York Knicks,NYK @ SAS,111,-9,Regular Season
22019,1610612765,DET,Detroit Pistons,0021900014,2019-10-24T00:00:00Z,DET vs. ATL,100,-17,1610612737,ATL,Atlanta Hawks,ATL @ DET,117,17,Regular Season
22019,1610612745,HOU,Houston Rockets,0021900015,2019-10-24T00:00:00Z,HOU vs. MIL,111,-6,1610612749,MIL,Milwaukee Bucks,MIL @ HOU,117,6,Regular Season
22019,1610612744,GSW,Golden State Warriors,0021900016,2019-10-24T00:00:00Z,GSW vs. LAC,122,-19,1610612746,LAC,LA Clippers,LAC @ GSW,141,19,Regular Season
22019,1610612760,OKC,Oklahoma City Thunder,0021900022,2019-10-25T00:00:00Z,OKC vs. WAS,85,-12,1610612764,WAS,Washington Wizards,WAS @ OKC,97,12,Regular Season
22019,1610612758,SAC,Sacramento Kings,0021900024,2019-10-25T00:00:00Z,SAC vs. POR,112,-10,1610612757,POR,Portland Trail Blazers,POR @ SAC,122,10,Regular Season
22019,1610612747,LAL,Los Angeles Lakers,0021900025,2019-10-25T00:00:00Z,LAL vs. UTA,95,9,1610612762,UTA,Utah Jazz,UTA @ LAL,86,-9,Regular Season
22019,1610612751,BKN,Brooklyn Nets,0021900019,2019-10-25T00:00:00Z,BKN vs. NYK,113,4,1610612752,NYK,New York Knicks,NYK @ BKN,109,-4,Regular Season
22019,1610612738,BOS,Boston Celtics,0021900017,2019-10-25T00:00:00Z,BOS vs. TOR,112,6,1610612761,TOR,Toronto Raptors,TOR @ BOS,106,-6,Regular Season
22019,1610612763,MEM,Memphis Grizzlies,0021900020,2019-10-25T00:00:00Z,MEM vs. CHI,102,-8,1610612741,CHI,Chicago Bulls,CHI @ MEM,110,8,Regular Season
22019,1610612766,CHA,Charlotte Hornets,0021900018,2019-10-25T00:00:00Z,CHA vs. MIN,99,-22,1610612750,MIN,Minnesota Timberwolves,MIN @ CHA,121,22,Regular Season
22019,1610612740,NOP,New Orleans Pelicans,0021900021,2019-10-25T00:00:00Z,NOP vs. DAL,116,-7,1610612742,DAL,Dallas Mavericks,DAL @ NOP,123,7,Regular Season
22019,1610612743,DEN,Denver Nuggets,0021900023,2019-10-25T00:00:00Z,DEN vs. PHX,108,1,1610612756,PHX,Phoenix Suns,PHX @ DEN,107,-1,Regular Season
22019,1610612745,HOU,Houston Rockets,0021900032,2019-10-26T00:00:00Z,HOU vs. NOP,126,3,1610612740,NOP,New Orleans Pelicans,NOP @ HOU,123,-3,Regular Season
22019,1610612749,MIL,Milwaukee Bucks,0021900026,2019-10-26T00:00:00Z,MIL vs. MIA,126,-5,1610612748,MIA,Miami Heat,MIA @ MIL,131,5,Regular Season
22019,1610612737,ATL,Atlanta Hawks,0021900028,2019-10-26T00:00:00Z,ATL vs. ORL,103,4,1610612753,ORL,Orlando Magic,ORL @ ATL,99,-4,Regular Season
22019,1610612741,CHI,Chicago Bulls,0021900031,2019-10-26T00:00:00Z,CHI vs. TOR,84,-24,1610612761,TOR,Toronto Raptors,TOR @ CHI,108,24,Regular Season
22019,1610612765,DET,Detroit Pistons,0021900027,2019-10-26T00:00:00Z,DET vs. PHI,111,-6,1610612755,PHI,Philadelphia 76ers,PHI @ DET,117,6,Regular Season
22019,1610612762,UTA,Utah Jazz,0021900034,2019-10-26T00:00:00Z,UTA vs. SAC,113,32,1610612758,SAC,Sacramento Kings,SAC @ UTA,81,-32,Regular Season
22019,1610612756,PHX,Phoenix Suns,0021900035,2019-10-26T00:00:00Z,PHX vs. LAC,130,8,1610612746,LAC,LA Clippers,LAC @ PHX,122,-8,Regular Season
22019,1610612759,SAS,San Antonio Spurs,0021900033,2019-10-26T00:00:00Z,SAS vs. WAS,124,2,1610612764,WAS,Washington Wizards,WAS @ SAS,122,-2,Regular Season
22019,1610612739,CLE,Cleveland Cavaliers,0021900030,2019-10-26T00:00:00Z,CLE vs. IND,110,11,1610612754,IND,Indiana Pacers,IND @ CLE,99,-11,Regular Season
22019,1610612752,NYK,New York Knicks,0021900029,2019-10-26T00:00:00Z,NYK vs. BOS,95,-23,1610612738,BOS,Boston Celtics,BOS @ NYK,118,23,Regular Season
22019,1610612750,MIN,Minnesota Timberwolves,0021900039,2019-10-27T00:00:00Z,MIN vs. MIA,116,7,1610612748,MIA,Miami Heat,MIA @ MIN,109,-7,Regular Season
22019,1610612763,MEM,Memphis Grizzlies,0021900037,2019-10-27T00:00:00Z,MEM vs. BKN,134,1,1610612751,BKN,Brooklyn Nets,BKN @ MEM,133,-1,Regular Season
22019,1610612760,OKC,Oklahoma City Thunder,0021900036,2019-10-27T00:00:00Z,OKC vs. GSW,120,28,1610612744,GSW,Golden State Warriors,GSW @ OKC,92,-28,Regular Season
22019,1610612742,DAL,Dallas Mavericks,0021900038,2019-10-27T00:00:00Z,DAL vs. POR,119,-2,1610612757,POR,Portland Trail Blazers,POR @ DAL,121,2,Regular Season
22019,1610612747,LAL,Los Angeles Lakers,0021900040,2019-10-27T00:00:00Z,LAL vs. CHA,120,19,1610612766,CHA,Charlotte Hornets,CHA @ LAL,101,-19,Regular Season
22019,1610612745,HOU,Houston Rockets,0021900045,2019-10-28T00:00:00Z,HOU vs. OKC,116,4,1610612760,OKC,Oklahoma City Thunder,OKC @ HOU,112,-4,Regular Season
22019,1610612756,PHX,Phoenix Suns,0021900049,2019-10-28T00:00:00Z,PHX vs. UTA,95,-1,1610612762,UTA,Utah Jazz,UTA @ PHX,96,1,Regular Season
22019,1610612761,TOR,Toronto Raptors,0021900044,2019-10-28T00:00:00Z,TOR vs. ORL,104,9,1610612753,ORL,Orlando Magic,ORL @ TOR,95,-9,Regular Season
22019,1610612740,NOP,New Orleans Pelicans,0021900047,2019-10-28T00:00:00Z,NOP vs. GSW,123,-11,1610612744,GSW,Golden State Warriors,GSW @ NOP,134,11,Regular Season
22019,1610612765,DET,Detroit Pistons,0021900041,2019-10-28T00:00:00Z,DET vs. IND,96,2,1610612754,IND,Indiana Pacers,IND @ DET,94,-2,Regular Season
22019,1610612758,SAC,Sacramento Kings,0021900050,2019-10-28T00:00:00Z,SAC vs. DEN,94,-7,1610612743,DEN,Denver Nuggets,DEN @ SAC,101,7,Regular Season
22019,1610612752,NYK,New York Knicks,0021900042,2019-10-28T00:00:00Z,NYK vs. CHI,105,7,1610612741,CHI,Chicago Bulls,CHI @ NYK,98,-7,Regular Season
22019,1610612759,SAS,San Antonio Spurs,0021900048,2019-10-28T00:00:00Z,SAS vs. POR,113,3,1610612757,POR,Portland Trail Blazers,POR @ SAS,110,-3,Regular Season
22019,1610612749,MIL,Milwaukee Bucks,0021900046,2019-10-28T00:00:00Z,MIL vs. CLE,129,17,1610612739,CLE,Cleveland Cavaliers,CLE @ MIL,112,-17,Regular Season
22019,1610612746,LAC,LA Clippers,0021900051,2019-10-28T00:00:00Z,LAC vs. CHA,111,15,1610612766,CHA,Charlotte Hornets,CHA @ LAC,96,-15,Regular Season
22019,1610612737,ATL,Atlanta Hawks,0021900043,2019-10-28T00:00:00Z,ATL vs. PHI,103,-2,1610612755,PHI,Philadelphia 76ers,PHI @ ATL,105,2,Regular Season
22019,1610612747,LAL,Los Angeles Lakers,0021900054,2019-10-29T00:00:00Z,LAL vs. MEM,120,29,1610612763,MEM,Memphis Grizzlies,MEM @ LAL,91,-29,Regular Season
22019,1610612748,MIA,Miami Heat,0021900052,2019-10-29T00:00:00Z,MIA vs. ATL,112,15,1610612737,ATL,Atlanta Hawks,ATL @ MIA,97,-15,Regular Season
22019,1610612743,DEN,Denver Nuggets,0021900053,2019-10-29T00:00:00Z,DEN vs. DAL,106,-3,1610612742,DAL,Dallas Mavericks,DAL @ DEN,109,3,Regular Season
22019,1610612738,BOS,Boston Celtics,0021900058,2019-10-30T00:00:00Z,BOS vs. MIL,116,11,1610612749,MIL,Milwaukee Bucks,MIL @ BOS,105,-11,Regular Season
22019,1610612751,BKN,Brooklyn Nets,0021900059,2019-10-30T00:00:00Z,BKN vs. IND,108,-10,1610612754,IND,Indiana Pacers,IND @ BKN,118,10,Regular Season
22019,1610612764,WAS,Washington Wizards,0021900061,2019-10-30T00:00:00Z,WAS vs. HOU,158,-1,1610612745,HOU,Houston Rockets,HOU @ WAS,159,1,Regular Season
22019,1610612744,GSW,Golden State Warriors,0021900065,2019-10-30T00:00:00Z,GSW vs. PHX,110,-11,1610612756,PHX,Phoenix Suns,PHX @ GSW,121,11,Regular Season
22019,1610612762,UTA,Utah Jazz,0021900063,2019-10-30T00:00:00Z,UTA vs. LAC,110,14,1610612746,LAC,LA Clippers,LAC @ UTA,96,-14,Regular Season
22019,1610612761,TOR,Toronto Raptors,0021900060,2019-10-30T00:00:00Z,TOR vs. DET,125,12,1610612765,DET,Detroit Pistons,DET @ TOR,113,-12,Regular Season
22019,1610612760,OKC,Oklahoma City Thunder,0021900062,2019-10-30T00:00:00Z,OKC vs. POR,99,-3,1610612757,POR,Portland Trail Blazers,POR @ OKC,102,3,Regular Season
22019,1610612753,ORL,Orlando Magic,0021900056,2019-10-30T00:00:00Z,ORL vs. NYK,95,12,1610612752,NYK,New York Knicks,NYK @ ORL,83,-12,Regular Season
22019,1610612739,CLE,Cleveland Cavaliers,0021900055,2019-10-30T00:00:00Z,CLE vs. CHI,117,6,1610612741,CHI,Chicago Bulls,CHI @ CLE,111,-6,Regular Season
22019,1610612755,PHI,Philadelphia 76ers,0021900057,2019-10-30T00:00:00Z,PHI vs. MIN,117,22,1610612750,MIN,Minnesota Timberwolves,MIN @ PHI,95,-22,Regular Season
22019,1610612758,SAC,Sacramento Kings,0021900064,2019-10-30T00:00:00Z,SAC vs. CHA,111,-7,1610612766,CHA,Charlotte Hornets,CHA @ SAC,118,7,Regular Season
22019,1610612740,NOP,New Orleans Pelicans,0021900067,2019-10-31T00:00:00Z,NOP vs. DEN,122,15,1610612743,DEN,Denver Nuggets,DEN @ NOP,107,-15,Regular Season
22019,1610612737,ATL,Atlanta Hawks,0021900066,2019-10-31T00:00:00Z,ATL vs. MIA,97,-9,1610612748,MIA,Miami Heat,MIA @ ATL,106,9,Regular Season
22019,1610612746,LAC,LA Clippers,0021900068,2019-10-31T00:00:00Z,LAC vs. SAS,103,6,1610612759,SAS,San Antonio Spurs,SAS @ LAC,97,-6,Regular Season
22019,1610612751,BKN,Brooklyn Nets,0021900069,2019-11-01T00:00:00Z,BKN vs. HOU,123,7,1610612745,HOU,Houston Rockets,HOU @ BKN,116,-7,Regular Season
22019,1610612758,SAC,Sacramento Kings,0021900075,2019-11-01T00:00:00Z,SAC vs. UTA,102,1,1610612762,UTA,Utah Jazz,UTA @ SAC,101,-1,Regular Season
22019,1610612753,ORL,Orlando Magic,0021900071,2019-11-01T00:00:00Z,ORL vs. MIL,91,-32,1610612749,MIL,Milwaukee Bucks,MIL @ ORL,123,32,Regular Season
22019,1610612754,IND,Indiana Pacers,0021900070,2019-11-01T00:00:00Z,IND vs. CLE,102,7,1610612739,CLE,Cleveland Cavaliers,CLE @ IND,95,-7,Regular Season
22019,1610612741,CHI,Chicago Bulls,0021900073,2019-11-01T00:00:00Z,CHI vs. DET,112,6,1610612765,DET,Detroit Pistons,DET @ CHI,106,-6,Regular Season
22019,1610612742,DAL,Dallas Mavericks,0021900074,2019-11-01T00:00:00Z,DAL vs. LAL,110,-9,1610612747,LAL,Los Angeles Lakers,LAL @ DAL,119,9,Regular Season
22019,1610612738,BOS,Boston Celtics,0021900072,2019-11-01T00:00:00Z,BOS vs. NYK,104,2,1610612752,NYK,New York Knicks,NYK @ BOS,102,-2,Regular Season
22019,1610612744,GSW,Golden State Warriors,0021900076,2019-11-01T00:00:00Z,GSW vs. SAS,110,-17,1610612759,SAS,San Antonio Spurs,SAS @ GSW,127,17,Regular Season
22019,1610612760,OKC,Oklahoma City Thunder,0021900077,2019-11-02T00:00:00Z,OKC vs. NOP,115,11,1610612740,NOP,New Orleans Pelicans,NOP @ OKC,104,-11,Regular Season
22019,1610612764,WAS,Washington Wizards,0021900080,2019-11-02T00:00:00Z,WAS vs. MIN,109,-22,1610612750,MIN,Minnesota Timberwolves,MIN @ WAS,131,22,Regular Season
22019,1610612744,GSW,Golden State Warriors,0021900083,2019-11-02T00:00:00Z,GSW vs. CHA,87,-6,1610612766,CHA,Charlotte Hornets,CHA @ GSW,93,6,Regular Season
22019,1610612763,MEM,Memphis Grizzlies,0021900081,2019-11-02T00:00:00Z,MEM vs. PHX,105,-9,1610612756,PHX,Phoenix Suns,PHX @ MEM,114,9,Regular Season
22019,1610612753,ORL,Orlando Magic,0021900079,2019-11-02T00:00:00Z,ORL vs. DEN,87,-4,1610612743,DEN,Denver Nuggets,DEN @ ORL,91,4,Regular Season
22019,1610612757,POR,Portland Trail Blazers,0021900084,2019-11-02T00:00:00Z,POR vs. PHI,128,-1,1610612755,PHI,Philadelphia 76ers,PHI @ POR,129,1,Regular Season
22019,1610612749,MIL,Milwaukee Bucks,0021900082,2019-11-02T00:00:00Z,MIL vs. TOR,115,10,1610612761,TOR,Toronto Raptors,TOR @ MIL,105,-10,Regular Season
22019,1610612765,DET,Detroit Pistons,0021900078,2019-11-02T00:00:00Z,DET vs. BKN,113,4,1610612751,BKN,Brooklyn Nets,BKN @ DET,109,-4,Regular Season
22019,1610612759,SAS,San Antonio Spurs,0021900088,2019-11-03T00:00:00Z,SAS vs. LAL,96,-7,1610612747,LAL,Los Angeles Lakers,LAL @ SAS,103,7,Regular Season
22019,1610612746,LAC,LA Clippers,0021900090,2019-11-03T00:00:00Z,LAC vs. UTA,105,11,1610612762,UTA,Utah Jazz,UTA @ LAC,94,-11,Regular Season
22019,1610612748,MIA,Miami Heat,0021900086,2019-11-03T00:00:00Z,MIA vs. HOU,129,29,1610612745,HOU,Houston Rockets,HOU @ MIA,100,-29,Regular Season
22019,1610612739,CLE,Cleveland Cavaliers,0021900089,2019-11-03T00:00:00Z,CLE vs. DAL,111,-20,1610612742,DAL,Dallas Mavericks,DAL @ CLE,131,20,Regular Season
22019,1610612754,IND,Indiana Pacers,0021900085,2019-11-03T00:00:00Z,IND vs. CHI,108,13,1610612741,CHI,Chicago Bulls,CHI @ IND,95,-13,Regular Season
22019,1610612752,NYK,New York Knicks,0021900087,2019-11-03T00:00:00Z,NYK vs. SAC,92,-21,1610612758,SAC,Sacramento Kings,SAC @ NYK,113,21,Regular Season
22019,1610612744,GSW,Golden State Warriors,0021900096,2019-11-04T00:00:00Z,GSW vs. POR,127,9,1610612757,POR,Portland Trail Blazers,POR @ GSW,118,-9,Regular Season
22019,1610612750,MIN,Minnesota Timberwolves,0021900094,2019-11-04T00:00:00Z,MIN vs. MIL,106,-28,1610612749,MIL,Milwaukee Bucks,MIL @ MIN,134,28,Regular Season
22019,1610612764,WAS,Washington Wizards,0021900091,2019-11-04T00:00:00Z,WAS vs. DET,115,16,1610612765,DET,Detroit Pistons,DET @ WAS,99,-16,Regular Season
22019,1610612751,BKN,Brooklyn Nets,0021900092,2019-11-04T00:00:00Z,BKN vs. NOP,135,10,1610612740,NOP,New Orleans Pelicans,NOP @ BKN,125,-10,Regular Season
22019,1610612763,MEM,Memphis Grizzlies,0021900093,2019-11-04T00:00:00Z,MEM vs. HOU,100,-7,1610612745,HOU,Houston Rockets,HOU @ MEM,107,7,Regular Season
22019,1610612756,PHX,Phoenix Suns,0021900095,2019-11-04T00:00:00Z,PHX vs. PHI,114,5,1610612755,PHI,Philadelphia 76ers,PHI @ PHX,109,-5,Regular Season
22019,1610612741,CHI,Chicago Bulls,0021900100,2019-11-05T00:00:00Z,CHI vs. LAL,112,-6,1610612747,LAL,Los Angeles Lakers,LAL @ CHI,118,6,Regular Season
22019,1610612766,CHA,Charlotte Hornets,0021900097,2019-11-05T00:00:00Z,CHA vs. IND,122,2,1610612754,IND,Indiana Pacers,IND @ CHA,120,-2,Regular Season
22019,1610612760,OKC,Oklahoma City Thunder,0021900101,2019-11-05T00:00:00Z,OKC vs. ORL,102,8,1610612753,ORL,Orlando Magic,ORL @ OKC,94,-8,Regular Season
22019,1610612737,ATL,Atlanta Hawks,0021900099,2019-11-05T00:00:00Z,ATL vs. SAS,108,8,1610612759,SAS,San Antonio Spurs,SAS @ ATL,100,-8,Regular Season
22019,1610612743,DEN,Denver Nuggets,0021900102,2019-11-05T00:00:00Z,DEN vs. MIA,109,20,1610612748,MIA,Miami Heat,MIA @ DEN,89,-20,Regular Season
22019,1610612739,CLE,Cleveland Cavaliers,0021900098,2019-11-05T00:00:00Z,CLE vs. BOS,113,-6,1610612738,BOS,Boston Celtics,BOS @ CLE,119,6,Regular Season
22019,1610612754,IND,Indiana Pacers,0021900104,2019-11-06T00:00:00Z,IND vs. WAS,121,15,1610612764,WAS,Washington Wizards,WAS @ IND,106,-15,Regular Season
22019,1610612763,MEM,Memphis Grizzlies,0021900108,2019-11-06T00:00:00Z,MEM vs. MIN,137,16,1610612750,MIN,Minnesota Timberwolves,MIN @ MEM,121,-16,Regular Season
22019,1610612742,DAL,Dallas Mavericks,0021900109,2019-11-06T00:00:00Z,DAL vs. ORL,107,1,1610612753,ORL,Orlando Magic,ORL @ DAL,106,-1,Regular Season
22019,1610612745,HOU,Houston Rockets,0021900107,2019-11-06T00:00:00Z,HOU vs. GSW,129,17,1610612744,GSW,Golden State Warriors,GSW @ HOU,112,-17,Regular Season
22019,1610612746,LAC,LA Clippers,0021900111,2019-11-06T00:00:00Z,LAC vs. MIL,124,-5,1610612749,MIL,Milwaukee Bucks,MIL @ LAC,129,5,Regular Season
22019,1610612737,ATL,Atlanta Hawks,0021900105,2019-11-06T00:00:00Z,ATL vs. CHI,93,-20,1610612741,CHI,Chicago Bulls,CHI @ ATL,113,20,Regular Season
22019,1610612765,DET,Detroit Pistons,0021900103,2019-11-06T00:00:00Z,DET vs. NYK,122,20,1610612752,NYK,New York Knicks,NYK @ DET,102,-20,Regular Season
22019,1610612762,UTA,Utah Jazz,0021900110,2019-11-06T00:00:00Z,UTA vs. PHI,106,2,1610612755,PHI,Philadelphia 76ers,PHI @ UTA,104,-2,Regular Season
22019,1610612761,TOR,Toronto Raptors,0021900106,2019-11-06T00:00:00Z,TOR vs. SAC,124,4,1610612758,SAC,Sacramento Kings,SAC @ TOR,120,-4,Regular Season
22019,1610612759,SAS,San Antonio Spurs,0021900113,2019-11-07T00:00:00Z,SAS vs. OKC,121,9,1610612760,OKC,Oklahoma City Thunder,OKC @ SAS,112,-9,Regular Season
22019,1610612766,CHA,Charlotte Hornets,0021900112,2019-11-07T00:00:00Z,CHA vs. BOS,87,-21,1610612738,BOS,Boston Celtics,BOS @ CHA,108,21,Regular Season
22019,1610612746,LAC,LA Clippers,0021900115,2019-11-07T00:00:00Z,LAC vs. POR,107,6,1610612757,POR,Portland Trail Blazers,POR @ LAC,101,-6,Regular Season
22019,1610612756,PHX,Phoenix Suns,0021900114,2019-11-07T00:00:00Z,PHX vs. MIA,108,-16,1610612748,MIA,Miami Heat,MIA @ PHX,124,16,Regular Season
22019,1610612764,WAS,Washington Wizards,0021900118,2019-11-08T00:00:00Z,WAS vs. CLE,100,-13,1610612739,CLE,Cleveland Cavaliers,CLE @ WAS,113,13,Regular Season
22019,1610612757,POR,Portland Trail Blazers,0021900125,2019-11-08T00:00:00Z,POR vs. BKN,115,-4,1610612751,BKN,Brooklyn Nets,BKN @ POR,119,4,Regular Season
22019,1610612750,MIN,Minnesota Timberwolves,0021900120,2019-11-08T00:00:00Z,MIN vs. GSW,125,6,1610612744,GSW,Golden State Warriors,GSW @ MIN,119,-6,Regular Season
22019,1610612742,DAL,Dallas Mavericks,0021900122,2019-11-08T00:00:00Z,DAL vs. NYK,102,-4,1610612752,NYK,New York Knicks,NYK @ DAL,106,4,Regular Season
22019,1610612753,ORL,Orlando Magic,0021900117,2019-11-08T00:00:00Z,ORL vs. MEM,118,32,1610612763,MEM,Memphis Grizzlies,MEM @ ORL,86,-32,Regular Season
22019,1610612740,NOP,New Orleans Pelicans,0021900121,2019-11-08T00:00:00Z,NOP vs. TOR,104,-18,1610612761,TOR,Toronto Raptors,TOR @ NOP,122,18,Regular Season
22019,1610612737,ATL,Atlanta Hawks,0021900119,2019-11-08T00:00:00Z,ATL vs. SAC,109,-12,1610612758,SAC,Sacramento Kings,SAC @ ATL,121,12,Regular Season
22019,1610612754,IND,Indiana Pacers,0021900116,2019-11-08T00:00:00Z,IND vs. DET,112,6,1610612765,DET,Detroit Pistons,DET @ IND,106,-6,Regular Season
22019,1610612747,LAL,Los Angeles Lakers,0021900126,2019-11-08T00:00:00Z,LAL vs. MIA,95,15,1610612748,MIA,Miami Heat,MIA @ LAL,80,-15,Regular Season
22019,1610612743,DEN,Denver Nuggets,0021900123,2019-11-08T00:00:00Z,DEN vs. PHI,100,3,1610612755,PHI,Philadelphia 76ers,PHI @ DEN,97,-3,Regular Season
22019,1610612762,UTA,Utah Jazz,0021900124,2019-11-08T00:00:00Z,UTA vs. MIL,103,3,1610612749,MIL,Milwaukee Bucks,MIL @ UTA,100,-3,Regular Season
22019,1610612763,MEM,Memphis Grizzlies,0021900130,2019-11-09T00:00:00Z,MEM vs. DAL,122,-16,1610612742,DAL,Dallas Mavericks,DAL @ MEM,138,16,Regular Season
22019,1610612760,OKC,Oklahoma City Thunder,0021900131,2019-11-09T00:00:00Z,OKC vs. GSW,114,6,1610612744,GSW,Golden State Warriors,GSW @ OKC,108,-6,Regular Season
22019,1610612759,SAS,San Antonio Spurs,0021900127,2019-11-09T00:00:00Z,SAS vs. BOS,115,-20,1610612738,BOS,Boston Celtics,BOS @ SAS,135,20,Regular Season
22019,1610612766,CHA,Charlotte Hornets,0021900128,2019-11-09T00:00:00Z,CHA vs. NOP,110,-5,1610612740,NOP,New Orleans Pelicans,NOP @ CHA,115,5,Regular Season
22019,1610612741,CHI,Chicago Bulls,0021900129,2019-11-09T00:00:00Z,CHI vs. HOU,94,-23,1610612745,HOU,Houston Rockets,HOU @ CHI,117,23,Regular Season
22019,1610612753,ORL,Orlando Magic,0021900133,2019-11-10T00:00:00Z,ORL vs. IND,102,-7,1610612754,IND,Indiana Pacers,IND @ ORL,109,7,Regular Season
22019,1610612750,MIN,Minnesota Timberwolves,0021900132,2019-11-10T00:00:00Z,MIN vs. DEN,98,-2,1610612743,DEN,Denver Nuggets,DEN @ MIN,100,2,Regular Season
22019,1610612752,NYK,New York Knicks,0021900136,2019-11-10T00:00:00Z,NYK vs. CLE,87,-21,1610612739,CLE,Cleveland Cavaliers,CLE @ NYK,108,21,Regular Season
22019,1610612755,PHI,Philadelphia 76ers,0021900134,2019-11-10T00:00:00Z,PHI vs. CHA,114,8,1610612766,CHA,Charlotte Hornets,CHA @ PHI,106,-8,Regular Season
22019,1610612757,POR,Portland Trail Blazers,0021900138,2019-11-10T00:00:00Z,POR vs. ATL,124,11,1610612737,ATL,Atlanta Hawks,ATL @ POR,113,-11,Regular Season
22019,1610612760,OKC,Oklahoma City Thunder,0021900135,2019-11-10T00:00:00Z,OKC vs. MIL,119,-2,1610612749,MIL,Milwaukee Bucks,MIL @ OKC,121,2,Regular Season
22019,1610612756,PHX,Phoenix Suns,0021900137,2019-11-10T00:00:00Z,PHX vs. BKN,138,26,1610612751,BKN,Brooklyn Nets,BKN @ PHX,112,-26,Regular Season
22019,1610612747,LAL,Los Angeles Lakers,0021900139,2019-11-10T00:00:00Z,LAL vs. TOR,104,-9,1610612761,TOR,Toronto Raptors,TOR @ LAL,113,9,Regular Season
22019,1610612746,LAC,LA Clippers,0021900145,2019-11-11T00:00:00Z,LAC vs. TOR,98,10,1610612761,TOR,Toronto Raptors,TOR @ LAC,88,-10,Regular Season
22019,1610612740,NOP,New Orleans Pelicans,0021900142,2019-11-11T00:00:00Z,NOP vs. HOU,116,-6,1610612745,HOU,Houston Rockets,HOU @ NOP,122,6,Regular Season
22019,1610612738,BOS,Boston Celtics,0021900141,2019-11-11T00:00:00Z,BOS vs. DAL,116,10,1610612742,DAL,Dallas Mavericks,DAL @ BOS,106,-10,Regular Season
22019,1610612744,GSW,Golden State Warriors,0021900144,2019-11-11T00:00:00Z,GSW vs. UTA,108,-14,1610612762,UTA,Utah Jazz,UTA @ GSW,122,14,Regular Season
22019,1610612765,DET,Detroit Pistons,0021900140,2019-11-11T00:00:00Z,DET vs. MIN,114,-6,1610612750,MIN,Minnesota Timberwolves,MIN @ DET,120,6,Regular Season
22019,1610612759,SAS,San Antonio Spurs,0021900143,2019-11-11T00:00:00Z,SAS vs. MEM,109,-4,1610612763,MEM,Memphis Grizzlies,MEM @ SAS,113,4,Regular Season
22019,1610612743,DEN,Denver Nuggets,0021900150,2019-11-12T00:00:00Z,DEN vs. ATL,121,-4,1610612737,ATL,Atlanta Hawks,ATL @ DEN,125,4,Regular Season
22019,1610612748,MIA,Miami Heat,0021900148,2019-11-12T00:00:00Z,MIA vs. DET,117,9,1610612765,DET,Detroit Pistons,DET @ MIA,108,-9,Regular Season
22019,1610612762,UTA,Utah Jazz,0021900152,2019-11-12T00:00:00Z,UTA vs. BKN,119,5,1610612751,BKN,Brooklyn Nets,BKN @ UTA,114,-5,Regular Season
22019,1610612741,CHI,Chicago Bulls,0021900149,2019-11-12T00:00:00Z,CHI vs. NYK,120,18,1610612752,NYK,New York Knicks,NYK @ CHI,102,-18,Regular Season
22019,1610612758,SAC,Sacramento Kings,0021900153,2019-11-12T00:00:00Z,SAC vs. POR,107,8,1610612757,POR,Portland Trail Blazers,POR @ SAC,99,-8,Regular Season
22019,1610612755,PHI,Philadelphia 76ers,0021900147,2019-11-12T00:00:00Z,PHI vs. CLE,98,1,1610612739,CLE,Cleveland Cavaliers,CLE @ PHI,97,-1,Regular Season
22019,1610612756,PHX,Phoenix Suns,0021900151,2019-11-12T00:00:00Z,PHX vs. LAL,115,-8,1610612747,LAL,Los Angeles Lakers,LAL @ PHX,123,8,Regular Season
22019,1610612754,IND,Indiana Pacers,0021900146,2019-11-12T00:00:00Z,IND vs. OKC,111,26,1610612760,OKC,Oklahoma City Thunder,OKC @ IND,85,-26,Regular Season
22019,1610612753,ORL,Orlando Magic,0021900155,2019-11-13T00:00:00Z,ORL vs. PHI,112,15,1610612755,PHI,Philadelphia 76ers,PHI @ ORL,97,-15,Regular Season
22019,1610612766,CHA,Charlotte Hornets,0021900154,2019-11-13T00:00:00Z,CHA vs. MEM,117,-2,1610612763,MEM,Memphis Grizzlies,MEM @ CHA,119,2,Regular Season
22019,1610612747,LAL,Los Angeles Lakers,0021900159,2019-11-13T00:00:00Z,LAL vs. GSW,120,26,1610612744,GSW,Golden State Warriors,GSW @ LAL,94,-26,Regular Season
22019,1610612745,HOU,Houston Rockets,0021900157,2019-11-13T00:00:00Z,HOU vs. LAC,102,9,1610612746,LAC,LA Clippers,LAC @ HOU,93,-9,Regular Season
22019,1610612738,BOS,Boston Celtics,0021900156,2019-11-13T00:00:00Z,BOS vs. WAS,140,7,1610612764,WAS,Washington Wizards,WAS @ BOS,133,-7,Regular Season
22019,1610612757,POR,Portland Trail Blazers,0021900160,2019-11-13T00:00:00Z,POR vs. TOR,106,-8,1610612761,TOR,Toronto Raptors,TOR @ POR,114,8,Regular Season
22019,1610612750,MIN,Minnesota Timberwolves,0021900158,2019-11-13T00:00:00Z,MIN vs. SAS,129,15,1610612759,SAS,San Antonio Spurs,SAS @ MIN,114,-15,Regular Season
22019,1610612756,PHX,Phoenix Suns,0021900165,2019-11-14T00:00:00Z,PHX vs. ATL,128,16,1610612737,ATL,Atlanta Hawks,ATL @ PHX,112,-16,Regular Season
22019,1610612749,MIL,Milwaukee Bucks,0021900163,2019-11-14T00:00:00Z,MIL vs. CHI,124,9,1610612741,CHI,Chicago Bulls,CHI @ MIL,115,-9,Regular Season
22019,1610612739,CLE,Cleveland Cavaliers,0021900161,2019-11-14T00:00:00Z,CLE vs. MIA,97,-11,1610612748,MIA,Miami Heat,MIA @ CLE,108,11,Regular Season
22019,1610612752,NYK,New York Knicks,0021900162,2019-11-14T00:00:00Z,NYK vs. DAL,106,3,1610612742,DAL,Dallas Mavericks,DAL @ NYK,103,-3,Regular Season
22019,1610612743,DEN,Denver Nuggets,0021900166,2019-11-14T00:00:00Z,DEN vs. BKN,101,8,1610612751,BKN,Brooklyn Nets,BKN @ DEN,93,-8,Regular Season
22019,1610612740,NOP,New Orleans Pelicans,0021900164,2019-11-14T00:00:00Z,NOP vs. LAC,132,5,1610612746,LAC,LA Clippers,LAC @ NOP,127,-5,Regular Season
22019,1610612744,GSW,Golden State Warriors,0021900173,2019-11-15T00:00:00Z,GSW vs. BOS,100,-5,1610612738,BOS,Boston Celtics,BOS @ GSW,105,5,Regular Season
22019,1610612745,HOU,Houston Rockets,0021900169,2019-11-15T00:00:00Z,HOU vs. IND,111,9,1610612754,IND,Indiana Pacers,IND @ HOU,102,-9,Regular Season
22019,1610612750,MIN,Minnesota Timberwolves,0021900171,2019-11-15T00:00:00Z,MIN vs. WAS,116,-21,1610612764,WAS,Washington Wizards,WAS @ MIN,137,21,Regular Season
22019,1610612766,CHA,Charlotte Hornets,0021900167,2019-11-15T00:00:00Z,CHA vs. DET,109,3,1610612765,DET,Detroit Pistons,DET @ CHA,106,-3,Regular Season
22019,1610612763,MEM,Memphis Grizzlies,0021900170,2019-11-15T00:00:00Z,MEM vs. UTA,107,1,1610612762,UTA,Utah Jazz,UTA @ MEM,106,-1,Regular Season
22019,1610612760,OKC,Oklahoma City Thunder,0021900172,2019-11-15T00:00:00Z,OKC vs. PHI,127,8,1610612755,PHI,Philadelphia 76ers,PHI @ OKC,119,-8,Regular Season
22019,1610612747,LAL,Los Angeles Lakers,0021900174,2019-11-15T00:00:00Z,LAL vs. SAC,99,2,1610612758,SAC,Sacramento Kings,SAC @ LAL,97,-2,Regular Season
22019,1610612753,ORL,Orlando Magic,0021900168,2019-11-15T00:00:00Z,ORL vs. SAS,111,2,1610612759,SAS,San Antonio Spurs,SAS @ ORL,109,-2,Regular Season
22019,1610612754,IND,Indiana Pacers,0021900176,2019-11-16T00:00:00Z,IND vs. MIL,83,-19,1610612749,MIL,Milwaukee Bucks,MIL @ IND,102,19,Regular Season
22019,1610612752,NYK,New York Knicks,0021900177,2019-11-16T00:00:00Z,NYK vs. CHA,102,-1,1610612766,CHA,Charlotte Hornets,CHA @ NYK,103,1,Regular Season
22019,1610612746,LAC,LA Clippers,0021900182,2019-11-16T00:00:00Z,LAC vs. ATL,150,49,1610612737,ATL,Atlanta Hawks,ATL @ LAC,101,-49,Regular Season
22019,1610612748,MIA,Miami Heat,0021900178,2019-11-16T00:00:00Z,MIA vs. NOP,109,15,1610612740,NOP,New Orleans Pelicans,NOP @ MIA,94,-15,Regular Season
22019,1610612759,SAS,San Antonio Spurs,0021900181,2019-11-16T00:00:00Z,SAS vs. POR,116,-5,1610612757,POR,Portland Trail Blazers,POR @ SAS,121,5,Regular Season
22019,1610612741,CHI,Chicago Bulls,0021900175,2019-11-16T00:00:00Z,CHI vs. BKN,111,-6,1610612751,BKN,Brooklyn Nets,BKN @ CHI,117,6,Regular Season
22019,1610612750,MIN,Minnesota Timberwolves,0021900179,2019-11-16T00:00:00Z,MIN vs. HOU,105,-20,1610612745,HOU,Houston Rockets,HOU @ MIN,125,20,Regular Season
22019,1610612742,DAL,Dallas Mavericks,0021900180,2019-11-16T00:00:00Z,DAL vs. TOR,110,8,1610612761,TOR,Toronto Raptors,TOR @ DAL,102,-8,Regular Season
22019,1610612740,NOP,New Orleans Pelicans,0021900187,2019-11-17T00:00:00Z,NOP vs. GSW,108,8,1610612744,GSW,Golden State Warriors,GSW @ NOP,100,-8,Regular Season
22019,1610612763,MEM,Memphis Grizzlies,0021900186,2019-11-17T00:00:00Z,MEM vs. DEN,114,-17,1610612743,DEN,Denver Nuggets,DEN @ MEM,131,17,Regular Season
22019,1610612739,CLE,Cleveland Cavaliers,0021900183,2019-11-17T00:00:00Z,CLE vs. PHI,95,-19,1610612755,PHI,Philadelphia 76ers,PHI @ CLE,114,19,Regular Season
22019,1610612758,SAC,Sacramento Kings,0021900184,2019-11-17T00:00:00Z,SAC vs. BOS,100,1,1610612738,BOS,Boston Celtics,BOS @ SAC,99,-1,Regular Season
22019,1610612747,LAL,Los Angeles Lakers,0021900188,2019-11-17T00:00:00Z,LAL vs. ATL,122,21,1610612737,ATL,Atlanta Hawks,ATL @ LAL,101,-21,Regular Season
22019,1610612753,ORL,Orlando Magic,0021900185,2019-11-17T00:00:00Z,ORL vs. WAS,125,4,1610612764,WAS,Washington Wizards,WAS @ ORL,121,-4,Regular Season
22019,1610612741,CHI,Chicago Bulls,0021900192,2019-11-18T00:00:00Z,CHI vs. MIL,101,-14,1610612749,MIL,Milwaukee Bucks,MIL @ CHI,115,14,Regular Season
22019,1610612752,NYK,New York Knicks,0021900189,2019-11-18T00:00:00Z,NYK vs. CLE,123,18,1610612739,CLE,Cleveland Cavaliers,CLE @ NYK,105,-18,Regular Season
22019,1610612745,HOU,Houston Rockets,0021900193,2019-11-18T00:00:00Z,HOU vs. POR,132,24,1610612757,POR,Portland Trail Blazers,POR @ HOU,108,-24,Regular Season
22019,1610612762,UTA,Utah Jazz,0021900196,2019-11-18T00:00:00Z,UTA vs. MIN,102,-10,1610612750,MIN,Minnesota Timberwolves,MIN @ UTA,112,10,Regular Season
22019,1610612751,BKN,Brooklyn Nets,0021900190,2019-11-18T00:00:00Z,BKN vs. IND,86,-29,1610612754,IND,Indiana Pacers,IND @ BKN,115,29,Regular Season
22019,1610612742,DAL,Dallas Mavericks,0021900194,2019-11-18T00:00:00Z,DAL vs. SAS,117,7,1610612759,SAS,San Antonio Spurs,SAS @ DAL,110,-7,Regular Season
22019,1610612746,LAC,LA Clippers,0021900197,2019-11-18T00:00:00Z,LAC vs. OKC,90,2,1610612760,OKC,Oklahoma City Thunder,OKC @ LAC,88,-2,Regular Season
22019,1610612756,PHX,Phoenix Suns,0021900195,2019-11-18T00:00:00Z,PHX vs. BOS,85,-14,1610612738,BOS,Boston Celtics,BOS @ PHX,99,14,Regular Season
22019,1610612761,TOR,Toronto Raptors,0021900191,2019-11-18T00:00:00Z,TOR vs. CHA,132,36,1610612766,CHA,Charlotte Hornets,CHA @ TOR,96,-36,Regular Season
22019,1610612758,SAC,Sacramento Kings,0021900200,2019-11-19T00:00:00Z,SAC vs. PHX,120,4,1610612756,PHX,Phoenix Suns,PHX @ SAC,116,-4,Regular Season
22019,1610612747,LAL,Los Angeles Lakers,0021900201,2019-11-19T00:00:00Z,LAL vs. OKC,112,5,1610612760,OKC,Oklahoma City Thunder,OKC @ LAL,107,-5,Regular Season
22019,1610612740,NOP,New Orleans Pelicans,0021900199,2019-11-19T00:00:00Z,NOP vs. POR,115,11,1610612757,POR,Portland Trail Blazers,POR @ NOP,104,-11,Regular Season
22019,1610612763,MEM,Memphis Grizzlies,0021900198,2019-11-19T00:00:00Z,MEM vs. GSW,95,-19,1610612744,GSW,Golden State Warriors,GSW @ MEM,114,19,Regular Season
22019,1610612746,LAC,LA Clippers,0021900212,2019-11-20T00:00:00Z,LAC vs. BOS,107,3,1610612738,BOS,Boston Celtics,BOS @ LAC,104,-3,Regular Season
22019,1610612751,BKN,Brooklyn Nets,0021900205,2019-11-20T00:00:00Z,BKN vs. CHA,101,10,1610612766,CHA,Charlotte Hornets,CHA @ BKN,91,-10,Regular Season
22019,1610612764,WAS,Washington Wizards,0021900203,2019-11-20T00:00:00Z,WAS vs. SAS,138,6,1610612759,SAS,San Antonio Spurs,SAS @ WAS,132,-6,Regular Season
22019,1610612743,DEN,Denver Nuggets,0021900211,2019-11-20T00:00:00Z,DEN vs. HOU,105,10,1610612745,HOU,Houston Rockets,HOU @ DEN,95,-10,Regular Season
22019,1610612742,DAL,Dallas Mavericks,0021900208,2019-11-20T00:00:00Z,DAL vs. GSW,142,48,1610612744,GSW,Golden State Warriors,GSW @ DAL,94,-48,Regular Season
22019,1610612761,TOR,Toronto Raptors,0021900207,2019-11-20T00:00:00Z,TOR vs. ORL,113,16,1610612753,ORL,Orlando Magic,ORL @ TOR,97,-16,Regular Season
22019,1610612755,PHI,Philadelphia 76ers,0021900202,2019-11-20T00:00:00Z,PHI vs. NYK,109,5,1610612752,NYK,New York Knicks,NYK @ PHI,104,-5,Regular Season
22019,1610612741,CHI,Chicago Bulls,0021900209,2019-11-20T00:00:00Z,CHI vs. DET,109,20,1610612765,DET,Detroit Pistons,DET @ CHI,89,-20,Regular Season
22019,1610612750,MIN,Minnesota Timberwolves,0021900210,2019-11-20T00:00:00Z,MIN vs. UTA,95,-8,1610612762,UTA,Utah Jazz,UTA @ MIN,103,8,Regular Season
22019,1610612748,MIA,Miami Heat,0021900206,2019-11-20T00:00:00Z,MIA vs. CLE,124,24,1610612739,CLE,Cleveland Cavaliers,CLE @ MIA,100,-24,Regular Season
22019,1610612737,ATL,Atlanta Hawks,0021900204,2019-11-20T00:00:00Z,ATL vs. MIL,127,-8,1610612749,MIL,Milwaukee Bucks,MIL @ ATL,135,8,Regular Season
22019,1610612756,PHX,Phoenix Suns,0021900214,2019-11-21T00:00:00Z,PHX vs. NOP,121,-3,1610612740,NOP,New Orleans Pelicans,NOP @ PHX,124,3,Regular Season
22019,1610612749,MIL,Milwaukee Bucks,0021900213,2019-11-21T00:00:00Z,MIL vs. POR,137,8,1610612757,POR,Portland Trail Blazers,POR @ MIL,129,-8,Regular Season
22019,1610612764,WAS,Washington Wizards,0021900216,2019-11-22T00:00:00Z,WAS vs. CHA,125,7,1610612766,CHA,Charlotte Hornets,CHA @ WAS,118,-7,Regular Season
22019,1610612742,DAL,Dallas Mavericks,0021900221,2019-11-22T00:00:00Z,DAL vs. CLE,143,42,1610612739,CLE,Cleveland Cavaliers,CLE @ DAL,101,-42,Regular Season
22019,1610612755,PHI,Philadelphia 76ers,0021900218,2019-11-22T00:00:00Z,PHI vs. SAS,115,11,1610612759,SAS,San Antonio Spurs,SAS @ PHI,104,-11,Regular Season
22019,1610612765,DET,Detroit Pistons,0021900215,2019-11-22T00:00:00Z,DET vs. ATL,128,25,1610612737,ATL,Atlanta Hawks,ATL @ DET,103,-25,Regular Season
22019,1610612760,OKC,Oklahoma City Thunder,0021900220,2019-11-22T00:00:00Z,OKC vs. LAL,127,-3,1610612747,LAL,Los Angeles Lakers,LAL @ OKC,130,3,Regular Season
22019,1610612762,UTA,Utah Jazz,0021900223,2019-11-22T00:00:00Z,UTA vs. GSW,113,4,1610612744,GSW,Golden State Warriors,GSW @ UTA,109,-4,Regular Season
22019,1610612746,LAC,LA Clippers,0021900224,2019-11-22T00:00:00Z,LAC vs. HOU,122,3,1610612745,HOU,Houston Rockets,HOU @ LAC,119,-3,Regular Season
22019,1610612741,CHI,Chicago Bulls,0021900219,2019-11-22T00:00:00Z,CHI vs. MIA,108,-8,1610612748,MIA,Miami Heat,MIA @ CHI,116,8,Regular Season
22019,1610612751,BKN,Brooklyn Nets,0021900217,2019-11-22T00:00:00Z,BKN vs. SAC,116,19,1610612758,SAC,Sacramento Kings,SAC @ BKN,97,-19,Regular Season
22019,1610612743,DEN,Denver Nuggets,0021900222,2019-11-22T00:00:00Z,DEN vs. BOS,96,4,1610612738,BOS,Boston Celtics,BOS @ DEN,92,-4,Regular Season
22019,1610612750,MIN,Minnesota Timberwolves,0021900225,2019-11-23T00:00:00Z,MIN vs. PHX,98,-2,1610612756,PHX,Phoenix Suns,PHX @ MIN,100,2,Regular Season
22019,1610612752,NYK,New York Knicks,0021900229,2019-11-23T00:00:00Z,NYK vs. SAS,104,-7,1610612759,SAS,San Antonio Spurs,SAS @ NYK,111,7,Regular Season
22019,1610612739,CLE,Cleveland Cavaliers,0021900231,2019-11-23T00:00:00Z,CLE vs. POR,110,6,1610612757,POR,Portland Trail Blazers,POR @ CLE,104,-6,Regular Season
22019,1610612749,MIL,Milwaukee Bucks,0021900233,2019-11-23T00:00:00Z,MIL vs. DET,104,14,1610612765,DET,Detroit Pistons,DET @ MIL,90,-14,Regular Season
22019,1610612754,IND,Indiana Pacers,0021900227,2019-11-23T00:00:00Z,IND vs. ORL,111,5,1610612753,ORL,Orlando Magic,ORL @ IND,106,-5,Regular Season
22019,1610612766,CHA,Charlotte Hornets,0021900226,2019-11-23T00:00:00Z,CHA vs. CHI,115,-1,1610612741,CHI,Chicago Bulls,CHI @ CHA,116,1,Regular Season
22019,1610612762,UTA,Utah Jazz,0021900234,2019-11-23T00:00:00Z,UTA vs. NOP,128,8,1610612740,NOP,New Orleans Pelicans,NOP @ UTA,120,-8,Regular Season
22019,1610612755,PHI,Philadelphia 76ers,0021900230,2019-11-23T00:00:00Z,PHI vs. MIA,113,27,1610612748,MIA,Miami Heat,MIA @ PHI,86,-27,Regular Season
22019,1610612763,MEM,Memphis Grizzlies,0021900232,2019-11-23T00:00:00Z,MEM vs. LAL,108,-1,1610612747,LAL,Los Angeles Lakers,LAL @ MEM,109,1,Regular Season
22019,1610612737,ATL,Atlanta Hawks,0021900228,2019-11-23T00:00:00Z,ATL vs. TOR,116,-3,1610612761,TOR,Toronto Raptors,TOR @ ATL,119,3,Regular Season
22019,1610612745,HOU,Houston Rockets,0021900235,2019-11-24T00:00:00Z,HOU vs. DAL,123,-14,1610612742,DAL,Dallas Mavericks,DAL @ HOU,137,14,Regular Season
22019,1610612752,NYK,New York Knicks,0021900236,2019-11-24T00:00:00Z,NYK vs. BKN,101,-2,1610612751,BKN,Brooklyn Nets,BKN @ NYK,103,2,Regular Season
22019,1610612746,LAC,LA Clippers,0021900239,2019-11-24T00:00:00Z,LAC vs. NOP,134,25,1610612740,NOP,New Orleans Pelicans,NOP @ LAC,109,-25,Regular Season
22019,1610612743,DEN,Denver Nuggets,0021900238,2019-11-24T00:00:00Z,DEN vs. PHX,116,12,1610612756,PHX,Phoenix Suns,PHX @ DEN,104,-12,Regular Season
22019,1610612764,WAS,Washington Wizards,0021900237,2019-11-24T00:00:00Z,WAS vs. SAC,106,-7,1610612758,SAC,Sacramento Kings,SAC @ WAS,113,7,Regular Season
22019,1610612738,BOS,Boston Celtics,0021900244,2019-11-25T00:00:00Z,BOS vs. SAC,103,1,1610612758,SAC,Sacramento Kings,SAC @ BOS,102,-1,Regular Season
22019,1610612737,ATL,Atlanta Hawks,0021900243,2019-11-25T00:00:00Z,ATL vs. MIN,113,-12,1610612750,MIN,Minnesota Timberwolves,MIN @ ATL,125,12,Regular Season
22019,1610612761,TOR,Toronto Raptors,0021900246,2019-11-25T00:00:00Z,TOR vs. PHI,101,5,1610612755,PHI,Philadelphia 76ers,PHI @ TOR,96,-5,Regular Season
22019,1610612754,IND,Indiana Pacers,0021900242,2019-11-25T00:00:00Z,IND vs. MEM,126,12,1610612763,MEM,Memphis Grizzlies,MEM @ IND,114,-12,Regular Season
22019,1610612744,GSW,Golden State Warriors,0021900250,2019-11-25T00:00:00Z,GSW vs. OKC,97,-3,1610612760,OKC,Oklahoma City Thunder,OKC @ GSW,100,3,Regular Season
22019,1610612749,MIL,Milwaukee Bucks,0021900248,2019-11-25T00:00:00Z,MIL vs. UTA,122,4,1610612762,UTA,Utah Jazz,UTA @ MIL,118,-4,Regular Season
22019,1610612765,DET,Detroit Pistons,0021900241,2019-11-25T00:00:00Z,DET vs. ORL,103,15,1610612753,ORL,Orlando Magic,ORL @ DET,88,-15,Regular Season
22019,1610612741,CHI,Chicago Bulls,0021900247,2019-11-25T00:00:00Z,CHI vs. POR,94,-23,1610612757,POR,Portland Trail Blazers,POR @ CHI,117,23,Regular Season
22019,1610612759,SAS,San Antonio Spurs,0021900249,2019-11-25T00:00:00Z,SAS vs. LAL,104,-10,1610612747,LAL,Los Angeles Lakers,LAL @ SAS,114,10,Regular Season
22019,1610612739,CLE,Cleveland Cavaliers,0021900240,2019-11-25T00:00:00Z,CLE vs. BKN,106,-2,1610612751,BKN,Brooklyn Nets,BKN @ CLE,108,2,Regular Season
22019,1610612748,MIA,Miami Heat,0021900245,2019-11-25T00:00:00Z,MIA vs. CHA,117,17,1610612766,CHA,Charlotte Hornets,CHA @ MIA,100,-17,Regular Season
22019,1610612742,DAL,Dallas Mavericks,0021900251,2019-11-26T00:00:00Z,DAL vs. LAC,99,-15,1610612746,LAC,LA Clippers,LAC @ DAL,114,15,Regular Season
22019,1610612743,DEN,Denver Nuggets,0021900252,2019-11-26T00:00:00Z,DEN vs. WAS,117,13,1610612764,WAS,Washington Wizards,WAS @ DEN,104,-13,Regular Season
22019,1610612739,CLE,Cleveland Cavaliers,0021900255,2019-11-27T00:00:00Z,CLE vs. ORL,104,-12,1610612753,ORL,Orlando Magic,ORL @ CLE,116,12,Regular Season
22019,1610612761,TOR,Toronto Raptors,0021900258,2019-11-27T00:00:00Z,TOR vs. NYK,126,28,1610612752,NYK,New York Knicks,NYK @ TOR,98,-28,Regular Season
22019,1610612738,BOS,Boston Celtics,0021900253,2019-11-27T00:00:00Z,BOS vs. BKN,121,11,1610612751,BKN,Brooklyn Nets,BKN @ BOS,110,-11,Regular Season
22019,1610612766,CHA,Charlotte Hornets,0021900254,2019-11-27T00:00:00Z,CHA vs. DET,102,1,1610612765,DET,Detroit Pistons,DET @ CHA,101,-1,Regular Season
22019,1610612763,MEM,Memphis Grizzlies,0021900260,2019-11-27T00:00:00Z,MEM vs. LAC,119,-2,1610612746,LAC,LA Clippers,LAC @ MEM,121,2,Regular Season
22019,1610612755,PHI,Philadelphia 76ers,0021900257,2019-11-27T00:00:00Z,PHI vs. SAC,97,6,1610612758,SAC,Sacramento Kings,SAC @ PHI,91,-6,Regular Season
22019,1610612756,PHX,Phoenix Suns,0021900263,2019-11-27T00:00:00Z,PHX vs. WAS,132,-8,1610612764,WAS,Washington Wizards,WAS @ PHX,140,8,Regular Season
22019,1610612759,SAS,San Antonio Spurs,0021900262,2019-11-27T00:00:00Z,SAS vs. MIN,101,-12,1610612750,MIN,Minnesota Timberwolves,MIN @ SAS,113,12,Regular Season
22019,1610612754,IND,Indiana Pacers,0021900256,2019-11-27T00:00:00Z,IND vs. UTA,121,19,1610612762,UTA,Utah Jazz,UTA @ IND,102,-19,Regular Season
22019,1610612757,POR,Portland Trail Blazers,0021900265,2019-11-27T00:00:00Z,POR vs. OKC,136,17,1610612760,OKC,Oklahoma City Thunder,OKC @ POR,119,-17,Regular Season
22019,1610612749,MIL,Milwaukee Bucks,0021900261,2019-11-27T00:00:00Z,MIL vs. ATL,111,9,1610612737,ATL,Atlanta Hawks,ATL @ MIL,102,-9,Regular Season
22019,1610612744,GSW,Golden State Warriors,0021900266,2019-11-27T00:00:00Z,GSW vs. CHI,104,14,1610612741,CHI,Chicago Bulls,CHI @ GSW,90,-14,Regular Season
22019,1610612745,HOU,Houston Rockets,0021900259,2019-11-27T00:00:00Z,HOU vs. MIA,117,9,1610612748,MIA,Miami Heat,MIA @ HOU,108,-9,Regular Season
22019,1610612740,NOP,New Orleans Pelicans,0021900264,2019-11-27T00:00:00Z,NOP vs. LAL,110,-4,1610612747,LAL,Los Angeles Lakers,LAL @ NOP,114,4,Regular Season
22019,1610612753,ORL,Orlando Magic,0021900269,2019-11-29T00:00:00Z,ORL vs. TOR,83,-7,1610612761,TOR,Toronto Raptors,TOR @ ORL,90,7,Regular Season
22019,1610612747,LAL,Los Angeles Lakers,0021900279,2019-11-29T00:00:00Z,LAL vs. WAS,125,22,1610612764,WAS,Washington Wizards,WAS @ LAL,103,-22,Regular Season
22019,1610612760,OKC,Oklahoma City Thunder,0021900275,2019-11-29T00:00:00Z,OKC vs. NOP,109,5,1610612740,NOP,New Orleans Pelicans,NOP @ OKC,104,-5,Regular Season
22019,1610612748,MIA,Miami Heat,0021900273,2019-11-29T00:00:00Z,MIA vs. GSW,122,17,1610612744,GSW,Golden State Warriors,GSW @ MIA,105,-17,Regular Season
22019,1610612752,NYK,New York Knicks,0021900271,2019-11-29T00:00:00Z,NYK vs. PHI,95,-6,1610612755,PHI,Philadelphia 76ers,PHI @ NYK,101,6,Regular Season
22019,1610612739,CLE,Cleveland Cavaliers,0021900270,2019-11-29T00:00:00Z,CLE vs. MIL,110,-9,1610612749,MIL,Milwaukee Bucks,MIL @ CLE,119,9,Regular Season
22019,1610612756,PHX,Phoenix Suns,0021900277,2019-11-29T00:00:00Z,PHX vs. DAL,113,-7,1610612742,DAL,Dallas Mavericks,DAL @ PHX,120,7,Regular Season
22019,1610612763,MEM,Memphis Grizzlies,0021900274,2019-11-29T00:00:00Z,MEM vs. UTA,94,-9,1610612762,UTA,Utah Jazz,UTA @ MEM,103,9,Regular Season
22019,1610612759,SAS,San Antonio Spurs,0021900276,2019-11-29T00:00:00Z,SAS vs. LAC,107,10,1610612746,LAC,LA Clippers,LAC @ SAS,97,-10,Regular Season
22019,1610612757,POR,Portland Trail Blazers,0021900278,2019-11-29T00:00:00Z,POR vs. CHI,107,4,1610612741,CHI,Chicago Bulls,CHI @ POR,103,-4,Regular Season
22019,1610612765,DET,Detroit Pistons,0021900268,2019-11-29T00:00:00Z,DET vs. CHA,107,-3,1610612766,CHA,Charlotte Hornets,CHA @ DET,110,3,Regular Season
22019,1610612754,IND,Indiana Pacers,0021900272,2019-11-29T00:00:00Z,IND vs. ATL,105,1,1610612737,ATL,Atlanta Hawks,ATL @ IND,104,-1,Regular Season
22019,1610612751,BKN,Brooklyn Nets,0021900267,2019-11-29T00:00:00Z,BKN vs. BOS,112,5,1610612738,BOS,Boston Celtics,BOS @ BKN,107,-5,Regular Season
22019,1610612755,PHI,Philadelphia 76ers,0021900281,2019-11-30T00:00:00Z,PHI vs. IND,119,3,1610612754,IND,Indiana Pacers,IND @ PHI,116,-3,Regular Season
22019,1610612745,HOU,Houston Rockets,0021900282,2019-11-30T00:00:00Z,HOU vs. ATL,158,47,1610612737,ATL,Atlanta Hawks,ATL @ HOU,111,-47,Regular Season
22019,1610612758,SAC,Sacramento Kings,0021900280,2019-11-30T00:00:00Z,SAC vs. DEN,100,3,1610612743,DEN,Denver Nuggets,DEN @ SAC,97,-3,Regular Season
22019,1610612749,MIL,Milwaukee Bucks,0021900283,2019-11-30T00:00:00Z,MIL vs. CHA,137,41,1610612766,CHA,Charlotte Hornets,CHA @ MIL,96,-41,Regular Season
22019,1610612740,NOP,New Orleans Pelicans,0021900289,2019-12-01T00:00:00Z,NOP vs. OKC,104,-3,1610612760,OKC,Oklahoma City Thunder,OKC @ NOP,107,3,Regular Season
22019,1610612752,NYK,New York Knicks,0021900285,2019-12-01T00:00:00Z,NYK vs. BOS,104,-9,1610612738,BOS,Boston Celtics,BOS @ NYK,113,9,Regular Season
22019,1610612753,ORL,Orlando Magic,0021900290,2019-12-01T00:00:00Z,ORL vs. GSW,100,4,1610612744,GSW,Golden State Warriors,GSW @ ORL,96,-4,Regular Season
22019,1610612746,LAC,LA Clippers,0021900292,2019-12-01T00:00:00Z,LAC vs. WAS,150,25,1610612764,WAS,Washington Wizards,WAS @ LAC,125,-25,Regular Season
22019,1610612750,MIN,Minnesota Timberwolves,0021900286,2019-12-01T00:00:00Z,MIN vs. MEM,107,-8,1610612763,MEM,Memphis Grizzlies,MEM @ MIN,115,8,Regular Season
22019,1610612765,DET,Detroit Pistons,0021900288,2019-12-01T00:00:00Z,DET vs. SAS,132,34,1610612759,SAS,San Antonio Spurs,SAS @ DET,98,-34,Regular Season
22019,1610612761,TOR,Toronto Raptors,0021900291,2019-12-01T00:00:00Z,TOR vs. UTA,130,20,1610612762,UTA,Utah Jazz,UTA @ TOR,110,-20,Regular Season
22019,1610612747,LAL,Los Angeles Lakers,0021900287,2019-12-01T00:00:00Z,LAL vs. DAL,100,-14,1610612742,DAL,Dallas Mavericks,DAL @ LAL,114,14,Regular Season
22019,1610612751,BKN,Brooklyn Nets,0021900284,2019-12-01T00:00:00Z,BKN vs. MIA,106,-3,1610612748,MIA,Miami Heat,MIA @ BKN,109,3,Regular Season
22019,1610612766,CHA,Charlotte Hornets,0021900293,2019-12-02T00:00:00Z,CHA vs. PHX,104,-5,1610612756,PHX,Phoenix Suns,PHX @ CHA,109,5,Regular Season
22019,1610612763,MEM,Memphis Grizzlies,0021900296,2019-12-02T00:00:00Z,MEM vs. IND,104,-13,1610612754,IND,Indiana Pacers,IND @ MEM,117,13,Regular Season
22019,1610612758,SAC,Sacramento Kings,0021900298,2019-12-02T00:00:00Z,SAC vs. CHI,106,-7,1610612741,CHI,Chicago Bulls,CHI @ SAC,113,7,Regular Season
22019,1610612749,MIL,Milwaukee Bucks,0021900297,2019-12-02T00:00:00Z,MIL vs. NYK,132,44,1610612752,NYK,New York Knicks,NYK @ MIL,88,-44,Regular Season
22019,1610612737,ATL,Atlanta Hawks,0021900295,2019-12-02T00:00:00Z,ATL vs. GSW,104,25,1610612744,GSW,Golden State Warriors,GSW @ ATL,79,-25,Regular Season
22019,1610612755,PHI,Philadelphia 76ers,0021900294,2019-12-02T00:00:00Z,PHI vs. UTA,103,9,1610612762,UTA,Utah Jazz,UTA @ PHI,94,-9,Regular Season
22019,1610612746,LAC,LA Clippers,0021900305,2019-12-03T00:00:00Z,LAC vs. POR,117,20,1610612757,POR,Portland Trail Blazers,POR @ LAC,97,-20,Regular Season
22019,1610612761,TOR,Toronto Raptors,0021900301,2019-12-03T00:00:00Z,TOR vs. MIA,110,-11,1610612748,MIA,Miami Heat,MIA @ TOR,121,11,Regular Season
22019,1610612743,DEN,Denver Nuggets,0021900304,2019-12-03T00:00:00Z,DEN vs. LAL,96,-9,1610612747,LAL,Los Angeles Lakers,LAL @ DEN,105,9,Regular Season
22019,1610612739,CLE,Cleveland Cavaliers,0021900299,2019-12-03T00:00:00Z,CLE vs. DET,94,-33,1610612765,DET,Detroit Pistons,DET @ CLE,127,33,Regular Season
22019,1610612764,WAS,Washington Wizards,0021900300,2019-12-03T00:00:00Z,WAS vs. ORL,120,-7,1610612753,ORL,Orlando Magic,ORL @ WAS,127,7,Regular Season
22019,1610612759,SAS,San Antonio Spurs,0021900303,2019-12-03T00:00:00Z,SAS vs. HOU,135,2,1610612745,HOU,Houston Rockets,HOU @ SAS,133,-2,Regular Season
22019,1610612740,NOP,New Orleans Pelicans,0021900302,2019-12-03T00:00:00Z,NOP vs. DAL,97,-21,1610612742,DAL,Dallas Mavericks,DAL @ NOP,118,21,Regular Season
22019,1610612753,ORL,Orlando Magic,0021900308,2019-12-04T00:00:00Z,ORL vs. PHX,128,14,1610612756,PHX,Phoenix Suns,PHX @ ORL,114,-14,Regular Season
22019,1610612760,OKC,Oklahoma City Thunder,0021900312,2019-12-04T00:00:00Z,OKC vs. IND,100,-7,1610612754,IND,Indiana Pacers,IND @ OKC,107,7,Regular Season
22019,1610612737,ATL,Atlanta Hawks,0021900309,2019-12-04T00:00:00Z,ATL vs. BKN,118,-12,1610612751,BKN,Brooklyn Nets,BKN @ ATL,130,12,Regular Season
22019,1610612765,DET,Detroit Pistons,0021900307,2019-12-04T00:00:00Z,DET vs. MIL,103,-24,1610612749,MIL,Milwaukee Bucks,MIL @ DET,127,24,Regular Season
22019,1610612738,BOS,Boston Celtics,0021900310,2019-12-04T00:00:00Z,BOS vs. MIA,112,19,1610612748,MIA,Miami Heat,MIA @ BOS,93,-19,Regular Season
22019,1610612766,CHA,Charlotte Hornets,0021900306,2019-12-04T00:00:00Z,CHA vs. GSW,106,15,1610612744,GSW,Golden State Warriors,GSW @ CHA,91,-15,Regular Season
22019,1610612762,UTA,Utah Jazz,0021900314,2019-12-04T00:00:00Z,UTA vs. LAL,96,-25,1610612747,LAL,Los Angeles Lakers,LAL @ UTA,121,25,Regular Season
22019,1610612741,CHI,Chicago Bulls,0021900311,2019-12-04T00:00:00Z,CHI vs. MEM,106,7,1610612763,MEM,Memphis Grizzlies,MEM @ CHI,99,-7,Regular Season
22019,1610612757,POR,Portland Trail Blazers,0021900315,2019-12-04T00:00:00Z,POR vs. SAC,127,11,1610612758,SAC,Sacramento Kings,SAC @ POR,116,-11,Regular Season
22019,1610612742,DAL,Dallas Mavericks,0021900313,2019-12-04T00:00:00Z,DAL vs. MIN,121,7,1610612750,MIN,Minnesota Timberwolves,MIN @ DAL,114,-7,Regular Season
22019,1610612761,TOR,Toronto Raptors,0021900318,2019-12-05T00:00:00Z,TOR vs. HOU,109,-10,1610612745,HOU,Houston Rockets,HOU @ TOR,119,10,Regular Season
22019,1610612740,NOP,New Orleans Pelicans,0021900319,2019-12-05T00:00:00Z,NOP vs. PHX,132,-7,1610612756,PHX,Phoenix Suns,PHX @ NOP,139,7,Regular Season
22019,1610612752,NYK,New York Knicks,0021900317,2019-12-05T00:00:00Z,NYK vs. DEN,92,-37,1610612743,DEN,Denver Nuggets,DEN @ NYK,129,37,Regular Season
22019,1610612764,WAS,Washington Wizards,0021900316,2019-12-05T00:00:00Z,WAS vs. PHI,119,6,1610612755,PHI,Philadelphia 76ers,PHI @ WAS,113,-6,Regular Season
22019,1610612766,CHA,Charlotte Hornets,0021900320,2019-12-06T00:00:00Z,CHA vs. BKN,104,-7,1610612751,BKN,Brooklyn Nets,BKN @ CHA,111,7,Regular Season
22019,1610612749,MIL,Milwaukee Bucks,0021900327,2019-12-06T00:00:00Z,MIL vs. LAC,119,28,1610612746,LAC,LA Clippers,LAC @ MIL,91,-28,Regular Season
22019,1610612757,POR,Portland Trail Blazers,0021900329,2019-12-06T00:00:00Z,POR vs. LAL,113,-23,1610612747,LAL,Los Angeles Lakers,LAL @ POR,136,23,Regular Season
22019,1610612760,OKC,Oklahoma City Thunder,0021900326,2019-12-06T00:00:00Z,OKC vs. MIN,139,12,1610612750,MIN,Minnesota Timberwolves,MIN @ OKC,127,-12,Regular Season
22019,1610612748,MIA,Miami Heat,0021900324,2019-12-06T00:00:00Z,MIA vs. WAS,112,9,1610612764,WAS,Washington Wizards,WAS @ MIA,103,-9,Regular Season
22019,1610612739,CLE,Cleveland Cavaliers,0021900321,2019-12-06T00:00:00Z,CLE vs. ORL,87,-6,1610612753,ORL,Orlando Magic,ORL @ CLE,93,6,Regular Season
22019,1610612738,BOS,Boston Celtics,0021900323,2019-12-06T00:00:00Z,BOS vs. DEN,108,13,1610612743,DEN,Denver Nuggets,DEN @ BOS,95,-13,Regular Season
22019,1610612741,CHI,Chicago Bulls,0021900325,2019-12-06T00:00:00Z,CHI vs. GSW,98,-2,1610612744,GSW,Golden State Warriors,GSW @ CHI,100,2,Regular Season
22019,1610612759,SAS,San Antonio Spurs,0021900328,2019-12-06T00:00:00Z,SAS vs. SAC,105,1,1610612758,SAC,Sacramento Kings,SAC @ SAS,104,-1,Regular Season
22019,1610612765,DET,Detroit Pistons,0021900322,2019-12-06T00:00:00Z,DET vs. IND,108,7,1610612754,IND,Indiana Pacers,IND @ DET,101,-7,Regular Season
22019,1610612745,HOU,Houston Rockets,0021900333,2019-12-07T00:00:00Z,HOU vs. PHX,115,6,1610612756,PHX,Phoenix Suns,PHX @ HOU,109,-6,Regular Season
22019,1610612752,NYK,New York Knicks,0021900331,2019-12-07T00:00:00Z,NYK vs. IND,103,-1,1610612754,IND,Indiana Pacers,IND @ NYK,104,1,Regular Season
22019,1610612762,UTA,Utah Jazz,0021900334,2019-12-07T00:00:00Z,UTA vs. MEM,126,14,1610612763,MEM,Memphis Grizzlies,MEM @ UTA,112,-14,Regular Season
22019,1610612742,DAL,Dallas Mavericks,0021900330,2019-12-07T00:00:00Z,DAL vs. NOP,130,46,1610612740,NOP,New Orleans Pelicans,NOP @ DAL,84,-46,Regular Season
22019,1610612755,PHI,Philadelphia 76ers,0021900332,2019-12-07T00:00:00Z,PHI vs. CLE,141,47,1610612739,CLE,Cleveland Cavaliers,CLE @ PHI,94,-47,Regular Season
22019,1610612748,MIA,Miami Heat,0021900337,2019-12-08T00:00:00Z,MIA vs. CHI,110,5,1610612741,CHI,Chicago Bulls,CHI @ MIA,105,-5,Regular Season
22019,1610612757,POR,Portland Trail Blazers,0021900341,2019-12-08T00:00:00Z,POR vs. OKC,96,-12,1610612760,OKC,Oklahoma City Thunder,OKC @ POR,108,12,Regular Season
22019,1610612755,PHI,Philadelphia 76ers,0021900338,2019-12-08T00:00:00Z,PHI vs. TOR,110,6,1610612761,TOR,Toronto Raptors,TOR @ PHI,104,-6,Regular Season
22019,1610612764,WAS,Washington Wizards,0021900339,2019-12-08T00:00:00Z,WAS vs. LAC,119,-16,1610612746,LAC,LA Clippers,LAC @ WAS,135,16,Regular Season
22019,1610612766,CHA,Charlotte Hornets,0021900336,2019-12-08T00:00:00Z,CHA vs. ATL,107,-15,1610612737,ATL,Atlanta Hawks,ATL @ CHA,122,15,Regular Season
22019,1610612742,DAL,Dallas Mavericks,0021900340,2019-12-08T00:00:00Z,DAL vs. SAC,106,-4,1610612758,SAC,Sacramento Kings,SAC @ DAL,110,4,Regular Season
22019,1610612747,LAL,Los Angeles Lakers,0021900342,2019-12-08T00:00:00Z,LAL vs. MIN,142,17,1610612750,MIN,Minnesota Timberwolves,MIN @ LAL,125,-17,Regular Season
22019,1610612751,BKN,Brooklyn Nets,0021900335,2019-12-08T00:00:00Z,BKN vs. DEN,105,3,1610612743,DEN,Denver Nuggets,DEN @ BKN,102,-3,Regular Season
22019,1610612738,BOS,Boston Celtics,0021900344,2019-12-09T00:00:00Z,BOS vs. CLE,110,22,1610612739,CLE,Cleveland Cavaliers,CLE @ BOS,88,-22,Regular Season
22019,1610612741,CHI,Chicago Bulls,0021900345,2019-12-09T00:00:00Z,CHI vs. TOR,92,-1,1610612761,TOR,Toronto Raptors,TOR @ CHI,93,1,Regular Season
22019,1610612762,UTA,Utah Jazz,0021900350,2019-12-09T00:00:00Z,UTA vs. OKC,90,-14,1610612760,OKC,Oklahoma City Thunder,OKC @ UTA,104,14,Regular Season
22019,1610612749,MIL,Milwaukee Bucks,0021900347,2019-12-09T00:00:00Z,MIL vs. ORL,110,9,1610612753,ORL,Orlando Magic,ORL @ MIL,101,-9,Regular Season
22019,1610612744,GSW,Golden State Warriors,0021900351,2019-12-09T00:00:00Z,GSW vs. MEM,102,-8,1610612763,MEM,Memphis Grizzlies,MEM @ GSW,110,8,Regular Season
22019,1610612754,IND,Indiana Pacers,0021900343,2019-12-09T00:00:00Z,IND vs. LAC,99,-11,1610612746,LAC,LA Clippers,LAC @ IND,110,11,Regular Season
22019,1610612740,NOP,New Orleans Pelicans,0021900348,2019-12-09T00:00:00Z,NOP vs. DET,103,-2,1610612765,DET,Detroit Pistons,DET @ NOP,105,2,Regular Season
22019,1610612756,PHX,Phoenix Suns,0021900349,2019-12-09T00:00:00Z,PHX vs. MIN,125,16,1610612750,MIN,Minnesota Timberwolves,MIN @ PHX,109,-16,Regular Season
22019,1610612745,HOU,Houston Rockets,0021900346,2019-12-09T00:00:00Z,HOU vs. SAC,118,-1,1610612758,SAC,Sacramento Kings,SAC @ HOU,119,1,Regular Season
22019,1610612766,CHA,Charlotte Hornets,0021900352,2019-12-10T00:00:00Z,CHA vs. WAS,114,7,1610612764,WAS,Washington Wizards,WAS @ CHA,107,-7,Regular Season
22019,1610612748,MIA,Miami Heat,0021900354,2019-12-10T00:00:00Z,MIA vs. ATL,135,14,1610612737,ATL,Atlanta Hawks,ATL @ MIA,121,-14,Regular Season
22019,1610612755,PHI,Philadelphia 76ers,0021900353,2019-12-10T00:00:00Z,PHI vs. DEN,97,5,1610612743,DEN,Denver Nuggets,DEN @ PHI,92,-5,Regular Season
22019,1610612757,POR,Portland Trail Blazers,0021900355,2019-12-10T00:00:00Z,POR vs. NYK,115,28,1610612752,NYK,New York Knicks,NYK @ POR,87,-28,Regular Season
22019,1610612739,CLE,Cleveland Cavaliers,0021900356,2019-12-11T00:00:00Z,CLE vs. HOU,110,-6,1610612745,HOU,Houston Rockets,HOU @ CLE,116,6,Regular Season
22019,1610612761,TOR,Toronto Raptors,0021900359,2019-12-11T00:00:00Z,TOR vs. LAC,92,-20,1610612746,LAC,LA Clippers,LAC @ TOR,112,20,Regular Season
22019,1610612744,GSW,Golden State Warriors,0021900366,2019-12-11T00:00:00Z,GSW vs. NYK,122,-2,1610612752,NYK,New York Knicks,NYK @ GSW,124,2,Regular Season
22019,1610612756,PHX,Phoenix Suns,0021900363,2019-12-11T00:00:00Z,PHX vs. MEM,108,-7,1610612763,MEM,Memphis Grizzlies,MEM @ PHX,115,7,Regular Season
22019,1610612754,IND,Indiana Pacers,0021900357,2019-12-11T00:00:00Z,IND vs. BOS,122,5,1610612738,BOS,Boston Celtics,BOS @ IND,117,-5,Regular Season
22019,1610612750,MIN,Minnesota Timberwolves,0021900362,2019-12-11T00:00:00Z,MIN vs. UTA,116,-11,1610612762,UTA,Utah Jazz,UTA @ MIN,127,11,Regular Season
22019,1610612753,ORL,Orlando Magic,0021900358,2019-12-11T00:00:00Z,ORL vs. LAL,87,-9,1610612747,LAL,Los Angeles Lakers,LAL @ ORL,96,9,Regular Season
22019,1610612741,CHI,Chicago Bulls,0021900361,2019-12-11T00:00:00Z,CHI vs. ATL,136,34,1610612737,ATL,Atlanta Hawks,ATL @ CHI,102,-34,Regular Season
22019,1610612749,MIL,Milwaukee Bucks,0021900364,2019-12-11T00:00:00Z,MIL vs. NOP,127,15,1610612740,NOP,New Orleans Pelicans,NOP @ MIL,112,-15,Regular Season
22019,1610612758,SAC,Sacramento Kings,0021900365,2019-12-11T00:00:00Z,SAC vs. OKC,94,1,1610612760,OKC,Oklahoma City Thunder,OKC @ SAC,93,-1,Regular Season
22019,1610612751,BKN,Brooklyn Nets,0021900360,2019-12-11T00:00:00Z,BKN vs. CHA,108,-5,1610612766,CHA,Charlotte Hornets,CHA @ BKN,113,5,Regular Season
22019,1610612738,BOS,Boston Celtics,0021900367,2019-12-12T00:00:00Z,BOS vs. PHI,109,-6,1610612755,PHI,Philadelphia 76ers,PHI @ BOS,115,6,Regular Season
22019,1610612759,SAS,San Antonio Spurs,0021900368,2019-12-12T00:00:00Z,SAS vs. CLE,109,-8,1610612739,CLE,Cleveland Cavaliers,CLE @ SAS,117,8,Regular Season
22019,1610612743,DEN,Denver Nuggets,0021900370,2019-12-12T00:00:00Z,DEN vs. POR,114,15,1610612757,POR,Portland Trail Blazers,POR @ DEN,99,-15,Regular Season
22019,1610612765,DET,Detroit Pistons,0021900369,2019-12-12T00:00:00Z,DET vs. DAL,111,-11,1610612742,DAL,Dallas Mavericks,DAL @ DET,122,11,Regular Season
22019,1610612753,ORL,Orlando Magic,0021900371,2019-12-13T00:00:00Z,ORL vs. HOU,107,-23,1610612745,HOU,Houston Rockets,HOU @ ORL,130,23,Regular Season
22019,1610612741,CHI,Chicago Bulls,0021900375,2019-12-13T00:00:00Z,CHI vs. CHA,73,-10,1610612766,CHA,Charlotte Hornets,CHA @ CHI,83,10,Regular Season
22019,1610612763,MEM,Memphis Grizzlies,0021900376,2019-12-13T00:00:00Z,MEM vs. MIL,114,-13,1610612749,MIL,Milwaukee Bucks,MIL @ MEM,127,13,Regular Season
22019,1610612762,UTA,Utah Jazz,0021900379,2019-12-13T00:00:00Z,UTA vs. GSW,114,8,1610612744,GSW,Golden State Warriors,GSW @ UTA,106,-8,Regular Season
22019,1610612755,PHI,Philadelphia 76ers,0021900372,2019-12-13T00:00:00Z,PHI vs. NOP,116,7,1610612740,NOP,New Orleans Pelicans,NOP @ PHI,109,-7,Regular Season
22019,1610612750,MIN,Minnesota Timberwolves,0021900377,2019-12-13T00:00:00Z,MIN vs. LAC,117,-7,1610612746,LAC,LA Clippers,LAC @ MIN,124,7,Regular Season
22019,1610612737,ATL,Atlanta Hawks,0021900373,2019-12-13T00:00:00Z,ATL vs. IND,100,-10,1610612754,IND,Indiana Pacers,IND @ ATL,110,10,Regular Season
22019,1610612748,MIA,Miami Heat,0021900374,2019-12-13T00:00:00Z,MIA vs. LAL,110,-3,1610612747,LAL,Los Angeles Lakers,LAL @ MIA,113,3,Regular Season
22019,1610612758,SAC,Sacramento Kings,0021900378,2019-12-13T00:00:00Z,SAC vs. NYK,101,-2,1610612752,NYK,New York Knicks,NYK @ SAC,103,2,Regular Season
22019,1610612756,PHX,Phoenix Suns,0021900380,2019-12-14T00:00:00Z,PHX vs. SAS,119,-2,1610612759,SAS,San Antonio Spurs,SAS @ PHX,121,2,Regular Season
22019,1610612742,DAL,Dallas Mavericks,0021900384,2019-12-14T00:00:00Z,DAL vs. MIA,118,-4,1610612748,MIA,Miami Heat,MIA @ DAL,122,4,Regular Season
22019,1610612745,HOU,Houston Rockets,0021900386,2019-12-14T00:00:00Z,HOU vs. DET,107,-8,1610612765,DET,Detroit Pistons,DET @ HOU,115,8,Regular Season
22019,1610612741,CHI,Chicago Bulls,0021900382,2019-12-14T00:00:00Z,CHI vs. LAC,109,3,1610612746,LAC,LA Clippers,LAC @ CHI,106,-3,Regular Season
22019,1610612761,TOR,Toronto Raptors,0021900381,2019-12-14T00:00:00Z,TOR vs. BKN,110,8,1610612751,BKN,Brooklyn Nets,BKN @ TOR,102,-8,Regular Season
22019,1610612743,DEN,Denver Nuggets,0021900387,2019-12-14T00:00:00Z,DEN vs. OKC,110,8,1610612760,OKC,Oklahoma City Thunder,OKC @ DEN,102,-8,Regular Season
22019,1610612763,MEM,Memphis Grizzlies,0021900383,2019-12-14T00:00:00Z,MEM vs. WAS,128,17,1610612764,WAS,Washington Wizards,WAS @ MEM,111,-17,Regular Season
22019,1610612749,MIL,Milwaukee Bucks,0021900385,2019-12-14T00:00:00Z,MIL vs. CLE,125,17,1610612739,CLE,Cleveland Cavaliers,CLE @ MIL,108,-17,Regular Season
22019,1610612737,ATL,Atlanta Hawks,0021900390,2019-12-15T00:00:00Z,ATL vs. LAL,96,-5,1610612747,LAL,Los Angeles Lakers,LAL @ ATL,101,5,Regular Season
22019,1610612744,GSW,Golden State Warriors,0021900393,2019-12-15T00:00:00Z,GSW vs. SAC,79,-21,1610612758,SAC,Sacramento Kings,SAC @ GSW,100,21,Regular Season
22019,1610612740,NOP,New Orleans Pelicans,0021900388,2019-12-15T00:00:00Z,NOP vs. ORL,119,-11,1610612753,ORL,Orlando Magic,ORL @ NOP,130,11,Regular Season
22019,1610612751,BKN,Brooklyn Nets,0021900391,2019-12-15T00:00:00Z,BKN vs. PHI,109,20,1610612755,PHI,Philadelphia 76ers,PHI @ BKN,89,-20,Regular Season
22019,1610612743,DEN,Denver Nuggets,0021900392,2019-12-15T00:00:00Z,DEN vs. NYK,111,6,1610612752,NYK,New York Knicks,NYK @ DEN,105,-6,Regular Season
22019,1610612754,IND,Indiana Pacers,0021900389,2019-12-15T00:00:00Z,IND vs. CHA,107,22,1610612766,CHA,Charlotte Hornets,CHA @ IND,85,-22,Regular Season
22019,1610612765,DET,Detroit Pistons,0021900394,2019-12-16T00:00:00Z,DET vs. WAS,119,-14,1610612764,WAS,Washington Wizards,WAS @ DET,133,14,Regular Season
22019,1610612756,PHX,Phoenix Suns,0021900400,2019-12-16T00:00:00Z,PHX vs. POR,110,-1,1610612757,POR,Portland Trail Blazers,POR @ PHX,111,1,Regular Season
22019,1610612745,HOU,Houston Rockets,0021900396,2019-12-16T00:00:00Z,HOU vs. SAS,109,2,1610612759,SAS,San Antonio Spurs,SAS @ HOU,107,-2,Regular Season
22019,1610612763,MEM,Memphis Grizzlies,0021900397,2019-12-16T00:00:00Z,MEM vs. MIA,118,7,1610612748,MIA,Miami Heat,MIA @ MEM,111,-7,Regular Season
22019,1610612761,TOR,Toronto Raptors,0021900395,2019-12-16T00:00:00Z,TOR vs. CLE,133,20,1610612739,CLE,Cleveland Cavaliers,CLE @ TOR,113,-20,Regular Season
22019,1610612760,OKC,Oklahoma City Thunder,0021900399,2019-12-16T00:00:00Z,OKC vs. CHI,109,3,1610612741,CHI,Chicago Bulls,CHI @ OKC,106,-3,Regular Season
22019,1610612749,MIL,Milwaukee Bucks,0021900398,2019-12-16T00:00:00Z,MIL vs. DAL,116,-4,1610612742,DAL,Dallas Mavericks,DAL @ MIL,120,4,Regular Season
22019,1610612746,LAC,LA Clippers,0021900406,2019-12-17T00:00:00Z,LAC vs. PHX,120,21,1610612756,PHX,Phoenix Suns,PHX @ LAC,99,-21,Regular Season
22019,1610612766,CHA,Charlotte Hornets,0021900401,2019-12-17T00:00:00Z,CHA vs. SAC,110,8,1610612758,SAC,Sacramento Kings,SAC @ CHA,102,-8,Regular Season
22019,1610612740,NOP,New Orleans Pelicans,0021900404,2019-12-17T00:00:00Z,NOP vs. BKN,101,-7,1610612751,BKN,Brooklyn Nets,BKN @ NOP,108,7,Regular Season
22019,1610612754,IND,Indiana Pacers,0021900402,2019-12-17T00:00:00Z,IND vs. LAL,105,3,1610612747,LAL,Los Angeles Lakers,LAL @ IND,102,-3,Regular Season
22019,1610612762,UTA,Utah Jazz,0021900405,2019-12-17T00:00:00Z,UTA vs. ORL,109,7,1610612753,ORL,Orlando Magic,ORL @ UTA,102,-7,Regular Season
22019,1610612752,NYK,New York Knicks,0021900403,2019-12-17T00:00:00Z,NYK vs. ATL,143,23,1610612737,ATL,Atlanta Hawks,ATL @ NYK,120,-23,Regular Season
22019,1610612757,POR,Portland Trail Blazers,0021900415,2019-12-18T00:00:00Z,POR vs. GSW,122,10,1610612744,GSW,Golden State Warriors,GSW @ POR,112,-10,Regular Season
22019,1610612764,WAS,Washington Wizards,0021900409,2019-12-18T00:00:00Z,WAS vs. CHI,109,-1,1610612741,CHI,Chicago Bulls,CHI @ WAS,110,1,Regular Season
22019,1610612750,MIN,Minnesota Timberwolves,0021900411,2019-12-18T00:00:00Z,MIN vs. NOP,99,-8,1610612740,NOP,New Orleans Pelicans,NOP @ MIN,107,8,Regular Season
22019,1610612765,DET,Detroit Pistons,0021900408,2019-12-18T00:00:00Z,DET vs. TOR,99,-13,1610612761,TOR,Toronto Raptors,TOR @ DET,112,13,Regular Season
22019,1610612739,CLE,Cleveland Cavaliers,0021900407,2019-12-18T00:00:00Z,CLE vs. CHA,100,2,1610612766,CHA,Charlotte Hornets,CHA @ CLE,98,-2,Regular Season
22019,1610612760,OKC,Oklahoma City Thunder,0021900412,2019-12-18T00:00:00Z,OKC vs. MEM,126,4,1610612763,MEM,Memphis Grizzlies,MEM @ OKC,122,-4,Regular Season
22019,1610612742,DAL,Dallas Mavericks,0021900413,2019-12-18T00:00:00Z,DAL vs. BOS,103,-6,1610612738,BOS,Boston Celtics,BOS @ DAL,109,6,Regular Season
22019,1610612755,PHI,Philadelphia 76ers,0021900410,2019-12-18T00:00:00Z,PHI vs. MIA,104,-4,1610612748,MIA,Miami Heat,MIA @ PHI,108,4,Regular Season
22019,1610612743,DEN,Denver Nuggets,0021900414,2019-12-18T00:00:00Z,DEN vs. ORL,113,9,1610612753,ORL,Orlando Magic,ORL @ DEN,104,-9,Regular Season
22019,1610612746,LAC,LA Clippers,0021900419,2019-12-19T00:00:00Z,LAC vs. HOU,117,-5,1610612745,HOU,Houston Rockets,HOU @ LAC,122,5,Regular Season
22019,1610612737,ATL,Atlanta Hawks,0021900416,2019-12-19T00:00:00Z,ATL vs. UTA,106,-5,1610612762,UTA,Utah Jazz,UTA @ ATL,111,5,Regular Season
22019,1610612749,MIL,Milwaukee Bucks,0021900417,2019-12-19T00:00:00Z,MIL vs. LAL,111,7,1610612747,LAL,Los Angeles Lakers,LAL @ MIL,104,-7,Regular Season
22019,1610612759,SAS,San Antonio Spurs,0021900418,2019-12-19T00:00:00Z,SAS vs. BKN,118,13,1610612751,BKN,Brooklyn Nets,BKN @ SAS,105,-13,Regular Season
22019,1610612738,BOS,Boston Celtics,0021900422,2019-12-20T00:00:00Z,BOS vs. DET,114,21,1610612765,DET,Detroit Pistons,DET @ BOS,93,-21,Regular Season
22019,1610612761,TOR,Toronto Raptors,0021900423,2019-12-20T00:00:00Z,TOR vs. WAS,122,4,1610612764,WAS,Washington Wizards,WAS @ TOR,118,-4,Regular Season
22019,1610612743,DEN,Denver Nuggets,0021900427,2019-12-20T00:00:00Z,DEN vs. MIN,109,9,1610612750,MIN,Minnesota Timberwolves,MIN @ DEN,100,-9,Regular Season
22019,1610612760,OKC,Oklahoma City Thunder,0021900426,2019-12-20T00:00:00Z,OKC vs. PHX,126,18,1610612756,PHX,Phoenix Suns,PHX @ OKC,108,-18,Regular Season
22019,1610612754,IND,Indiana Pacers,0021900421,2019-12-20T00:00:00Z,IND vs. SAC,119,14,1610612758,SAC,Sacramento Kings,SAC @ IND,105,-14,Regular Season
22019,1610612739,CLE,Cleveland Cavaliers,0021900420,2019-12-20T00:00:00Z,CLE vs. MEM,114,7,1610612763,MEM,Memphis Grizzlies,MEM @ CLE,107,-7,Regular Season
22019,1610612755,PHI,Philadelphia 76ers,0021900425,2019-12-20T00:00:00Z,PHI vs. DAL,98,-19,1610612742,DAL,Dallas Mavericks,DAL @ PHI,117,19,Regular Season
22019,1610612748,MIA,Miami Heat,0021900424,2019-12-20T00:00:00Z,MIA vs. NYK,129,15,1610612752,NYK,New York Knicks,NYK @ MIA,114,-15,Regular Season
22019,1610612744,GSW,Golden State Warriors,0021900429,2019-12-20T00:00:00Z,GSW vs. NOP,106,4,1610612740,NOP,New Orleans Pelicans,NOP @ GSW,102,-4,Regular Season
22019,1610612757,POR,Portland Trail Blazers,0021900428,2019-12-20T00:00:00Z,POR vs. ORL,118,15,1610612753,ORL,Orlando Magic,ORL @ POR,103,-15,Regular Season
22019,1610612763,MEM,Memphis Grizzlies,0021900435,2019-12-21T00:00:00Z,MEM vs. SAC,119,4,1610612758,SAC,Sacramento Kings,SAC @ MEM,115,-4,Regular Season
22019,1610612766,CHA,Charlotte Hornets,0021900430,2019-12-21T00:00:00Z,CHA vs. UTA,107,-7,1610612762,UTA,Utah Jazz,UTA @ CHA,114,7,Regular Season
22019,1610612765,DET,Detroit Pistons,0021900432,2019-12-21T00:00:00Z,DET vs. CHI,107,-12,1610612741,CHI,Chicago Bulls,CHI @ DET,119,12,Regular Season
22019,1610612759,SAS,San Antonio Spurs,0021900436,2019-12-21T00:00:00Z,SAS vs. LAC,109,-25,1610612746,LAC,LA Clippers,LAC @ SAS,134,25,Regular Season
22019,1610612752,NYK,New York Knicks,0021900434,2019-12-21T00:00:00Z,NYK vs. MIL,102,-21,1610612749,MIL,Milwaukee Bucks,MIL @ NYK,123,21,Regular Season
22019,1610612756,PHX,Phoenix Suns,0021900437,2019-12-21T00:00:00Z,PHX vs. HOU,125,-14,1610612745,HOU,Houston Rockets,HOU @ PHX,139,14,Regular Season
22019,1610612757,POR,Portland Trail Blazers,0021900438,2019-12-21T00:00:00Z,POR vs. MIN,113,7,1610612750,MIN,Minnesota Timberwolves,MIN @ POR,106,-7,Regular Season
22019,1610612751,BKN,Brooklyn Nets,0021900431,2019-12-21T00:00:00Z,BKN vs. ATL,122,10,1610612737,ATL,Atlanta Hawks,ATL @ BKN,112,-10,Regular Season
22019,1610612755,PHI,Philadelphia 76ers,0021900433,2019-12-21T00:00:00Z,PHI vs. WAS,125,17,1610612764,WAS,Washington Wizards,WAS @ PHI,108,-17,Regular Season
22019,1610612747,LAL,Los Angeles Lakers,0021900443,2019-12-22T00:00:00Z,LAL vs. DEN,104,-24,1610612743,DEN,Denver Nuggets,DEN @ LAL,128,24,Regular Season
22019,1610612749,MIL,Milwaukee Bucks,0021900441,2019-12-22T00:00:00Z,MIL vs. IND,117,28,1610612754,IND,Indiana Pacers,IND @ MIL,89,-28,Regular Season
22019,1610612760,OKC,Oklahoma City Thunder,0021900442,2019-12-22T00:00:00Z,OKC vs. LAC,118,6,1610612746,LAC,LA Clippers,LAC @ OKC,112,-6,Regular Season
22019,1610612738,BOS,Boston Celtics,0021900440,2019-12-22T00:00:00Z,BOS vs. CHA,119,26,1610612766,CHA,Charlotte Hornets,CHA @ BOS,93,-26,Regular Season
22019,1610612761,TOR,Toronto Raptors,0021900439,2019-12-22T00:00:00Z,TOR vs. DAL,110,3,1610612742,DAL,Dallas Mavericks,DAL @ TOR,107,-3,Regular Season
22019,1610612744,GSW,Golden State Warriors,0021900454,2019-12-23T00:00:00Z,GSW vs. MIN,113,9,1610612750,MIN,Minnesota Timberwolves,MIN @ GSW,104,-9,Regular Season
22019,1610612756,PHX,Phoenix Suns,0021900451,2019-12-23T00:00:00Z,PHX vs. DEN,111,-2,1610612743,DEN,Denver Nuggets,DEN @ PHX,113,2,Regular Season
22019,1610612753,ORL,Orlando Magic,0021900448,2019-12-23T00:00:00Z,ORL vs. CHI,103,8,1610612741,CHI,Chicago Bulls,CHI @ ORL,95,-8,Regular Season
22019,1610612757,POR,Portland Trail Blazers,0021900452,2019-12-23T00:00:00Z,POR vs. NOP,94,-8,1610612740,NOP,New Orleans Pelicans,NOP @ POR,102,8,Regular Season
22019,1610612765,DET,Detroit Pistons,0021900445,2019-12-23T00:00:00Z,DET vs. PHI,109,-16,1610612755,PHI,Philadelphia 76ers,PHI @ DET,125,16,Regular Season
22019,1610612752,NYK,New York Knicks,0021900447,2019-12-23T00:00:00Z,NYK vs. WAS,115,-6,1610612764,WAS,Washington Wizards,WAS @ NYK,121,6,Regular Season
22019,1610612754,IND,Indiana Pacers,0021900446,2019-12-23T00:00:00Z,IND vs. TOR,120,5,1610612761,TOR,Toronto Raptors,TOR @ IND,115,-5,Regular Season
22019,1610612748,MIA,Miami Heat,0021900449,2019-12-23T00:00:00Z,MIA vs. UTA,107,3,1610612762,UTA,Utah Jazz,UTA @ MIA,104,-3,Regular Season
22019,1610612758,SAC,Sacramento Kings,0021900453,2019-12-23T00:00:00Z,SAC vs. HOU,104,-9,1610612745,HOU,Houston Rockets,HOU @ SAC,113,9,Regular Season
22019,1610612763,MEM,Memphis Grizzlies,0021900450,2019-12-23T00:00:00Z,MEM vs. SAS,115,-30,1610612759,SAS,San Antonio Spurs,SAS @ MEM,145,30,Regular Season
22019,1610612739,CLE,Cleveland Cavaliers,0021900444,2019-12-23T00:00:00Z,CLE vs. ATL,121,3,1610612737,ATL,Atlanta Hawks,ATL @ CLE,118,-3,Regular Season
22019,1610612743,DEN,Denver Nuggets,0021900459,2019-12-25T00:00:00Z,DEN vs. NOP,100,-12,1610612740,NOP,New Orleans Pelicans,NOP @ DEN,112,12,Regular Season
22019,1610612761,TOR,Toronto Raptors,0021900455,2019-12-25T00:00:00Z,TOR vs. BOS,102,-16,1610612738,BOS,Boston Celtics,BOS @ TOR,118,16,Regular Season
22019,1610612744,GSW,Golden State Warriors,0021900457,2019-12-25T00:00:00Z,GSW vs. HOU,116,12,1610612745,HOU,Houston Rockets,HOU @ GSW,104,-12,Regular Season
22019,1610612747,LAL,Los Angeles Lakers,0021900458,2019-12-25T00:00:00Z,LAL vs. LAC,106,-5,1610612746,LAC,LA Clippers,LAC @ LAL,111,5,Regular Season
22019,1610612755,PHI,Philadelphia 76ers,0021900456,2019-12-25T00:00:00Z,PHI vs. MIL,121,12,1610612749,MIL,Milwaukee Bucks,MIL @ PHI,109,-12,Regular Season
22019,1610612760,OKC,Oklahoma City Thunder,0021900462,2019-12-26T00:00:00Z,OKC vs. MEM,97,-13,1610612763,MEM,Memphis Grizzlies,MEM @ OKC,110,13,Regular Season
22019,1610612758,SAC,Sacramento Kings,0021900464,2019-12-26T00:00:00Z,SAC vs. MIN,104,-1,1610612750,MIN,Minnesota Timberwolves,MIN @ SAC,105,1,Regular Season
22019,1610612751,BKN,Brooklyn Nets,0021900461,2019-12-26T00:00:00Z,BKN vs. NYK,82,-12,1610612752,NYK,New York Knicks,NYK @ BKN,94,12,Regular Season
22019,1610612762,UTA,Utah Jazz,0021900465,2019-12-26T00:00:00Z,UTA vs. POR,121,6,1610612757,POR,Portland Trail Blazers,POR @ UTA,115,-6,Regular Season
22019,1610612765,DET,Detroit Pistons,0021900460,2019-12-26T00:00:00Z,DET vs. WAS,132,30,1610612764,WAS,Washington Wizards,WAS @ DET,102,-30,Regular Season
22019,1610612742,DAL,Dallas Mavericks,0021900463,2019-12-26T00:00:00Z,DAL vs. SAS,102,4,1610612759,SAS,San Antonio Spurs,SAS @ DAL,98,-4,Regular Season
22019,1610612744,GSW,Golden State Warriors,0021900471,2019-12-27T00:00:00Z,GSW vs. PHX,105,9,1610612756,PHX,Phoenix Suns,PHX @ GSW,96,-9,Regular Season
22019,1610612748,MIA,Miami Heat,0021900470,2019-12-27T00:00:00Z,MIA vs. IND,113,1,1610612754,IND,Indiana Pacers,IND @ MIA,112,-1,Regular Season
22019,1610612753,ORL,Orlando Magic,0021900468,2019-12-27T00:00:00Z,ORL vs. PHI,98,1,1610612755,PHI,Philadelphia 76ers,PHI @ ORL,97,-1,Regular Season
22019,1610612766,CHA,Charlotte Hornets,0021900467,2019-12-27T00:00:00Z,CHA vs. OKC,102,-2,1610612760,OKC,Oklahoma City Thunder,OKC @ CHA,104,2,Regular Season
22019,1610612737,ATL,Atlanta Hawks,0021900469,2019-12-27T00:00:00Z,ATL vs. MIL,86,-26,1610612749,MIL,Milwaukee Bucks,MIL @ ATL,112,26,Regular Season
22019,1610612738,BOS,Boston Celtics,0021900466,2019-12-27T00:00:00Z,BOS vs. CLE,129,12,1610612739,CLE,Cleveland Cavaliers,CLE @ BOS,117,-12,Regular Season
22019,1610612750,MIN,Minnesota Timberwolves,0021900479,2019-12-28T00:00:00Z,MIN vs. CLE,88,-6,1610612739,CLE,Cleveland Cavaliers,CLE @ MIN,94,6,Regular Season
22019,1610612759,SAS,San Antonio Spurs,0021900481,2019-12-28T00:00:00Z,SAS vs. DET,136,27,1610612765,DET,Detroit Pistons,DET @ SAS,109,-27,Regular Season
22019,1610612741,CHI,Chicago Bulls,0021900477,2019-12-28T00:00:00Z,CHI vs. ATL,116,35,1610612737,ATL,Atlanta Hawks,ATL @ CHI,81,-35,Regular Season
22019,1610612745,HOU,Houston Rockets,0021900478,2019-12-28T00:00:00Z,HOU vs. BKN,108,10,1610612751,BKN,Brooklyn Nets,BKN @ HOU,98,-10,Regular Season
22019,1610612743,DEN,Denver Nuggets,0021900472,2019-12-28T00:00:00Z,DEN vs. MEM,119,9,1610612763,MEM,Memphis Grizzlies,MEM @ DEN,110,-9,Regular Season
22019,1610612749,MIL,Milwaukee Bucks,0021900480,2019-12-28T00:00:00Z,MIL vs. ORL,111,11,1610612753,ORL,Orlando Magic,ORL @ MIL,100,-11,Regular Season
22019,1610612740,NOP,New Orleans Pelicans,0021900474,2019-12-28T00:00:00Z,NOP vs. IND,120,22,1610612754,IND,Indiana Pacers,IND @ NOP,98,-22,Regular Season
22019,1610612738,BOS,Boston Celtics,0021900473,2019-12-28T00:00:00Z,BOS vs. TOR,97,-16,1610612761,TOR,Toronto Raptors,TOR @ BOS,113,16,Regular Season
22019,1610612748,MIA,Miami Heat,0021900475,2019-12-28T00:00:00Z,MIA vs. PHI,117,1,1610612755,PHI,Philadelphia 76ers,PHI @ MIA,116,-1,Regular Season
22019,1610612758,SAC,Sacramento Kings,0021900483,2019-12-28T00:00:00Z,SAC vs. PHX,110,-2,1610612756,PHX,Phoenix Suns,PHX @ SAC,112,2,Regular Season
22019,1610612746,LAC,LA Clippers,0021900485,2019-12-28T00:00:00Z,LAC vs. UTA,107,-13,1610612762,UTA,Utah Jazz,UTA @ LAC,120,13,Regular Season
22019,1610612744,GSW,Golden State Warriors,0021900482,2019-12-28T00:00:00Z,GSW vs. DAL,121,-20,1610612742,DAL,Dallas Mavericks,DAL @ GSW,141,20,Regular Season
22019,1610612757,POR,Portland Trail Blazers,0021900484,2019-12-28T00:00:00Z,POR vs. LAL,120,-8,1610612747,LAL,Los Angeles Lakers,LAL @ POR,128,8,Regular Season
22019,1610612764,WAS,Washington Wizards,0021900476,2019-12-28T00:00:00Z,WAS vs. NYK,100,-7,1610612752,NYK,New York Knicks,NYK @ WAS,107,7,Regular Season
22019,1610612763,MEM,Memphis Grizzlies,0021900487,2019-12-29T00:00:00Z,MEM vs. CHA,117,13,1610612766,CHA,Charlotte Hornets,CHA @ MEM,104,-13,Regular Season
22019,1610612761,TOR,Toronto Raptors,0021900486,2019-12-29T00:00:00Z,TOR vs. OKC,97,-1,1610612760,OKC,Oklahoma City Thunder,OKC @ TOR,98,1,Regular Season
22019,1610612740,NOP,New Orleans Pelicans,0021900488,2019-12-29T00:00:00Z,NOP vs. HOU,127,15,1610612745,HOU,Houston Rockets,HOU @ NOP,112,-15,Regular Season
22019,1610612747,LAL,Los Angeles Lakers,0021900490,2019-12-29T00:00:00Z,LAL vs. DAL,108,13,1610612742,DAL,Dallas Mavericks,DAL @ LAL,95,-13,Regular Season
22019,1610612743,DEN,Denver Nuggets,0021900489,2019-12-29T00:00:00Z,DEN vs. SAC,120,5,1610612758,SAC,Sacramento Kings,SAC @ DEN,115,-5,Regular Season
22019,1610612750,MIN,Minnesota Timberwolves,0021900494,2019-12-30T00:00:00Z,MIN vs. BKN,122,7,1610612751,BKN,Brooklyn Nets,BKN @ MIN,115,-7,Regular Season
22019,1610612764,WAS,Washington Wizards,0021900492,2019-12-30T00:00:00Z,WAS vs. MIA,123,18,1610612748,MIA,Miami Heat,MIA @ WAS,105,-18,Regular Season
22019,1610612741,CHI,Chicago Bulls,0021900493,2019-12-30T00:00:00Z,CHI vs. MIL,102,-21,1610612749,MIL,Milwaukee Bucks,MIL @ CHI,123,21,Regular Season
22019,1610612753,ORL,Orlando Magic,0021900491,2019-12-30T00:00:00Z,ORL vs. ATL,93,-8,1610612737,ATL,Atlanta Hawks,ATL @ ORL,101,8,Regular Season
22019,1610612762,UTA,Utah Jazz,0021900495,2019-12-30T00:00:00Z,UTA vs. DET,104,23,1610612765,DET,Detroit Pistons,DET @ UTA,81,-23,Regular Season
22019,1610612757,POR,Portland Trail Blazers,0021900496,2019-12-30T00:00:00Z,POR vs. PHX,116,-6,1610612756,PHX,Phoenix Suns,PHX @ POR,122,6,Regular Season
22019,1610612754,IND,Indiana Pacers,0021900498,2019-12-31T00:00:00Z,IND vs. PHI,115,18,1610612755,PHI,Philadelphia 76ers,PHI @ IND,97,-18,Regular Season
22019,1610612745,HOU,Houston Rockets,0021900501,2019-12-31T00:00:00Z,HOU vs. DEN,130,26,1610612743,DEN,Denver Nuggets,DEN @ HOU,104,-26,Regular Season
22019,1610612766,CHA,Charlotte Hornets,0021900497,2019-12-31T00:00:00Z,CHA vs. BOS,92,-17,1610612738,BOS,Boston Celtics,BOS @ CHA,109,17,Regular Season
22019,1610612761,TOR,Toronto Raptors,0021900500,2019-12-31T00:00:00Z,TOR vs. CLE,117,20,1610612739,CLE,Cleveland Cavaliers,CLE @ TOR,97,-20,Regular Season
22019,1610612760,OKC,Oklahoma City Thunder,0021900503,2019-12-31T00:00:00Z,OKC vs. DAL,106,5,1610612742,DAL,Dallas Mavericks,DAL @ OKC,101,-5,Regular Season
22019,1610612759,SAS,San Antonio Spurs,0021900502,2019-12-31T00:00:00Z,SAS vs. GSW,117,4,1610612744,GSW,Golden State Warriors,GSW @ SAS,113,-4,Regular Season
22019,1610612758,SAC,Sacramento Kings,0021900499,2019-12-31T00:00:00Z,SAC vs. LAC,87,-18,1610612746,LAC,LA Clippers,LAC @ SAC,105,18,Regular Season
22019,1610612749,MIL,Milwaukee Bucks,0021900506,2020-01-01T00:00:00Z,MIL vs. MIN,106,2,1610612750,MIN,Minnesota Timberwolves,MIN @ MIL,104,-2,Regular Season
22019,1610612752,NYK,New York Knicks,0021900505,2020-01-01T00:00:00Z,NYK vs. POR,117,24,1610612757,POR,Portland Trail Blazers,POR @ NYK,93,-24,Regular Season
22019,1610612747,LAL,Los Angeles Lakers,0021900507,2020-01-01T00:00:00Z,LAL vs. PHX,117,10,1610612756,PHX,Phoenix Suns,PHX @ LAL,107,-10,Regular Season
22019,1610612764,WAS,Washington Wizards,0021900504,2020-01-01T00:00:00Z,WAS vs. ORL,101,-21,1610612753,ORL,Orlando Magic,ORL @ WAS,122,21,Regular Season
22019,1610612750,MIN,Minnesota Timberwolves,0021900512,2020-01-02T00:00:00Z,MIN vs. GSW,99,15,1610612744,GSW,Golden State Warriors,GSW @ MIN,84,-15,Regular Season
22019,1610612741,CHI,Chicago Bulls,0021900511,2020-01-02T00:00:00Z,CHI vs. UTA,98,-4,1610612762,UTA,Utah Jazz,UTA @ CHI,102,4,Regular Season
22019,1610612754,IND,Indiana Pacers,0021900509,2020-01-02T00:00:00Z,IND vs. DEN,116,-8,1610612743,DEN,Denver Nuggets,DEN @ IND,124,8,Regular Season
22019,1610612759,SAS,San Antonio Spurs,0021900514,2020-01-02T00:00:00Z,SAS vs. OKC,103,-6,1610612760,OKC,Oklahoma City Thunder,OKC @ SAS,109,6,Regular Season
22019,1610612739,CLE,Cleveland Cavaliers,0021900508,2020-01-02T00:00:00Z,CLE vs. CHA,106,-3,1610612766,CHA,Charlotte Hornets,CHA @ CLE,109,3,Regular Season
22019,1610612748,MIA,Miami Heat,0021900510,2020-01-02T00:00:00Z,MIA vs. TOR,84,8,1610612761,TOR,Toronto Raptors,TOR @ MIA,76,-8,Regular Season
22019,1610612746,LAC,LA Clippers,0021900516,2020-01-02T00:00:00Z,LAC vs. DET,126,14,1610612765,DET,Detroit Pistons,DET @ LAC,112,-14,Regular Season
22019,1610612758,SAC,Sacramento Kings,0021900515,2020-01-02T00:00:00Z,SAC vs. MEM,128,5,1610612763,MEM,Memphis Grizzlies,MEM @ SAC,123,-5,Regular Season
22019,1610612742,DAL,Dallas Mavericks,0021900513,2020-01-02T00:00:00Z,DAL vs. BKN,123,12,1610612751,BKN,Brooklyn Nets,BKN @ DAL,111,-12,Regular Season
22019,1610612747,LAL,Los Angeles Lakers,0021900522,2020-01-03T00:00:00Z,LAL vs. NOP,123,10,1610612740,NOP,New Orleans Pelicans,NOP @ LAL,113,-10,Regular Season
22019,1610612764,WAS,Washington Wizards,0021900519,2020-01-03T00:00:00Z,WAS vs. POR,103,-19,1610612757,POR,Portland Trail Blazers,POR @ WAS,122,19,Regular Season
22019,1610612738,BOS,Boston Celtics,0021900517,2020-01-03T00:00:00Z,BOS vs. ATL,109,3,1610612737,ATL,Atlanta Hawks,ATL @ BOS,106,-3,Regular Season
22019,1610612753,ORL,Orlando Magic,0021900518,2020-01-03T00:00:00Z,ORL vs. MIA,105,20,1610612748,MIA,Miami Heat,MIA @ ORL,85,-20,Regular Season
22019,1610612745,HOU,Houston Rockets,0021900520,2020-01-03T00:00:00Z,HOU vs. PHI,118,10,1610612755,PHI,Philadelphia 76ers,PHI @ HOU,108,-10,Regular Season
22019,1610612756,PHX,Phoenix Suns,0021900521,2020-01-03T00:00:00Z,PHX vs. NYK,120,8,1610612752,NYK,New York Knicks,NYK @ PHX,112,-8,Regular Season
22019,1610612758,SAC,Sacramento Kings,0021900533,2020-01-04T00:00:00Z,SAC vs. NOP,115,-2,1610612740,NOP,New Orleans Pelicans,NOP @ SAC,117,2,Regular Season
22019,1610612749,MIL,Milwaukee Bucks,0021900531,2020-01-04T00:00:00Z,MIL vs. SAS,127,9,1610612759,SAS,San Antonio Spurs,SAS @ MIL,118,-9,Regular Season
22019,1610612741,CHI,Chicago Bulls,0021900529,2020-01-04T00:00:00Z,CHI vs. BOS,104,-7,1610612738,BOS,Boston Celtics,BOS @ CHI,111,7,Regular Season
22019,1610612742,DAL,Dallas Mavericks,0021900530,2020-01-04T00:00:00Z,DAL vs. CHA,120,-3,1610612766,CHA,Charlotte Hornets,CHA @ DAL,123,3,Regular Season
22019,1610612739,CLE,Cleveland Cavaliers,0021900527,2020-01-04T00:00:00Z,CLE vs. OKC,106,-15,1610612760,OKC,Oklahoma City Thunder,OKC @ CLE,121,15,Regular Season
22019,1610612753,ORL,Orlando Magic,0021900525,2020-01-04T00:00:00Z,ORL vs. UTA,96,-13,1610612762,UTA,Utah Jazz,UTA @ ORL,109,13,Regular Season
22019,1610612744,GSW,Golden State Warriors,0021900532,2020-01-04T00:00:00Z,GSW vs. DET,104,-7,1610612765,DET,Detroit Pistons,DET @ GSW,111,7,Regular Season
22019,1610612746,LAC,LA Clippers,0021900523,2020-01-04T00:00:00Z,LAC vs. MEM,114,-26,1610612763,MEM,Memphis Grizzlies,MEM @ LAC,140,26,Regular Season
22019,1610612764,WAS,Washington Wizards,0021900528,2020-01-04T00:00:00Z,WAS vs. DEN,128,14,1610612743,DEN,Denver Nuggets,DEN @ WAS,114,-14,Regular Season
22019,1610612751,BKN,Brooklyn Nets,0021900524,2020-01-04T00:00:00Z,BKN vs. TOR,102,-19,1610612761,TOR,Toronto Raptors,TOR @ BKN,121,19,Regular Season
22019,1610612737,ATL,Atlanta Hawks,0021900526,2020-01-04T00:00:00Z,ATL vs. IND,116,5,1610612754,IND,Indiana Pacers,IND @ ATL,111,-5,Regular Season
22019,1610612756,PHX,Phoenix Suns,0021900537,2020-01-05T00:00:00Z,PHX vs. MEM,114,-7,1610612763,MEM,Memphis Grizzlies,MEM @ PHX,121,7,Regular Season
22019,1610612746,LAC,LA Clippers,0021900534,2020-01-05T00:00:00Z,LAC vs. NYK,135,3,1610612752,NYK,New York Knicks,NYK @ LAC,132,-3,Regular Season
22019,1610612748,MIA,Miami Heat,0021900535,2020-01-05T00:00:00Z,MIA vs. POR,122,11,1610612757,POR,Portland Trail Blazers,POR @ MIA,111,-11,Regular Season
22019,1610612739,CLE,Cleveland Cavaliers,0021900536,2020-01-05T00:00:00Z,CLE vs. MIN,103,-15,1610612750,MIN,Minnesota Timberwolves,MIN @ CLE,118,15,Regular Season
22019,1610612747,LAL,Los Angeles Lakers,0021900538,2020-01-05T00:00:00Z,LAL vs. DET,106,7,1610612765,DET,Detroit Pistons,DET @ LAL,99,-7,Regular Season
22019,1610612764,WAS,Washington Wizards,0021900542,2020-01-06T00:00:00Z,WAS vs. BOS,99,5,1610612738,BOS,Boston Celtics,BOS @ WAS,94,-5,Regular Season
22019,1610612753,ORL,Orlando Magic,0021900540,2020-01-06T00:00:00Z,ORL vs. BKN,101,12,1610612751,BKN,Brooklyn Nets,BKN @ ORL,89,-12,Regular Season
22019,1610612758,SAC,Sacramento Kings,0021900547,2020-01-06T00:00:00Z,SAC vs. GSW,111,13,1610612744,GSW,Golden State Warriors,GSW @ SAC,98,-13,Regular Season
22019,1610612740,NOP,New Orleans Pelicans,0021900544,2020-01-06T00:00:00Z,NOP vs. UTA,126,-2,1610612762,UTA,Utah Jazz,UTA @ NOP,128,2,Regular Season
22019,1610612759,SAS,San Antonio Spurs,0021900546,2020-01-06T00:00:00Z,SAS vs. MIL,126,22,1610612749,MIL,Milwaukee Bucks,MIL @ SAS,104,-22,Regular Season
22019,1610612766,CHA,Charlotte Hornets,0021900539,2020-01-06T00:00:00Z,CHA vs. IND,104,-11,1610612754,IND,Indiana Pacers,IND @ CHA,115,11,Regular Season
22019,1610612737,ATL,Atlanta Hawks,0021900543,2020-01-06T00:00:00Z,ATL vs. DEN,115,-8,1610612743,DEN,Denver Nuggets,DEN @ ATL,123,8,Regular Season
22019,1610612742,DAL,Dallas Mavericks,0021900545,2020-01-06T00:00:00Z,DAL vs. CHI,118,8,1610612741,CHI,Chicago Bulls,CHI @ DAL,110,-8,Regular Season
22019,1610612755,PHI,Philadelphia 76ers,0021900541,2020-01-06T00:00:00Z,PHI vs. OKC,120,7,1610612760,OKC,Oklahoma City Thunder,OKC @ PHI,113,-7,Regular Season
22019,1610612747,LAL,Los Angeles Lakers,0021900553,2020-01-07T00:00:00Z,LAL vs. NYK,117,30,1610612752,NYK,New York Knicks,NYK @ LAL,87,-30,Regular Season
22019,1610612739,CLE,Cleveland Cavaliers,0021900548,2020-01-07T00:00:00Z,CLE vs. DET,113,-2,1610612765,DET,Detroit Pistons,DET @ CLE,115,2,Regular Season
22019,1610612751,BKN,Brooklyn Nets,0021900550,2020-01-07T00:00:00Z,BKN vs. OKC,103,-8,1610612760,OKC,Oklahoma City Thunder,OKC @ BKN,111,8,Regular Season
22019,1610612756,PHX,Phoenix Suns,0021900552,2020-01-07T00:00:00Z,PHX vs. SAC,103,-11,1610612758,SAC,Sacramento Kings,SAC @ PHX,114,11,Regular Season
22019,1610612761,TOR,Toronto Raptors,0021900549,2020-01-07T00:00:00Z,TOR vs. POR,99,-2,1610612757,POR,Portland Trail Blazers,POR @ TOR,101,2,Regular Season
22019,1610612763,MEM,Memphis Grizzlies,0021900551,2020-01-07T00:00:00Z,MEM vs. MIN,119,7,1610612750,MIN,Minnesota Timberwolves,MIN @ MEM,112,-7,Regular Season
22019,1610612762,UTA,Utah Jazz,0021900561,2020-01-08T00:00:00Z,UTA vs. NYK,128,24,1610612752,NYK,New York Knicks,NYK @ UTA,104,-24,Regular Season
22019,1610612754,IND,Indiana Pacers,0021900556,2020-01-08T00:00:00Z,IND vs. MIA,108,-14,1610612748,MIA,Miami Heat,MIA @ IND,122,14,Regular Season
22019,1610612753,ORL,Orlando Magic,0021900557,2020-01-08T00:00:00Z,ORL vs. WAS,123,34,1610612764,WAS,Washington Wizards,WAS @ ORL,89,-34,Regular Season
22019,1610612738,BOS,Boston Celtics,0021900554,2020-01-08T00:00:00Z,BOS vs. SAS,114,-15,1610612759,SAS,San Antonio Spurs,SAS @ BOS,129,15,Regular Season
22019,1610612744,GSW,Golden State Warriors,0021900562,2020-01-08T00:00:00Z,GSW vs. MIL,98,-9,1610612749,MIL,Milwaukee Bucks,MIL @ GSW,107,9,Regular Season
22019,1610612742,DAL,Dallas Mavericks,0021900559,2020-01-08T00:00:00Z,DAL vs. DEN,106,-1,1610612743,DEN,Denver Nuggets,DEN @ DAL,107,1,Regular Season
22019,1610612740,NOP,New Orleans Pelicans,0021900560,2020-01-08T00:00:00Z,NOP vs. CHI,123,15,1610612741,CHI,Chicago Bulls,CHI @ NOP,108,-15,Regular Season
22019,1610612737,ATL,Atlanta Hawks,0021900558,2020-01-08T00:00:00Z,ATL vs. HOU,115,-7,1610612745,HOU,Houston Rockets,HOU @ ATL,122,7,Regular Season
22019,1610612766,CHA,Charlotte Hornets,0021900555,2020-01-08T00:00:00Z,CHA vs. TOR,110,-2,1610612761,TOR,Toronto Raptors,TOR @ CHA,112,2,Regular Season
22019,1610612760,OKC,Oklahoma City Thunder,0021900566,2020-01-09T00:00:00Z,OKC vs. HOU,113,21,1610612745,HOU,Houston Rockets,HOU @ OKC,92,-21,Regular Season
22019,1610612765,DET,Detroit Pistons,0021900563,2020-01-09T00:00:00Z,DET vs. CLE,112,-3,1610612739,CLE,Cleveland Cavaliers,CLE @ DET,115,3,Regular Season
22019,1610612755,PHI,Philadelphia 76ers,0021900564,2020-01-09T00:00:00Z,PHI vs. BOS,109,11,1610612738,BOS,Boston Celtics,BOS @ PHI,98,-11,Regular Season
22019,1610612750,MIN,Minnesota Timberwolves,0021900565,2020-01-09T00:00:00Z,MIN vs. POR,116,14,1610612757,POR,Portland Trail Blazers,POR @ MIN,102,-14,Regular Season
22019,1610612758,SAC,Sacramento Kings,0021900575,2020-01-10T00:00:00Z,SAC vs. MIL,106,-21,1610612749,MIL,Milwaukee Bucks,MIL @ SAC,127,21,Regular Season
22019,1610612756,PHX,Phoenix Suns,0021900573,2020-01-10T00:00:00Z,PHX vs. ORL,98,4,1610612753,ORL,Orlando Magic,ORL @ PHX,94,-4,Regular Season
22019,1610612742,DAL,Dallas Mavericks,0021900572,2020-01-10T00:00:00Z,DAL vs. LAL,114,-15,1610612747,LAL,Los Angeles Lakers,LAL @ DAL,129,15,Regular Season
22019,1610612762,UTA,Utah Jazz,0021900574,2020-01-10T00:00:00Z,UTA vs. CHA,109,17,1610612766,CHA,Charlotte Hornets,CHA @ UTA,92,-17,Regular Season
22019,1610612751,BKN,Brooklyn Nets,0021900568,2020-01-10T00:00:00Z,BKN vs. MIA,117,4,1610612748,MIA,Miami Heat,MIA @ BKN,113,-4,Regular Season
22019,1610612741,CHI,Chicago Bulls,0021900570,2020-01-10T00:00:00Z,CHI vs. IND,105,-11,1610612754,IND,Indiana Pacers,IND @ CHI,116,11,Regular Season
22019,1610612763,MEM,Memphis Grizzlies,0021900571,2020-01-10T00:00:00Z,MEM vs. SAS,134,13,1610612759,SAS,San Antonio Spurs,SAS @ MEM,121,-13,Regular Season
22019,1610612746,LAC,LA Clippers,0021900576,2020-01-10T00:00:00Z,LAC vs. GSW,109,9,1610612744,GSW,Golden State Warriors,GSW @ LAC,100,-9,Regular Season
22019,1610612764,WAS,Washington Wizards,0021900567,2020-01-10T00:00:00Z,WAS vs. ATL,111,10,1610612737,ATL,Atlanta Hawks,ATL @ WAS,101,-10,Regular Season
22019,1610612752,NYK,New York Knicks,0021900569,2020-01-10T00:00:00Z,NYK vs. NOP,111,-12,1610612740,NOP,New Orleans Pelicans,NOP @ NYK,123,12,Regular Season
22019,1610612738,BOS,Boston Celtics,0021900578,2020-01-11T00:00:00Z,BOS vs. NOP,140,35,1610612740,NOP,New Orleans Pelicans,NOP @ BOS,105,-35,Regular Season
22019,1610612745,HOU,Houston Rockets,0021900577,2020-01-11T00:00:00Z,HOU vs. MIN,139,30,1610612750,MIN,Minnesota Timberwolves,MIN @ HOU,109,-30,Regular Season
22019,1610612742,DAL,Dallas Mavericks,0021900581,2020-01-11T00:00:00Z,DAL vs. PHI,109,18,1610612755,PHI,Philadelphia 76ers,PHI @ DAL,91,-18,Regular Season
22019,1610612765,DET,Detroit Pistons,0021900579,2020-01-11T00:00:00Z,DET vs. CHI,99,-9,1610612741,CHI,Chicago Bulls,CHI @ DET,108,9,Regular Season
22019,1610612760,OKC,Oklahoma City Thunder,0021900580,2020-01-11T00:00:00Z,OKC vs. LAL,110,-15,1610612747,LAL,Los Angeles Lakers,LAL @ OKC,125,15,Regular Season
22019,1610612743,DEN,Denver Nuggets,0021900582,2020-01-11T00:00:00Z,DEN vs. CLE,103,-8,1610612739,CLE,Cleveland Cavaliers,CLE @ DEN,111,8,Regular Season
22019,1610612757,POR,Portland Trail Blazers,0021900583,2020-01-11T00:00:00Z,POR vs. MIL,101,-21,1610612749,MIL,Milwaukee Bucks,MIL @ POR,122,21,Regular Season
22019,1610612761,TOR,Toronto Raptors,0021900587,2020-01-12T00:00:00Z,TOR vs. SAS,104,-1,1610612759,SAS,San Antonio Spurs,SAS @ TOR,105,1,Regular Season
22019,1610612763,MEM,Memphis Grizzlies,0021900588,2020-01-12T00:00:00Z,MEM vs. GSW,122,20,1610612744,GSW,Golden State Warriors,GSW @ MEM,102,-20,Regular Season
22019,1610612764,WAS,Washington Wizards,0021900585,2020-01-12T00:00:00Z,WAS vs. UTA,116,-11,1610612762,UTA,Utah Jazz,UTA @ WAS,127,11,Regular Season
22019,1610612752,NYK,New York Knicks,0021900584,2020-01-12T00:00:00Z,NYK vs. MIA,124,3,1610612748,MIA,Miami Heat,MIA @ NYK,121,-3,Regular Season
22019,1610612751,BKN,Brooklyn Nets,0021900586,2020-01-12T00:00:00Z,BKN vs. ATL,108,22,1610612737,ATL,Atlanta Hawks,ATL @ BKN,86,-22,Regular Season
22019,1610612743,DEN,Denver Nuggets,0021900589,2020-01-12T00:00:00Z,DEN vs. LAC,114,10,1610612746,LAC,LA Clippers,LAC @ DEN,104,-10,Regular Season
22019,1610612756,PHX,Phoenix Suns,0021900590,2020-01-12T00:00:00Z,PHX vs. CHA,100,8,1610612766,CHA,Charlotte Hornets,CHA @ PHX,92,-8,Regular Season
22019,1610612765,DET,Detroit Pistons,0021900591,2020-01-13T00:00:00Z,DET vs. NOP,110,-7,1610612740,NOP,New Orleans Pelicans,NOP @ DET,117,7,Regular Season
22019,1610612747,LAL,Los Angeles Lakers,0021900597,2020-01-13T00:00:00Z,LAL vs. CLE,128,29,1610612739,CLE,Cleveland Cavaliers,CLE @ LAL,99,-29,Regular Season
22019,1610612754,IND,Indiana Pacers,0021900592,2020-01-13T00:00:00Z,IND vs. PHI,101,6,1610612755,PHI,Philadelphia 76ers,PHI @ IND,95,-6,Regular Season
22019,1610612758,SAC,Sacramento Kings,0021900596,2020-01-13T00:00:00Z,SAC vs. ORL,112,-2,1610612753,ORL,Orlando Magic,ORL @ SAC,114,2,Regular Season
22019,1610612757,POR,Portland Trail Blazers,0021900595,2020-01-13T00:00:00Z,POR vs. CHA,115,3,1610612766,CHA,Charlotte Hornets,CHA @ POR,112,-3,Regular Season
22019,1610612750,MIN,Minnesota Timberwolves,0021900594,2020-01-13T00:00:00Z,MIN vs. OKC,104,-13,1610612760,OKC,Oklahoma City Thunder,OKC @ MIN,117,13,Regular Season
22019,1610612738,BOS,Boston Celtics,0021900593,2020-01-13T00:00:00Z,BOS vs. CHI,113,12,1610612741,CHI,Chicago Bulls,CHI @ BOS,101,-12,Regular Season
22019,1610612744,GSW,Golden State Warriors,0021900602,2020-01-14T00:00:00Z,GSW vs. DAL,97,-27,1610612742,DAL,Dallas Mavericks,DAL @ GSW,124,27,Regular Season
22019,1610612751,BKN,Brooklyn Nets,0021900599,2020-01-14T00:00:00Z,BKN vs. UTA,107,-11,1610612762,UTA,Utah Jazz,UTA @ BKN,118,11,Regular Season
22019,1610612763,MEM,Memphis Grizzlies,0021900600,2020-01-14T00:00:00Z,MEM vs. HOU,121,11,1610612745,HOU,Houston Rockets,HOU @ MEM,110,-11,Regular Season
22019,1610612749,MIL,Milwaukee Bucks,0021900601,2020-01-14T00:00:00Z,MIL vs. NYK,128,26,1610612752,NYK,New York Knicks,NYK @ MIL,102,-26,Regular Season
22019,1610612737,ATL,Atlanta Hawks,0021900598,2020-01-14T00:00:00Z,ATL vs. PHX,123,13,1610612756,PHX,Phoenix Suns,PHX @ ATL,110,-13,Regular Season
22019,1610612746,LAC,LA Clippers,0021900603,2020-01-14T00:00:00Z,LAC vs. CLE,128,25,1610612739,CLE,Cleveland Cavaliers,CLE @ LAC,103,-25,Regular Season
22019,1610612745,HOU,Houston Rockets,0021900611,2020-01-15T00:00:00Z,HOU vs. POR,107,-10,1610612757,POR,Portland Trail Blazers,POR @ HOU,117,10,Regular Season
22019,1610612747,LAL,Los Angeles Lakers,0021900613,2020-01-15T00:00:00Z,LAL vs. ORL,118,-1,1610612753,ORL,Orlando Magic,ORL @ LAL,119,1,Regular Season
22019,1610612750,MIN,Minnesota Timberwolves,0021900608,2020-01-15T00:00:00Z,MIN vs. IND,99,-5,1610612754,IND,Indiana Pacers,IND @ MIN,104,5,Regular Season
22019,1610612758,SAC,Sacramento Kings,0021900612,2020-01-15T00:00:00Z,SAC vs. DAL,123,-4,1610612742,DAL,Dallas Mavericks,DAL @ SAC,127,4,Regular Season
22019,1610612738,BOS,Boston Celtics,0021900604,2020-01-15T00:00:00Z,BOS vs. DET,103,-13,1610612765,DET,Detroit Pistons,DET @ BOS,116,13,Regular Season
22019,1610612748,MIA,Miami Heat,0021900606,2020-01-15T00:00:00Z,MIA vs. SAS,106,6,1610612759,SAS,San Antonio Spurs,SAS @ MIA,100,-6,Regular Season
22019,1610612760,OKC,Oklahoma City Thunder,0021900609,2020-01-15T00:00:00Z,OKC vs. TOR,121,-9,1610612761,TOR,Toronto Raptors,TOR @ OKC,130,9,Regular Season
22019,1610612743,DEN,Denver Nuggets,0021900610,2020-01-15T00:00:00Z,DEN vs. CHA,100,14,1610612766,CHA,Charlotte Hornets,CHA @ DEN,86,-14,Regular Season
22019,1610612755,PHI,Philadelphia 76ers,0021900605,2020-01-15T00:00:00Z,PHI vs. BKN,117,11,1610612751,BKN,Brooklyn Nets,BKN @ PHI,106,-11,Regular Season
22019,1610612741,CHI,Chicago Bulls,0021900607,2020-01-15T00:00:00Z,CHI vs. WAS,115,9,1610612764,WAS,Washington Wizards,WAS @ CHI,106,-9,Regular Season
22019,1610612740,NOP,New Orleans Pelicans,0021900616,2020-01-16T00:00:00Z,NOP vs. UTA,138,6,1610612762,UTA,Utah Jazz,UTA @ NOP,132,-6,Regular Season
22019,1610612749,MIL,Milwaukee Bucks,0021900615,2020-01-16T00:00:00Z,MIL vs. BOS,128,5,1610612738,BOS,Boston Celtics,BOS @ MIL,123,-5,Regular Season
22019,1610612752,NYK,New York Knicks,0021900614,2020-01-16T00:00:00Z,NYK vs. PHX,98,-23,1610612756,PHX,Phoenix Suns,PHX @ NYK,121,23,Regular Season
22019,1610612746,LAC,LA Clippers,0021900618,2020-01-16T00:00:00Z,LAC vs. ORL,122,27,1610612753,ORL,Orlando Magic,ORL @ LAC,95,-27,Regular Season
22019,1610612744,GSW,Golden State Warriors,0021900617,2020-01-16T00:00:00Z,GSW vs. DEN,131,-3,1610612743,DEN,Denver Nuggets,DEN @ GSW,134,3,Regular Season
22019,1610612759,SAS,San Antonio Spurs,0021900624,2020-01-17T00:00:00Z,SAS vs. ATL,120,-1,1610612737,ATL,Atlanta Hawks,ATL @ SAS,121,1,Regular Season
22019,1610612755,PHI,Philadelphia 76ers,0021900620,2020-01-17T00:00:00Z,PHI vs. CHI,100,11,1610612741,CHI,Chicago Bulls,CHI @ PHI,89,-11,Regular Season
22019,1610612760,OKC,Oklahoma City Thunder,0021900623,2020-01-17T00:00:00Z,OKC vs. MIA,108,-7,1610612748,MIA,Miami Heat,MIA @ OKC,115,7,Regular Season
22019,1610612754,IND,Indiana Pacers,0021900619,2020-01-17T00:00:00Z,IND vs. MIN,116,2,1610612750,MIN,Minnesota Timberwolves,MIN @ IND,114,-2,Regular Season
22019,1610612763,MEM,Memphis Grizzlies,0021900622,2020-01-17T00:00:00Z,MEM vs. CLE,113,4,1610612739,CLE,Cleveland Cavaliers,CLE @ MEM,109,-4,Regular Season
22019,1610612761,TOR,Toronto Raptors,0021900621,2020-01-17T00:00:00Z,TOR vs. WAS,140,29,1610612764,WAS,Washington Wizards,WAS @ TOR,111,-29,Regular Season
22019,1610612742,DAL,Dallas Mavericks,0021900625,2020-01-17T00:00:00Z,DAL vs. POR,120,8,1610612757,POR,Portland Trail Blazers,POR @ DAL,112,-8,Regular Season
22019,1610612760,OKC,Oklahoma City Thunder,0021900635,2020-01-18T00:00:00Z,OKC vs. POR,119,13,1610612757,POR,Portland Trail Blazers,POR @ OKC,106,-13,Regular Season
22019,1610612752,NYK,New York Knicks,0021900630,2020-01-18T00:00:00Z,NYK vs. PHI,87,-3,1610612755,PHI,Philadelphia 76ers,PHI @ NYK,90,3,Regular Season
22019,1610612738,BOS,Boston Celtics,0021900628,2020-01-18T00:00:00Z,BOS vs. PHX,119,-4,1610612756,PHX,Phoenix Suns,PHX @ BOS,123,4,Regular Season
22019,1610612762,UTA,Utah Jazz,0021900636,2020-01-18T00:00:00Z,UTA vs. SAC,123,22,1610612758,SAC,Sacramento Kings,SAC @ UTA,101,-22,Regular Season
22019,1610612744,GSW,Golden State Warriors,0021900634,2020-01-18T00:00:00Z,GSW vs. ORL,109,14,1610612753,ORL,Orlando Magic,ORL @ GSW,95,-14,Regular Season
22019,1610612745,HOU,Houston Rockets,0021900633,2020-01-18T00:00:00Z,HOU vs. LAL,115,-9,1610612747,LAL,Los Angeles Lakers,LAL @ HOU,124,9,Regular Season
22019,1610612751,BKN,Brooklyn Nets,0021900627,2020-01-18T00:00:00Z,BKN vs. MIL,97,-20,1610612749,MIL,Milwaukee Bucks,MIL @ BKN,117,20,Regular Season
22019,1610612737,ATL,Atlanta Hawks,0021900629,2020-01-18T00:00:00Z,ATL vs. DET,103,-33,1610612765,DET,Detroit Pistons,DET @ ATL,136,33,Regular Season
22019,1610612750,MIN,Minnesota Timberwolves,0021900632,2020-01-18T00:00:00Z,MIN vs. TOR,112,-10,1610612761,TOR,Toronto Raptors,TOR @ MIN,122,10,Regular Season
22019,1610612740,NOP,New Orleans Pelicans,0021900626,2020-01-18T00:00:00Z,NOP vs. LAC,130,-3,1610612746,LAC,LA Clippers,LAC @ NOP,133,3,Regular Season
22019,1610612741,CHI,Chicago Bulls,0021900631,2020-01-18T00:00:00Z,CHI vs. CLE,118,2,1610612739,CLE,Cleveland Cavaliers,CLE @ CHI,116,-2,Regular Season
22019,1610612743,DEN,Denver Nuggets,0021900638,2020-01-19T00:00:00Z,DEN vs. IND,107,-8,1610612754,IND,Indiana Pacers,IND @ DEN,115,8,Regular Season
22019,1610612759,SAS,San Antonio Spurs,0021900637,2020-01-19T00:00:00Z,SAS vs. MIA,107,5,1610612748,MIA,Miami Heat,MIA @ SAS,102,-5,Regular Season
22019,1610612757,POR,Portland Trail Blazers,0021900652,2020-01-20T00:00:00Z,POR vs. GSW,129,5,1610612744,GSW,Golden State Warriors,GSW @ POR,124,-5,Regular Season
22019,1610612766,CHA,Charlotte Hornets,0021900642,2020-01-20T00:00:00Z,CHA vs. ORL,83,-23,1610612753,ORL,Orlando Magic,ORL @ CHA,106,23,Regular Season
22019,1610612738,BOS,Boston Celtics,0021900648,2020-01-20T00:00:00Z,BOS vs. LAL,139,32,1610612747,LAL,Los Angeles Lakers,LAL @ BOS,107,-32,Regular Season
22019,1610612737,ATL,Atlanta Hawks,0021900640,2020-01-20T00:00:00Z,ATL vs. TOR,117,-5,1610612761,TOR,Toronto Raptors,TOR @ ATL,122,5,Regular Season
22019,1610612739,CLE,Cleveland Cavaliers,0021900643,2020-01-20T00:00:00Z,CLE vs. NYK,86,-20,1610612752,NYK,New York Knicks,NYK @ CLE,106,20,Regular Season
22019,1610612762,UTA,Utah Jazz,0021900651,2020-01-20T00:00:00Z,UTA vs. IND,118,30,1610612754,IND,Indiana Pacers,IND @ UTA,88,-30,Regular Season
22019,1610612749,MIL,Milwaukee Bucks,0021900647,2020-01-20T00:00:00Z,MIL vs. CHI,111,13,1610612741,CHI,Chicago Bulls,CHI @ MIL,98,-13,Regular Season
22019,1610612750,MIN,Minnesota Timberwolves,0021900649,2020-01-20T00:00:00Z,MIN vs. DEN,100,-7,1610612743,DEN,Denver Nuggets,DEN @ MIN,107,7,Regular Season
22019,1610612763,MEM,Memphis Grizzlies,0021900646,2020-01-20T00:00:00Z,MEM vs. NOP,116,-10,1610612740,NOP,New Orleans Pelicans,NOP @ MEM,126,10,Regular Season
22019,1610612751,BKN,Brooklyn Nets,0021900641,2020-01-20T00:00:00Z,BKN vs. PHI,111,-6,1610612755,PHI,Philadelphia 76ers,PHI @ BKN,117,6,Regular Season
22019,1610612745,HOU,Houston Rockets,0021900645,2020-01-20T00:00:00Z,HOU vs. OKC,107,-5,1610612760,OKC,Oklahoma City Thunder,OKC @ HOU,112,5,Regular Season
22019,1610612748,MIA,Miami Heat,0021900644,2020-01-20T00:00:00Z,MIA vs. SAC,118,5,1610612758,SAC,Sacramento Kings,SAC @ MIA,113,-5,Regular Season
22019,1610612756,PHX,Phoenix Suns,0021900650,2020-01-20T00:00:00Z,PHX vs. SAS,118,-2,1610612759,SAS,San Antonio Spurs,SAS @ PHX,120,2,Regular Season
22019,1610612764,WAS,Washington Wizards,0021900639,2020-01-20T00:00:00Z,WAS vs. DET,106,6,1610612765,DET,Detroit Pistons,DET @ WAS,100,-6,Regular Season
22019,1610612742,DAL,Dallas Mavericks,0021900653,2020-01-21T00:00:00Z,DAL vs. LAC,107,-3,1610612746,LAC,LA Clippers,LAC @ DAL,110,3,Regular Season
22019,1610612744,GSW,Golden State Warriors,0021900665,2020-01-22T00:00:00Z,GSW vs. UTA,96,-33,1610612762,UTA,Utah Jazz,UTA @ GSW,129,33,Regular Season
22019,1610612756,PHX,Phoenix Suns,0021900664,2020-01-22T00:00:00Z,PHX vs. IND,87,-25,1610612754,IND,Indiana Pacers,IND @ PHX,112,25,Regular Season
22019,1610612765,DET,Detroit Pistons,0021900654,2020-01-22T00:00:00Z,DET vs. SAC,127,21,1610612758,SAC,Sacramento Kings,SAC @ DET,106,-21,Regular Season
22019,1610612753,ORL,Orlando Magic,0021900655,2020-01-22T00:00:00Z,ORL vs. OKC,114,-6,1610612760,OKC,Oklahoma City Thunder,OKC @ ORL,120,6,Regular Season
22019,1610612752,NYK,New York Knicks,0021900659,2020-01-22T00:00:00Z,NYK vs. LAL,92,-8,1610612747,LAL,Los Angeles Lakers,LAL @ NYK,100,8,Regular Season
22019,1610612737,ATL,Atlanta Hawks,0021900656,2020-01-22T00:00:00Z,ATL vs. LAC,102,7,1610612746,LAC,LA Clippers,LAC @ ATL,95,-7,Regular Season
22019,1610612741,CHI,Chicago Bulls,0021900661,2020-01-22T00:00:00Z,CHI vs. MIN,117,7,1610612750,MIN,Minnesota Timberwolves,MIN @ CHI,110,-7,Regular Season
22019,1610612748,MIA,Miami Heat,0021900658,2020-01-22T00:00:00Z,MIA vs. WAS,134,5,1610612764,WAS,Washington Wizards,WAS @ MIA,129,-5,Regular Season
22019,1610612745,HOU,Houston Rockets,0021900662,2020-01-22T00:00:00Z,HOU vs. DEN,121,16,1610612743,DEN,Denver Nuggets,DEN @ HOU,105,-16,Regular Season
22019,1610612761,TOR,Toronto Raptors,0021900660,2020-01-22T00:00:00Z,TOR vs. PHI,107,12,1610612755,PHI,Philadelphia 76ers,PHI @ TOR,95,-12,Regular Season
22019,1610612738,BOS,Boston Celtics,0021900657,2020-01-22T00:00:00Z,BOS vs. MEM,119,24,1610612763,MEM,Memphis Grizzlies,MEM @ BOS,95,-24,Regular Season
22019,1610612740,NOP,New Orleans Pelicans,0021900663,2020-01-22T00:00:00Z,NOP vs. SAS,117,-4,1610612759,SAS,San Antonio Spurs,SAS @ NOP,121,4,Regular Season
22019,1610612739,CLE,Cleveland Cavaliers,0021900666,2020-01-23T00:00:00Z,CLE vs. WAS,112,-12,1610612764,WAS,Washington Wizards,WAS @ CLE,124,12,Regular Season
22019,1610612757,POR,Portland Trail Blazers,0021900668,2020-01-23T00:00:00Z,POR vs. DAL,125,-8,1610612742,DAL,Dallas Mavericks,DAL @ POR,133,8,Regular Season
22019,1610612751,BKN,Brooklyn Nets,0021900667,2020-01-23T00:00:00Z,BKN vs. LAL,113,-15,1610612747,LAL,Los Angeles Lakers,LAL @ BKN,128,15,Regular Season
22019,1610612759,SAS,San Antonio Spurs,0021900678,2020-01-24T00:00:00Z,SAS vs. PHX,99,-4,1610612756,PHX,Phoenix Suns,PHX @ SAS,103,4,Regular Season
22019,1610612765,DET,Detroit Pistons,0021900670,2020-01-24T00:00:00Z,DET vs. MEM,112,-13,1610612763,MEM,Memphis Grizzlies,MEM @ DET,125,13,Regular Season
22019,1610612740,NOP,New Orleans Pelicans,0021900676,2020-01-24T00:00:00Z,NOP vs. DEN,106,-7,1610612743,DEN,Denver Nuggets,DEN @ NOP,113,7,Regular Season
22019,1610612741,CHI,Chicago Bulls,0021900674,2020-01-24T00:00:00Z,CHI vs. SAC,81,-17,1610612758,SAC,Sacramento Kings,SAC @ CHI,98,17,Regular Season
22019,1610612748,MIA,Miami Heat,0021900673,2020-01-24T00:00:00Z,MIA vs. LAC,117,-5,1610612746,LAC,LA Clippers,LAC @ MIA,122,5,Regular Season
22019,1610612750,MIN,Minnesota Timberwolves,0021900675,2020-01-24T00:00:00Z,MIN vs. HOU,124,-7,1610612745,HOU,Houston Rockets,HOU @ MIN,131,7,Regular Season
22019,1610612752,NYK,New York Knicks,0021900672,2020-01-24T00:00:00Z,NYK vs. TOR,112,-6,1610612761,TOR,Toronto Raptors,TOR @ NYK,118,6,Regular Season
22019,1610612753,ORL,Orlando Magic,0021900671,2020-01-24T00:00:00Z,ORL vs. BOS,98,-11,1610612738,BOS,Boston Celtics,BOS @ ORL,109,11,Regular Season
22019,1610612760,OKC,Oklahoma City Thunder,0021900677,2020-01-24T00:00:00Z,OKC vs. ATL,140,29,1610612737,ATL,Atlanta Hawks,ATL @ OKC,111,-29,Regular Season
22019,1610612744,GSW,Golden State Warriors,0021900679,2020-01-24T00:00:00Z,GSW vs. IND,118,-11,1610612754,IND,Indiana Pacers,IND @ GSW,129,11,Regular Season
22019,1610612766,CHA,Charlotte Hornets,0021900669,2020-01-24T00:00:00Z,CHA vs. MIL,103,-13,1610612749,MIL,Milwaukee Bucks,MIL @ CHA,116,13,Regular Season
22019,1610612739,CLE,Cleveland Cavaliers,0021900682,2020-01-25T00:00:00Z,CLE vs. CHI,106,-12,1610612741,CHI,Chicago Bulls,CHI @ CLE,118,12,Regular Season
22019,1610612750,MIN,Minnesota Timberwolves,0021900683,2020-01-25T00:00:00Z,MIN vs. OKC,104,-9,1610612760,OKC,Oklahoma City Thunder,OKC @ MIN,113,9,Regular Season
22019,1610612755,PHI,Philadelphia 76ers,0021900684,2020-01-25T00:00:00Z,PHI vs. LAL,108,17,1610612747,LAL,Los Angeles Lakers,LAL @ PHI,91,-17,Regular Season
22019,1610612762,UTA,Utah Jazz,0021900680,2020-01-25T00:00:00Z,UTA vs. DAL,112,5,1610612742,DAL,Dallas Mavericks,DAL @ UTA,107,-5,Regular Season
22019,1610612765,DET,Detroit Pistons,0021900681,2020-01-25T00:00:00Z,DET vs. BKN,111,-10,1610612751,BKN,Brooklyn Nets,BKN @ DET,121,10,Regular Season
22019,1610612743,DEN,Denver Nuggets,0021900685,2020-01-26T00:00:00Z,DEN vs. HOU,117,7,1610612745,HOU,Houston Rockets,HOU @ DEN,110,-7,Regular Season
22019,1610612763,MEM,Memphis Grizzlies,0021900690,2020-01-26T00:00:00Z,MEM vs. PHX,114,5,1610612756,PHX,Phoenix Suns,PHX @ MEM,109,-5,Regular Season
22019,1610612740,NOP,New Orleans Pelicans,0021900691,2020-01-26T00:00:00Z,NOP vs. BOS,123,15,1610612738,BOS,Boston Celtics,BOS @ NOP,108,-15,Regular Season
22019,1610612753,ORL,Orlando Magic,0021900689,2020-01-26T00:00:00Z,ORL vs. LAC,97,-15,1610612746,LAC,LA Clippers,LAC @ ORL,112,15,Regular Season
22019,1610612752,NYK,New York Knicks,0021900688,2020-01-26T00:00:00Z,NYK vs. BKN,110,13,1610612751,BKN,Brooklyn Nets,BKN @ NYK,97,-13,Regular Season
22019,1610612759,SAS,San Antonio Spurs,0021900686,2020-01-26T00:00:00Z,SAS vs. TOR,106,-4,1610612761,TOR,Toronto Raptors,TOR @ SAS,110,4,Regular Season
22019,1610612737,ATL,Atlanta Hawks,0021900687,2020-01-26T00:00:00Z,ATL vs. WAS,152,19,1610612764,WAS,Washington Wizards,WAS @ ATL,133,-19,Regular Season
22019,1610612757,POR,Portland Trail Blazers,0021900692,2020-01-26T00:00:00Z,POR vs. IND,139,10,1610612754,IND,Indiana Pacers,IND @ POR,129,-10,Regular Season
22019,1610612741,CHI,Chicago Bulls,0021900695,2020-01-27T00:00:00Z,CHI vs. SAS,110,1,1610612759,SAS,San Antonio Spurs,SAS @ CHI,109,-1,Regular Season
22019,1610612748,MIA,Miami Heat,0021900694,2020-01-27T00:00:00Z,MIA vs. ORL,113,21,1610612753,ORL,Orlando Magic,ORL @ MIA,92,-21,Regular Season
22019,1610612760,OKC,Oklahoma City Thunder,0021900697,2020-01-27T00:00:00Z,OKC vs. DAL,97,-10,1610612742,DAL,Dallas Mavericks,DAL @ OKC,107,10,Regular Season
22019,1610612750,MIN,Minnesota Timberwolves,0021900696,2020-01-27T00:00:00Z,MIN vs. SAC,129,-4,1610612758,SAC,Sacramento Kings,SAC @ MIN,133,4,Regular Season
22019,1610612762,UTA,Utah Jazz,0021900698,2020-01-27T00:00:00Z,UTA vs. HOU,117,-9,1610612745,HOU,Houston Rockets,HOU @ UTA,126,9,Regular Season
22019,1610612765,DET,Detroit Pistons,0021900693,2020-01-27T00:00:00Z,DET vs. CLE,100,-15,1610612739,CLE,Cleveland Cavaliers,CLE @ DET,115,15,Regular Season
22019,1610612755,PHI,Philadelphia 76ers,0021900702,2020-01-28T00:00:00Z,PHI vs. GSW,115,11,1610612744,GSW,Golden State Warriors,GSW @ PHI,104,-11,Regular Season
22019,1610612761,TOR,Toronto Raptors,0021900703,2020-01-28T00:00:00Z,TOR vs. ATL,130,16,1610612737,ATL,Atlanta Hawks,ATL @ TOR,114,-16,Regular Season
22019,1610612766,CHA,Charlotte Hornets,0021900699,2020-01-28T00:00:00Z,CHA vs. NYK,97,5,1610612752,NYK,New York Knicks,NYK @ CHA,92,-5,Regular Season
22019,1610612748,MIA,Miami Heat,0021900701,2020-01-28T00:00:00Z,MIA vs. BOS,101,-8,1610612738,BOS,Boston Celtics,BOS @ MIA,109,8,Regular Season
22019,1610612749,MIL,Milwaukee Bucks,0021900705,2020-01-28T00:00:00Z,MIL vs. WAS,151,20,1610612764,WAS,Washington Wizards,WAS @ MIL,131,-20,Regular Season
22019,1610612739,CLE,Cleveland Cavaliers,0021900700,2020-01-28T00:00:00Z,CLE vs. NOP,111,-14,1610612740,NOP,New Orleans Pelicans,NOP @ CLE,125,14,Regular Season
22019,1610612742,DAL,Dallas Mavericks,0021900706,2020-01-28T00:00:00Z,DAL vs. PHX,104,-29,1610612756,PHX,Phoenix Suns,PHX @ DAL,133,29,Regular Season
22019,1610612763,MEM,Memphis Grizzlies,0021900704,2020-01-28T00:00:00Z,MEM vs. DEN,104,8,1610612743,DEN,Denver Nuggets,DEN @ MEM,96,-8,Regular Season
22019,1610612754,IND,Indiana Pacers,0021900708,2020-01-29T00:00:00Z,IND vs. CHI,115,9,1610612741,CHI,Chicago Bulls,CHI @ IND,106,-9,Regular Season
22019,1610612759,SAS,San Antonio Spurs,0021900711,2020-01-29T00:00:00Z,SAS vs. UTA,127,7,1610612762,UTA,Utah Jazz,UTA @ SAS,120,-7,Regular Season
22019,1610612758,SAC,Sacramento Kings,0021900713,2020-01-29T00:00:00Z,SAC vs. OKC,100,-20,1610612760,OKC,Oklahoma City Thunder,OKC @ SAC,120,20,Regular Season
22019,1610612751,BKN,Brooklyn Nets,0021900709,2020-01-29T00:00:00Z,BKN vs. DET,125,10,1610612765,DET,Detroit Pistons,DET @ BKN,115,-10,Regular Season
22019,1610612757,POR,Portland Trail Blazers,0021900712,2020-01-29T00:00:00Z,POR vs. HOU,125,13,1610612745,HOU,Houston Rockets,HOU @ POR,112,-13,Regular Season
22019,1610612752,NYK,New York Knicks,0021900710,2020-01-29T00:00:00Z,NYK vs. MEM,106,-21,1610612763,MEM,Memphis Grizzlies,MEM @ NYK,127,21,Regular Season
22019,1610612737,ATL,Atlanta Hawks,0021900716,2020-01-30T00:00:00Z,ATL vs. PHI,127,10,1610612755,PHI,Philadelphia 76ers,PHI @ ATL,117,-10,Regular Season
22019,1610612739,CLE,Cleveland Cavaliers,0021900714,2020-01-30T00:00:00Z,CLE vs. TOR,109,-6,1610612761,TOR,Toronto Raptors,TOR @ CLE,115,6,Regular Season
22019,1610612743,DEN,Denver Nuggets,0021900718,2020-01-30T00:00:00Z,DEN vs. UTA,106,6,1610612762,UTA,Utah Jazz,UTA @ DEN,100,-6,Regular Season
22019,1610612738,BOS,Boston Celtics,0021900717,2020-01-30T00:00:00Z,BOS vs. GSW,119,15,1610612744,GSW,Golden State Warriors,GSW @ BOS,104,-15,Regular Season
22019,1610612746,LAC,LA Clippers,0021900719,2020-01-30T00:00:00Z,LAC vs. SAC,103,-21,1610612758,SAC,Sacramento Kings,SAC @ LAC,124,21,Regular Season
22019,1610612764,WAS,Washington Wizards,0021900715,2020-01-30T00:00:00Z,WAS vs. CHA,121,14,1610612766,CHA,Charlotte Hornets,CHA @ WAS,107,-14,Regular Season
22019,1610612756,PHX,Phoenix Suns,0021900725,2020-01-31T00:00:00Z,PHX vs. OKC,107,-4,1610612760,OKC,Oklahoma City Thunder,OKC @ PHX,111,4,Regular Season
22019,1610612751,BKN,Brooklyn Nets,0021900721,2020-01-31T00:00:00Z,BKN vs. CHI,133,15,1610612741,CHI,Chicago Bulls,CHI @ BKN,118,-15,Regular Season
22019,1610612745,HOU,Houston Rockets,0021900722,2020-01-31T00:00:00Z,HOU vs. DAL,128,7,1610612742,DAL,Dallas Mavericks,DAL @ HOU,121,-7,Regular Season
22019,1610612765,DET,Detroit Pistons,0021900720,2020-01-31T00:00:00Z,DET vs. TOR,92,-13,1610612761,TOR,Toronto Raptors,TOR @ DET,105,13,Regular Season
22019,1610612749,MIL,Milwaukee Bucks,0021900724,2020-01-31T00:00:00Z,MIL vs. DEN,115,-12,1610612743,DEN,Denver Nuggets,DEN @ MIL,127,12,Regular Season
22019,1610612747,LAL,Los Angeles Lakers,0021900726,2020-01-31T00:00:00Z,LAL vs. POR,119,-8,1610612757,POR,Portland Trail Blazers,POR @ LAL,127,8,Regular Season
22019,1610612740,NOP,New Orleans Pelicans,0021900723,2020-01-31T00:00:00Z,NOP vs. MEM,139,28,1610612763,MEM,Memphis Grizzlies,MEM @ NOP,111,-28,Regular Season
22019,1610612759,SAS,San Antonio Spurs,0021900734,2020-02-01T00:00:00Z,SAS vs. CHA,114,24,1610612766,CHA,Charlotte Hornets,CHA @ SAS,90,-24,Regular Season
22019,1610612742,DAL,Dallas Mavericks,0021900733,2020-02-01T00:00:00Z,DAL vs. ATL,123,23,1610612737,ATL,Atlanta Hawks,ATL @ DAL,100,-23,Regular Season
22019,1610612758,SAC,Sacramento Kings,0021900736,2020-02-01T00:00:00Z,SAC vs. LAL,113,-16,1610612747,LAL,Los Angeles Lakers,LAL @ SAC,129,16,Regular Season
22019,1610612739,CLE,Cleveland Cavaliers,0021900730,2020-02-01T00:00:00Z,CLE vs. GSW,112,-19,1610612744,GSW,Golden State Warriors,GSW @ CLE,131,19,Regular Season
22019,1610612753,ORL,Orlando Magic,0021900729,2020-02-01T00:00:00Z,ORL vs. MIA,89,-13,1610612748,MIA,Miami Heat,MIA @ ORL,102,13,Regular Season
22019,1610612757,POR,Portland Trail Blazers,0021900735,2020-02-01T00:00:00Z,POR vs. UTA,124,17,1610612762,UTA,Utah Jazz,UTA @ POR,107,-17,Regular Season
22019,1610612764,WAS,Washington Wizards,0021900731,2020-02-01T00:00:00Z,WAS vs. BKN,113,6,1610612751,BKN,Brooklyn Nets,BKN @ WAS,107,-6,Regular Season
22019,1610612754,IND,Indiana Pacers,0021900728,2020-02-01T00:00:00Z,IND vs. NYK,85,-7,1610612752,NYK,New York Knicks,NYK @ IND,92,7,Regular Season
22019,1610612746,LAC,LA Clippers,0021900727,2020-02-01T00:00:00Z,LAC vs. MIN,118,12,1610612750,MIN,Minnesota Timberwolves,MIN @ LAC,106,-12,Regular Season
22019,1610612738,BOS,Boston Celtics,0021900732,2020-02-01T00:00:00Z,BOS vs. PHI,116,21,1610612755,PHI,Philadelphia 76ers,PHI @ BOS,95,-21,Regular Season
22019,1610612761,TOR,Toronto Raptors,0021900740,2020-02-02T00:00:00Z,TOR vs. CHI,129,27,1610612741,CHI,Chicago Bulls,CHI @ TOR,102,-27,Regular Season
22019,1610612749,MIL,Milwaukee Bucks,0021900739,2020-02-02T00:00:00Z,MIL vs. PHX,129,21,1610612756,PHX,Phoenix Suns,PHX @ MIL,108,-21,Regular Season
22019,1610612765,DET,Detroit Pistons,0021900737,2020-02-02T00:00:00Z,DET vs. DEN,128,5,1610612743,DEN,Denver Nuggets,DEN @ DET,123,-5,Regular Season
22019,1610612745,HOU,Houston Rockets,0021900738,2020-02-02T00:00:00Z,HOU vs. NOP,117,8,1610612740,NOP,New Orleans Pelicans,NOP @ HOU,109,-8,Regular Season
22019,1610612763,MEM,Memphis Grizzlies,0021900748,2020-02-03T00:00:00Z,MEM vs. DET,96,14,1610612765,DET,Detroit Pistons,DET @ MEM,82,-14,Regular Season
22019,1610612766,CHA,Charlotte Hornets,0021900741,2020-02-03T00:00:00Z,CHA vs. ORL,100,-12,1610612753,ORL,Orlando Magic,ORL @ CHA,112,12,Regular Season
22019,1610612737,ATL,Atlanta Hawks,0021900745,2020-02-03T00:00:00Z,ATL vs. BOS,115,-8,1610612738,BOS,Boston Celtics,BOS @ ATL,123,8,Regular Season
22019,1610612758,SAC,Sacramento Kings,0021900749,2020-02-03T00:00:00Z,SAC vs. MIN,113,4,1610612750,MIN,Minnesota Timberwolves,MIN @ SAC,109,-4,Regular Season
22019,1610612754,IND,Indiana Pacers,0021900743,2020-02-03T00:00:00Z,IND vs. DAL,103,-9,1610612742,DAL,Dallas Mavericks,DAL @ IND,112,9,Regular Season
22019,1610612739,CLE,Cleveland Cavaliers,0021900742,2020-02-03T00:00:00Z,CLE vs. NYK,134,-5,1610612752,NYK,New York Knicks,NYK @ CLE,139,5,Regular Season
22019,1610612764,WAS,Washington Wizards,0021900744,2020-02-03T00:00:00Z,WAS vs. GSW,117,-8,1610612744,GSW,Golden State Warriors,GSW @ WAS,125,8,Regular Season
22019,1610612751,BKN,Brooklyn Nets,0021900746,2020-02-03T00:00:00Z,BKN vs. PHX,119,22,1610612756,PHX,Phoenix Suns,PHX @ BKN,97,-22,Regular Season
22019,1610612748,MIA,Miami Heat,0021900747,2020-02-03T00:00:00Z,MIA vs. PHI,137,31,1610612755,PHI,Philadelphia 76ers,PHI @ MIA,106,-31,Regular Season
22019,1610612746,LAC,LA Clippers,0021900750,2020-02-03T00:00:00Z,LAC vs. SAS,108,3,1610612759,SAS,San Antonio Spurs,SAS @ LAC,105,-3,Regular Season
22019,1610612745,HOU,Houston Rockets,0021900752,2020-02-04T00:00:00Z,HOU vs. CHA,125,15,1610612766,CHA,Charlotte Hornets,CHA @ HOU,110,-15,Regular Season
22019,1610612740,NOP,New Orleans Pelicans,0021900751,2020-02-04T00:00:00Z,NOP vs. MIL,108,-12,1610612749,MIL,Milwaukee Bucks,MIL @ NOP,120,12,Regular Season
22019,1610612747,LAL,Los Angeles Lakers,0021900754,2020-02-04T00:00:00Z,LAL vs. SAS,129,27,1610612759,SAS,San Antonio Spurs,SAS @ LAL,102,-27,Regular Season
22019,1610612743,DEN,Denver Nuggets,0021900753,2020-02-04T00:00:00Z,DEN vs. POR,127,28,1610612757,POR,Portland Trail Blazers,POR @ DEN,99,-28,Regular Season
22019,1610612750,MIN,Minnesota Timberwolves,0021900759,2020-02-05T00:00:00Z,MIN vs. ATL,120,-7,1610612737,ATL,Atlanta Hawks,ATL @ MIN,127,7,Regular Season
22019,1610612765,DET,Detroit Pistons,0021900755,2020-02-05T00:00:00Z,DET vs. PHX,116,8,1610612756,PHX,Phoenix Suns,PHX @ DET,108,-8,Regular Season
22019,1610612762,UTA,Utah Jazz,0021900762,2020-02-05T00:00:00Z,UTA vs. DEN,95,-3,1610612743,DEN,Denver Nuggets,DEN @ UTA,98,3,Regular Season
22019,1610612742,DAL,Dallas Mavericks,0021900761,2020-02-05T00:00:00Z,DAL vs. MEM,107,-14,1610612763,MEM,Memphis Grizzlies,MEM @ DAL,121,14,Regular Season
22019,1610612738,BOS,Boston Celtics,0021900756,2020-02-05T00:00:00Z,BOS vs. ORL,116,16,1610612753,ORL,Orlando Magic,ORL @ BOS,100,-16,Regular Season
22019,1610612760,OKC,Oklahoma City Thunder,0021900760,2020-02-05T00:00:00Z,OKC vs. CLE,109,6,1610612739,CLE,Cleveland Cavaliers,CLE @ OKC,103,-6,Regular Season
22019,1610612746,LAC,LA Clippers,0021900763,2020-02-05T00:00:00Z,LAC vs. MIA,128,17,1610612748,MIA,Miami Heat,MIA @ LAC,111,-17,Regular Season
22019,1610612751,BKN,Brooklyn Nets,0021900757,2020-02-05T00:00:00Z,BKN vs. GSW,129,41,1610612744,GSW,Golden State Warriors,GSW @ BKN,88,-41,Regular Season
22019,1610612761,TOR,Toronto Raptors,0021900758,2020-02-05T00:00:00Z,TOR vs. IND,119,1,1610612754,IND,Indiana Pacers,IND @ TOR,118,-1,Regular Season
22019,1610612741,CHI,Chicago Bulls,0021900765,2020-02-06T00:00:00Z,CHI vs. NOP,119,-6,1610612740,NOP,New Orleans Pelicans,NOP @ CHI,125,6,Regular Season
22019,1610612749,MIL,Milwaukee Bucks,0021900766,2020-02-06T00:00:00Z,MIL vs. PHI,112,11,1610612755,PHI,Philadelphia 76ers,PHI @ MIL,101,-11,Regular Season
22019,1610612757,POR,Portland Trail Blazers,0021900767,2020-02-06T00:00:00Z,POR vs. SAS,125,8,1610612759,SAS,San Antonio Spurs,SAS @ POR,117,-8,Regular Season
22019,1610612747,LAL,Los Angeles Lakers,0021900768,2020-02-06T00:00:00Z,LAL vs. HOU,111,-10,1610612745,HOU,Houston Rockets,HOU @ LAL,121,10,Regular Season
22019,1610612752,NYK,New York Knicks,0021900764,2020-02-06T00:00:00Z,NYK vs. ORL,105,2,1610612753,ORL,Orlando Magic,ORL @ NYK,103,-2,Regular Season
22019,1610612758,SAC,Sacramento Kings,0021900775,2020-02-07T00:00:00Z,SAC vs. MIA,105,8,1610612748,MIA,Miami Heat,MIA @ SAC,97,-8,Regular Season
22019,1610612762,UTA,Utah Jazz,0021900776,2020-02-07T00:00:00Z,UTA vs. POR,117,3,1610612757,POR,Portland Trail Blazers,POR @ UTA,114,-3,Regular Season
22019,1610612756,PHX,Phoenix Suns,0021900774,2020-02-07T00:00:00Z,PHX vs. HOU,127,36,1610612745,HOU,Houston Rockets,HOU @ PHX,91,-36,Regular Season
22019,1610612754,IND,Indiana Pacers,0021900772,2020-02-07T00:00:00Z,IND vs. TOR,106,-9,1610612761,TOR,Toronto Raptors,TOR @ IND,115,9,Regular Season
22019,1610612738,BOS,Boston Celtics,0021900771,2020-02-07T00:00:00Z,BOS vs. ATL,112,5,1610612737,ATL,Atlanta Hawks,ATL @ BOS,107,-5,Regular Season
22019,1610612760,OKC,Oklahoma City Thunder,0021900773,2020-02-07T00:00:00Z,OKC vs. DET,108,7,1610612765,DET,Detroit Pistons,DET @ OKC,101,-7,Regular Season
22019,1610612755,PHI,Philadelphia 76ers,0021900769,2020-02-07T00:00:00Z,PHI vs. MEM,119,12,1610612763,MEM,Memphis Grizzlies,MEM @ PHI,107,-12,Regular Season
22019,1610612764,WAS,Washington Wizards,0021900770,2020-02-07T00:00:00Z,WAS vs. DAL,119,1,1610612742,DAL,Dallas Mavericks,DAL @ WAS,118,-1,Regular Season
22019,1610612766,CHA,Charlotte Hornets,0021900778,2020-02-08T00:00:00Z,CHA vs. DAL,100,-16,1610612742,DAL,Dallas Mavericks,DAL @ CHA,116,16,Regular Season
22019,1610612761,TOR,Toronto Raptors,0021900781,2020-02-08T00:00:00Z,TOR vs. BKN,119,1,1610612751,BKN,Brooklyn Nets,BKN @ TOR,118,-1,Regular Season
22019,1610612756,PHX,Phoenix Suns,0021900784,2020-02-08T00:00:00Z,PHX vs. DEN,108,-9,1610612743,DEN,Denver Nuggets,DEN @ PHX,117,9,Regular Season
22019,1610612753,ORL,Orlando Magic,0021900777,2020-02-08T00:00:00Z,ORL vs. MIL,95,-16,1610612749,MIL,Milwaukee Bucks,MIL @ ORL,111,16,Regular Season
22019,1610612744,GSW,Golden State Warriors,0021900783,2020-02-08T00:00:00Z,GSW vs. LAL,120,-5,1610612747,LAL,Los Angeles Lakers,LAL @ GSW,125,5,Regular Season
22019,1610612765,DET,Detroit Pistons,0021900779,2020-02-08T00:00:00Z,DET vs. NYK,92,-3,1610612752,NYK,New York Knicks,NYK @ DET,95,3,Regular Season
22019,1610612758,SAC,Sacramento Kings,0021900785,2020-02-08T00:00:00Z,SAC vs. SAS,122,20,1610612759,SAS,San Antonio Spurs,SAS @ SAC,102,-20,Regular Season
22019,1610612750,MIN,Minnesota Timberwolves,0021900782,2020-02-08T00:00:00Z,MIN vs. LAC,142,27,1610612746,LAC,LA Clippers,LAC @ MIN,115,-27,Regular Season
22019,1610612754,IND,Indiana Pacers,0021900780,2020-02-08T00:00:00Z,IND vs. NOP,117,-7,1610612740,NOP,New Orleans Pelicans,NOP @ IND,124,7,Regular Season
22019,1610612755,PHI,Philadelphia 76ers,0021900788,2020-02-09T00:00:00Z,PHI vs. CHI,118,7,1610612741,CHI,Chicago Bulls,CHI @ PHI,111,-7,Regular Season
22019,1610612745,HOU,Houston Rockets,0021900790,2020-02-09T00:00:00Z,HOU vs. UTA,113,-1,1610612762,UTA,Utah Jazz,UTA @ HOU,114,1,Regular Season
22019,1610612737,ATL,Atlanta Hawks,0021900787,2020-02-09T00:00:00Z,ATL vs. NYK,140,5,1610612752,NYK,New York Knicks,NYK @ ATL,135,-5,Regular Season
22019,1610612757,POR,Portland Trail Blazers,0021900792,2020-02-09T00:00:00Z,POR vs. MIA,115,6,1610612748,MIA,Miami Heat,MIA @ POR,109,-6,Regular Season
22019,1610612739,CLE,Cleveland Cavaliers,0021900791,2020-02-09T00:00:00Z,CLE vs. LAC,92,-41,1610612746,LAC,LA Clippers,LAC @ CLE,133,41,Regular Season
22019,1610612760,OKC,Oklahoma City Thunder,0021900786,2020-02-09T00:00:00Z,OKC vs. BOS,111,-1,1610612738,BOS,Boston Celtics,BOS @ OKC,112,1,Regular Season
22019,1610612764,WAS,Washington Wizards,0021900789,2020-02-09T00:00:00Z,WAS vs. MEM,99,-7,1610612763,MEM,Memphis Grizzlies,MEM @ WAS,106,7,Regular Season
22019,1610612749,MIL,Milwaukee Bucks,0021900797,2020-02-10T00:00:00Z,MIL vs. SAC,123,12,1610612758,SAC,Sacramento Kings,SAC @ MIL,111,-12,Regular Season
22019,1610612753,ORL,Orlando Magic,0021900795,2020-02-10T00:00:00Z,ORL vs. ATL,135,9,1610612737,ATL,Atlanta Hawks,ATL @ ORL,126,-9,Regular Season
22019,1610612761,TOR,Toronto Raptors,0021900796,2020-02-10T00:00:00Z,TOR vs. MIN,137,11,1610612750,MIN,Minnesota Timberwolves,MIN @ TOR,126,-11,Regular Season
22019,1610612742,DAL,Dallas Mavericks,0021900798,2020-02-10T00:00:00Z,DAL vs. UTA,119,-4,1610612762,UTA,Utah Jazz,UTA @ DAL,123,4,Regular Season
22019,1610612747,LAL,Los Angeles Lakers,0021900801,2020-02-10T00:00:00Z,LAL vs. PHX,125,25,1610612756,PHX,Phoenix Suns,PHX @ LAL,100,-25,Regular Season
22019,1610612744,GSW,Golden State Warriors,0021900800,2020-02-10T00:00:00Z,GSW vs. MIA,101,-12,1610612748,MIA,Miami Heat,MIA @ GSW,113,12,Regular Season
22019,1610612765,DET,Detroit Pistons,0021900793,2020-02-10T00:00:00Z,DET vs. CHA,76,-11,1610612766,CHA,Charlotte Hornets,CHA @ DET,87,11,Regular Season
22019,1610612743,DEN,Denver Nuggets,0021900799,2020-02-10T00:00:00Z,DEN vs. SAS,127,7,1610612759,SAS,San Antonio Spurs,SAS @ DEN,120,-7,Regular Season
22019,1610612754,IND,Indiana Pacers,0021900794,2020-02-10T00:00:00Z,IND vs. BKN,105,-1,1610612751,BKN,Brooklyn Nets,BKN @ IND,106,1,Regular Season
22019,1610612755,PHI,Philadelphia 76ers,0021900802,2020-02-11T00:00:00Z,PHI vs. LAC,110,7,1610612746,LAC,LA Clippers,LAC @ PHI,103,-7,Regular Season
22019,1610612740,NOP,New Orleans Pelicans,0021900804,2020-02-11T00:00:00Z,NOP vs. POR,138,21,1610612757,POR,Portland Trail Blazers,POR @ NOP,117,-21,Regular Season
22019,1610612760,OKC,Oklahoma City Thunder,0021900805,2020-02-11T00:00:00Z,OKC vs. SAS,106,-8,1610612759,SAS,San Antonio Spurs,SAS @ OKC,114,8,Regular Season
22019,1610612745,HOU,Houston Rockets,0021900806,2020-02-11T00:00:00Z,HOU vs. BOS,116,11,1610612738,BOS,Boston Celtics,BOS @ HOU,105,-11,Regular Season
22019,1610612764,WAS,Washington Wizards,0021900803,2020-02-11T00:00:00Z,WAS vs. CHI,126,12,1610612741,CHI,Chicago Bulls,CHI @ WAS,114,-12,Regular Season
22019,1610612754,IND,Indiana Pacers,0021900810,2020-02-12T00:00:00Z,IND vs. MIL,118,7,1610612749,MIL,Milwaukee Bucks,MIL @ IND,111,-7,Regular Season
22019,1610612756,PHX,Phoenix Suns,0021900815,2020-02-12T00:00:00Z,PHX vs. GSW,112,6,1610612744,GSW,Golden State Warriors,GSW @ PHX,106,-6,Regular Season
22019,1610612750,MIN,Minnesota Timberwolves,0021900813,2020-02-12T00:00:00Z,MIN vs. CHA,108,-7,1610612766,CHA,Charlotte Hornets,CHA @ MIN,115,7,Regular Season
22019,1610612763,MEM,Memphis Grizzlies,0021900812,2020-02-12T00:00:00Z,MEM vs. POR,111,7,1610612757,POR,Portland Trail Blazers,POR @ MEM,104,-7,Regular Season
22019,1610612751,BKN,Brooklyn Nets,0021900809,2020-02-12T00:00:00Z,BKN vs. TOR,101,10,1610612761,TOR,Toronto Raptors,TOR @ BKN,91,-10,Regular Season
22019,1610612742,DAL,Dallas Mavericks,0021900814,2020-02-12T00:00:00Z,DAL vs. SAC,130,19,1610612758,SAC,Sacramento Kings,SAC @ DAL,111,-19,Regular Season
22019,1610612739,CLE,Cleveland Cavaliers,0021900807,2020-02-12T00:00:00Z,CLE vs. ATL,127,22,1610612737,ATL,Atlanta Hawks,ATL @ CLE,105,-22,Regular Season
22019,1610612753,ORL,Orlando Magic,0021900808,2020-02-12T00:00:00Z,ORL vs. DET,116,4,1610612765,DET,Detroit Pistons,DET @ ORL,112,-4,Regular Season
22019,1610612743,DEN,Denver Nuggets,0021900817,2020-02-12T00:00:00Z,DEN vs. LAL,116,-4,1610612747,LAL,Los Angeles Lakers,LAL @ DEN,120,4,Regular Season
22019,1610612762,UTA,Utah Jazz,0021900816,2020-02-12T00:00:00Z,UTA vs. MIA,116,15,1610612748,MIA,Miami Heat,MIA @ UTA,101,-15,Regular Season
22019,1610612752,NYK,New York Knicks,0021900811,2020-02-12T00:00:00Z,NYK vs. WAS,96,-18,1610612764,WAS,Washington Wizards,WAS @ NYK,114,18,Regular Season
22019,1610612738,BOS,Boston Celtics,0021900818,2020-02-13T00:00:00Z,BOS vs. LAC,141,8,1610612746,LAC,LA Clippers,LAC @ BOS,133,-8,Regular Season
22019,1610612740,NOP,New Orleans Pelicans,0021900819,2020-02-13T00:00:00Z,NOP vs. OKC,118,-5,1610612760,OKC,Oklahoma City Thunder,OKC @ NOP,123,5,Regular Season
22019,1610612758,SAC,Sacramento Kings,0021900824,2020-02-20T00:00:00Z,SAC vs. MEM,129,4,1610612763,MEM,Memphis Grizzlies,MEM @ SAC,125,-4,Regular Season
22019,1610612765,DET,Detroit Pistons,0021900820,2020-02-20T00:00:00Z,DET vs. MIL,106,-20,1610612749,MIL,Milwaukee Bucks,MIL @ DET,126,20,Regular Season
22019,1610612741,CHI,Chicago Bulls,0021900823,2020-02-20T00:00:00Z,CHI vs. CHA,93,-10,1610612766,CHA,Charlotte Hornets,CHA @ CHI,103,10,Regular Season
22019,1610612744,GSW,Golden State Warriors,0021900825,2020-02-20T00:00:00Z,GSW vs. HOU,105,-30,1610612745,HOU,Houston Rockets,HOU @ GSW,135,30,Regular Season
22019,1610612755,PHI,Philadelphia 76ers,0021900822,2020-02-20T00:00:00Z,PHI vs. BKN,112,8,1610612751,BKN,Brooklyn Nets,BKN @ PHI,104,-8,Regular Season
22019,1610612737,ATL,Atlanta Hawks,0021900821,2020-02-20T00:00:00Z,ATL vs. MIA,129,5,1610612748,MIA,Miami Heat,MIA @ ATL,124,-5,Regular Season
22019,1610612752,NYK,New York Knicks,0021900828,2020-02-21T00:00:00Z,NYK vs. IND,98,-8,1610612754,IND,Indiana Pacers,IND @ NYK,106,8,Regular Season
22019,1610612764,WAS,Washington Wizards,0021900827,2020-02-21T00:00:00Z,WAS vs. CLE,108,-5,1610612739,CLE,Cleveland Cavaliers,CLE @ WAS,113,5,Regular Season
22019,1610612747,LAL,Los Angeles Lakers,0021900833,2020-02-21T00:00:00Z,LAL vs. MEM,117,12,1610612763,MEM,Memphis Grizzlies,MEM @ LAL,105,-12,Regular Season
22019,1610612760,OKC,Oklahoma City Thunder,0021900831,2020-02-21T00:00:00Z,OKC vs. DEN,113,12,1610612743,DEN,Denver Nuggets,DEN @ OKC,101,-12,Regular Season
22019,1610612753,ORL,Orlando Magic,0021900826,2020-02-21T00:00:00Z,ORL vs. DAL,106,-16,1610612742,DAL,Dallas Mavericks,DAL @ ORL,122,16,Regular Season
22019,1610612750,MIN,Minnesota Timberwolves,0021900830,2020-02-21T00:00:00Z,MIN vs. BOS,117,-10,1610612738,BOS,Boston Celtics,BOS @ MIN,127,10,Regular Season
22019,1610612761,TOR,Toronto Raptors,0021900829,2020-02-21T00:00:00Z,TOR vs. PHX,118,17,1610612756,PHX,Phoenix Suns,PHX @ TOR,101,-17,Regular Season
22019,1610612762,UTA,Utah Jazz,0021900832,2020-02-21T00:00:00Z,UTA vs. SAS,104,-9,1610612759,SAS,San Antonio Spurs,SAS @ UTA,113,9,Regular Season
22019,1610612757,POR,Portland Trail Blazers,0021900834,2020-02-21T00:00:00Z,POR vs. NOP,115,-13,1610612740,NOP,New Orleans Pelicans,NOP @ POR,128,13,Regular Season
22019,1610612737,ATL,Atlanta Hawks,0021900837,2020-02-22T00:00:00Z,ATL vs. DAL,111,4,1610612742,DAL,Dallas Mavericks,DAL @ ATL,107,-4,Regular Season
22019,1610612746,LAC,LA Clippers,0021900835,2020-02-22T00:00:00Z,LAC vs. SAC,103,-9,1610612758,SAC,Sacramento Kings,SAC @ LAC,112,9,Regular Season
22019,1610612741,CHI,Chicago Bulls,0021900839,2020-02-22T00:00:00Z,CHI vs. PHX,104,-8,1610612756,PHX,Phoenix Suns,PHX @ CHI,112,8,Regular Season
22019,1610612748,MIA,Miami Heat,0021900838,2020-02-22T00:00:00Z,MIA vs. CLE,124,19,1610612739,CLE,Cleveland Cavaliers,CLE @ MIA,105,-19,Regular Season
22019,1610612749,MIL,Milwaukee Bucks,0021900840,2020-02-22T00:00:00Z,MIL vs. PHI,119,21,1610612755,PHI,Philadelphia 76ers,PHI @ MIL,98,-21,Regular Season
22019,1610612762,UTA,Utah Jazz,0021900841,2020-02-22T00:00:00Z,UTA vs. HOU,110,-10,1610612745,HOU,Houston Rockets,HOU @ UTA,120,10,Regular Season
22019,1610612766,CHA,Charlotte Hornets,0021900836,2020-02-22T00:00:00Z,CHA vs. BKN,86,-29,1610612751,BKN,Brooklyn Nets,BKN @ CHA,115,29,Regular Season
22019,1610612761,TOR,Toronto Raptors,0021900843,2020-02-23T00:00:00Z,TOR vs. IND,127,46,1610612754,IND,Indiana Pacers,IND @ TOR,81,-46,Regular Season
22019,1610612741,CHI,Chicago Bulls,0021900845,2020-02-23T00:00:00Z,CHI vs. WAS,126,9,1610612764,WAS,Washington Wizards,WAS @ CHI,117,-9,Regular Season
22019,1610612744,GSW,Golden State Warriors,0021900847,2020-02-23T00:00:00Z,GSW vs. NOP,101,-14,1610612740,NOP,New Orleans Pelicans,NOP @ GSW,115,14,Regular Season
22019,1610612743,DEN,Denver Nuggets,0021900844,2020-02-23T00:00:00Z,DEN vs. MIN,128,12,1610612750,MIN,Minnesota Timberwolves,MIN @ DEN,116,-12,Regular Season
22019,1610612747,LAL,Los Angeles Lakers,0021900842,2020-02-23T00:00:00Z,LAL vs. BOS,114,2,1610612738,BOS,Boston Celtics,BOS @ LAL,112,-2,Regular Season
22019,1610612760,OKC,Oklahoma City Thunder,0021900846,2020-02-23T00:00:00Z,OKC vs. SAS,131,28,1610612759,SAS,San Antonio Spurs,SAS @ OKC,103,-28,Regular Season
22019,1610612757,POR,Portland Trail Blazers,0021900848,2020-02-23T00:00:00Z,POR vs. DET,107,3,1610612765,DET,Detroit Pistons,DET @ POR,104,-3,Regular Season
22019,1610612751,BKN,Brooklyn Nets,0021900852,2020-02-24T00:00:00Z,BKN vs. ORL,113,-2,1610612753,ORL,Orlando Magic,ORL @ BKN,115,2,Regular Season
22019,1610612746,LAC,LA Clippers,0021900856,2020-02-24T00:00:00Z,LAC vs. MEM,124,27,1610612763,MEM,Memphis Grizzlies,MEM @ LAC,97,-27,Regular Season
22019,1610612742,DAL,Dallas Mavericks,0021900854,2020-02-24T00:00:00Z,DAL vs. MIN,139,16,1610612750,MIN,Minnesota Timberwolves,MIN @ DAL,123,-16,Regular Season
22019,1610612764,WAS,Washington Wizards,0021900851,2020-02-24T00:00:00Z,WAS vs. MIL,134,-3,1610612749,MIL,Milwaukee Bucks,MIL @ WAS,137,3,Regular Season
22019,1610612745,HOU,Houston Rockets,0021900853,2020-02-24T00:00:00Z,HOU vs. NYK,123,11,1610612752,NYK,New York Knicks,NYK @ HOU,112,-11,Regular Season
22019,1610612739,CLE,Cleveland Cavaliers,0021900849,2020-02-24T00:00:00Z,CLE vs. MIA,125,6,1610612748,MIA,Miami Heat,MIA @ CLE,119,-6,Regular Season
22019,1610612755,PHI,Philadelphia 76ers,0021900850,2020-02-24T00:00:00Z,PHI vs. ATL,129,17,1610612737,ATL,Atlanta Hawks,ATL @ PHI,112,-17,Regular Season
22019,1610612762,UTA,Utah Jazz,0021900855,2020-02-24T00:00:00Z,UTA vs. PHX,111,-20,1610612756,PHX,Phoenix Suns,PHX @ UTA,131,20,Regular Season
22019,1610612744,GSW,Golden State Warriors,0021900863,2020-02-25T00:00:00Z,GSW vs. SAC,94,-18,1610612758,SAC,Sacramento Kings,SAC @ GSW,112,18,Regular Season
22019,1610612761,TOR,Toronto Raptors,0021900858,2020-02-25T00:00:00Z,TOR vs. MIL,97,-11,1610612749,MIL,Milwaukee Bucks,MIL @ TOR,108,11,Regular Season
22019,1610612741,CHI,Chicago Bulls,0021900859,2020-02-25T00:00:00Z,CHI vs. OKC,122,-2,1610612760,OKC,Oklahoma City Thunder,OKC @ CHI,124,2,Regular Season
22019,1610612747,LAL,Los Angeles Lakers,0021900861,2020-02-25T00:00:00Z,LAL vs. NOP,118,9,1610612740,NOP,New Orleans Pelicans,NOP @ LAL,109,-9,Regular Season
22019,1610612757,POR,Portland Trail Blazers,0021900862,2020-02-25T00:00:00Z,POR vs. BOS,106,-12,1610612738,BOS,Boston Celtics,BOS @ POR,118,12,Regular Season
22019,1610612754,IND,Indiana Pacers,0021900857,2020-02-25T00:00:00Z,IND vs. CHA,119,39,1610612766,CHA,Charlotte Hornets,CHA @ IND,80,-39,Regular Season
22019,1610612743,DEN,Denver Nuggets,0021900860,2020-02-25T00:00:00Z,DEN vs. DET,115,17,1610612765,DET,Detroit Pistons,DET @ DEN,98,-17,Regular Season
22019,1610612745,HOU,Houston Rockets,0021900870,2020-02-26T00:00:00Z,HOU vs. MEM,140,28,1610612763,MEM,Memphis Grizzlies,MEM @ HOU,112,-28,Regular Season
22019,1610612762,UTA,Utah Jazz,0021900872,2020-02-26T00:00:00Z,UTA vs. BOS,103,-11,1610612738,BOS,Boston Celtics,BOS @ UTA,114,11,Regular Season
22019,1610612737,ATL,Atlanta Hawks,0021900867,2020-02-26T00:00:00Z,ATL vs. ORL,120,-10,1610612753,ORL,Orlando Magic,ORL @ ATL,130,10,Regular Season
22019,1610612764,WAS,Washington Wizards,0021900866,2020-02-26T00:00:00Z,WAS vs. BKN,110,4,1610612751,BKN,Brooklyn Nets,BKN @ WAS,106,-4,Regular Season
22019,1610612739,CLE,Cleveland Cavaliers,0021900865,2020-02-26T00:00:00Z,CLE vs. PHI,108,14,1610612755,PHI,Philadelphia 76ers,PHI @ CLE,94,-14,Regular Season
22019,1610612766,CHA,Charlotte Hornets,0021900864,2020-02-26T00:00:00Z,CHA vs. NYK,107,6,1610612752,NYK,New York Knicks,NYK @ CHA,101,-6,Regular Season
22019,1610612756,PHX,Phoenix Suns,0021900871,2020-02-26T00:00:00Z,PHX vs. LAC,92,-10,1610612746,LAC,LA Clippers,LAC @ PHX,102,10,Regular Season
22019,1610612748,MIA,Miami Heat,0021900868,2020-02-26T00:00:00Z,MIA vs. MIN,126,-3,1610612750,MIN,Minnesota Timberwolves,MIN @ MIA,129,3,Regular Season
22019,1610612759,SAS,San Antonio Spurs,0021900869,2020-02-26T00:00:00Z,SAS vs. DAL,103,-6,1610612742,DAL,Dallas Mavericks,DAL @ SAS,109,6,Regular Season
22019,1610612760,OKC,Oklahoma City Thunder,0021900875,2020-02-27T00:00:00Z,OKC vs. SAC,112,4,1610612758,SAC,Sacramento Kings,SAC @ OKC,108,-4,Regular Season
22019,1610612744,GSW,Golden State Warriors,0021900876,2020-02-27T00:00:00Z,GSW vs. LAL,86,-30,1610612747,LAL,Los Angeles Lakers,LAL @ GSW,116,30,Regular Season
22019,1610612755,PHI,Philadelphia 76ers,0021900873,2020-02-27T00:00:00Z,PHI vs. NYK,115,9,1610612752,NYK,New York Knicks,NYK @ PHI,106,-9,Regular Season
22019,1610612754,IND,Indiana Pacers,0021900874,2020-02-27T00:00:00Z,IND vs. POR,106,6,1610612757,POR,Portland Trail Blazers,POR @ IND,100,-6,Regular Season
22019,1610612761,TOR,Toronto Raptors,0021900879,2020-02-28T00:00:00Z,TOR vs. CHA,96,-3,1610612766,CHA,Charlotte Hornets,CHA @ TOR,99,3,Regular Season
22019,1610612746,LAC,LA Clippers,0021900886,2020-02-28T00:00:00Z,LAC vs. DEN,132,29,1610612743,DEN,Denver Nuggets,DEN @ LAC,103,-29,Regular Season
22019,1610612753,ORL,Orlando Magic,0021900877,2020-02-28T00:00:00Z,ORL vs. MIN,136,11,1610612750,MIN,Minnesota Timberwolves,MIN @ ORL,125,-11,Regular Season
22019,1610612749,MIL,Milwaukee Bucks,0021900882,2020-02-28T00:00:00Z,MIL vs. OKC,133,47,1610612760,OKC,Oklahoma City Thunder,OKC @ MIL,86,-47,Regular Season
22019,1610612762,UTA,Utah Jazz,0021900885,2020-02-28T00:00:00Z,UTA vs. WAS,129,10,1610612764,WAS,Washington Wizards,WAS @ UTA,119,-10,Regular Season
22019,1610612737,ATL,Atlanta Hawks,0021900878,2020-02-28T00:00:00Z,ATL vs. BKN,141,23,1610612751,BKN,Brooklyn Nets,BKN @ ATL,118,-23,Regular Season
22019,1610612740,NOP,New Orleans Pelicans,0021900883,2020-02-28T00:00:00Z,NOP vs. CLE,116,12,1610612739,CLE,Cleveland Cavaliers,CLE @ NOP,104,-12,Regular Season
22019,1610612763,MEM,Memphis Grizzlies,0021900881,2020-02-28T00:00:00Z,MEM vs. SAC,101,-3,1610612758,SAC,Sacramento Kings,SAC @ MEM,104,3,Regular Season
22019,1610612756,PHX,Phoenix Suns,0021900884,2020-02-28T00:00:00Z,PHX vs. DET,111,-2,1610612765,DET,Detroit Pistons,DET @ PHX,113,2,Regular Season
22019,1610612748,MIA,Miami Heat,0021900880,2020-02-28T00:00:00Z,MIA vs. DAL,126,8,1610612742,DAL,Dallas Mavericks,DAL @ MIA,118,-8,Regular Season
22019,1610612737,ATL,Atlanta Hawks,0021900888,2020-02-29T00:00:00Z,ATL vs. POR,129,12,1610612757,POR,Portland Trail Blazers,POR @ ATL,117,-12,Regular Season
22019,1610612748,MIA,Miami Heat,0021900889,2020-02-29T00:00:00Z,MIA vs. BKN,116,3,1610612751,BKN,Brooklyn Nets,BKN @ MIA,113,-3,Regular Season
22019,1610612756,PHX,Phoenix Suns,0021900894,2020-02-29T00:00:00Z,PHX vs. GSW,99,-16,1610612744,GSW,Golden State Warriors,GSW @ PHX,115,16,Regular Season
22019,1610612738,BOS,Boston Celtics,0021900892,2020-02-29T00:00:00Z,BOS vs. HOU,110,-1,1610612745,HOU,Houston Rockets,HOU @ BOS,111,1,Regular Season
22019,1610612763,MEM,Memphis Grizzlies,0021900891,2020-02-29T00:00:00Z,MEM vs. LAL,105,17,1610612747,LAL,Los Angeles Lakers,LAL @ MEM,88,-17,Regular Season
22019,1610612739,CLE,Cleveland Cavaliers,0021900890,2020-02-29T00:00:00Z,CLE vs. IND,104,-9,1610612754,IND,Indiana Pacers,IND @ CLE,113,9,Regular Season
22019,1610612752,NYK,New York Knicks,0021900887,2020-02-29T00:00:00Z,NYK vs. CHI,125,10,1610612741,CHI,Chicago Bulls,CHI @ NYK,115,-10,Regular Season
22019,1610612759,SAS,San Antonio Spurs,0021900893,2020-02-29T00:00:00Z,SAS vs. ORL,114,1,1610612753,ORL,Orlando Magic,ORL @ SAS,113,-1,Regular Season
22019,1610612758,SAC,Sacramento Kings,0021900899,2020-03-01T00:00:00Z,SAC vs. DET,106,6,1610612765,DET,Detroit Pistons,DET @ SAC,100,-6,Regular Season
22019,1610612766,CHA,Charlotte Hornets,0021900895,2020-03-01T00:00:00Z,CHA vs. MIL,85,-8,1610612749,MIL,Milwaukee Bucks,MIL @ CHA,93,8,Regular Season
22019,1610612750,MIN,Minnesota Timberwolves,0021900896,2020-03-01T00:00:00Z,MIN vs. DAL,91,-20,1610612742,DAL,Dallas Mavericks,DAL @ MIN,111,20,Regular Season
22019,1610612740,NOP,New Orleans Pelicans,0021900900,2020-03-01T00:00:00Z,NOP vs. LAL,114,-8,1610612747,LAL,Los Angeles Lakers,LAL @ NOP,122,8,Regular Season
22019,1610612743,DEN,Denver Nuggets,0021900898,2020-03-01T00:00:00Z,DEN vs. TOR,133,15,1610612761,TOR,Toronto Raptors,TOR @ DEN,118,-15,Regular Season
22019,1610612746,LAC,LA Clippers,0021900897,2020-03-01T00:00:00Z,LAC vs. PHI,136,6,1610612755,PHI,Philadelphia 76ers,PHI @ LAC,130,-6,Regular Season
22019,1610612744,GSW,Golden State Warriors,0021900901,2020-03-01T00:00:00Z,GSW vs. WAS,110,-14,1610612764,WAS,Washington Wizards,WAS @ GSW,124,14,Regular Season
22019,1610612739,CLE,Cleveland Cavaliers,0021900902,2020-03-02T00:00:00Z,CLE vs. UTA,113,-13,1610612762,UTA,Utah Jazz,UTA @ CLE,126,13,Regular Season
22019,1610612752,NYK,New York Knicks,0021900903,2020-03-02T00:00:00Z,NYK vs. HOU,125,2,1610612745,HOU,Houston Rockets,HOU @ NYK,123,-2,Regular Season
22019,1610612737,ATL,Atlanta Hawks,0021900905,2020-03-02T00:00:00Z,ATL vs. MEM,88,-39,1610612763,MEM,Memphis Grizzlies,MEM @ ATL,127,39,Regular Season
22019,1610612741,CHI,Chicago Bulls,0021900907,2020-03-02T00:00:00Z,CHI vs. DAL,109,2,1610612742,DAL,Dallas Mavericks,DAL @ CHI,107,-2,Regular Season
22019,1610612759,SAS,San Antonio Spurs,0021900908,2020-03-02T00:00:00Z,SAS vs. IND,111,-5,1610612754,IND,Indiana Pacers,IND @ SAS,116,5,Regular Season
22019,1610612753,ORL,Orlando Magic,0021900904,2020-03-02T00:00:00Z,ORL vs. POR,107,-23,1610612757,POR,Portland Trail Blazers,POR @ ORL,130,23,Regular Season
22019,1610612748,MIA,Miami Heat,0021900906,2020-03-02T00:00:00Z,MIA vs. MIL,105,16,1610612749,MIL,Milwaukee Bucks,MIL @ MIA,89,-16,Regular Season
22019,1610612747,LAL,Los Angeles Lakers,0021900915,2020-03-03T00:00:00Z,LAL vs. PHI,120,13,1610612755,PHI,Philadelphia 76ers,PHI @ LAL,107,-13,Regular Season
22019,1610612743,DEN,Denver Nuggets,0021900913,2020-03-03T00:00:00Z,DEN vs. GSW,100,-16,1610612744,GSW,Golden State Warriors,GSW @ DEN,116,16,Regular Season
22019,1610612758,SAC,Sacramento Kings,0021900916,2020-03-03T00:00:00Z,SAC vs. WAS,133,7,1610612764,WAS,Washington Wizards,WAS @ SAC,126,-7,Regular Season
22019,1610612756,PHX,Phoenix Suns,0021900914,2020-03-03T00:00:00Z,PHX vs. TOR,114,-9,1610612761,TOR,Toronto Raptors,TOR @ PHX,123,9,Regular Season
22019,1610612738,BOS,Boston Celtics,0021900910,2020-03-03T00:00:00Z,BOS vs. BKN,120,-9,1610612751,BKN,Brooklyn Nets,BKN @ BOS,129,9,Regular Season
22019,1610612760,OKC,Oklahoma City Thunder,0021900912,2020-03-03T00:00:00Z,OKC vs. LAC,94,-15,1610612746,LAC,LA Clippers,LAC @ OKC,109,15,Regular Season
22019,1610612766,CHA,Charlotte Hornets,0021900909,2020-03-03T00:00:00Z,CHA vs. SAS,103,-1,1610612759,SAS,San Antonio Spurs,SAS @ CHA,104,1,Regular Season
22019,1610612740,NOP,New Orleans Pelicans,0021900911,2020-03-03T00:00:00Z,NOP vs. MIN,134,-5,1610612750,MIN,Minnesota Timberwolves,MIN @ NOP,139,5,Regular Season
22019,1610612742,DAL,Dallas Mavericks,0021900923,2020-03-04T00:00:00Z,DAL vs. NOP,127,4,1610612740,NOP,New Orleans Pelicans,NOP @ DAL,123,-4,Regular Season
22019,1610612765,DET,Detroit Pistons,0021900918,2020-03-04T00:00:00Z,DET vs. OKC,107,-7,1610612760,OKC,Oklahoma City Thunder,OKC @ DET,114,7,Regular Season
22019,1610612757,POR,Portland Trail Blazers,0021900925,2020-03-04T00:00:00Z,POR vs. WAS,125,21,1610612764,WAS,Washington Wizards,WAS @ POR,104,-21,Regular Season
22019,1610612751,BKN,Brooklyn Nets,0021900920,2020-03-04T00:00:00Z,BKN vs. MEM,79,-39,1610612763,MEM,Memphis Grizzlies,MEM @ BKN,118,39,Regular Season
22019,1610612748,MIA,Miami Heat,0021900919,2020-03-04T00:00:00Z,MIA vs. ORL,116,3,1610612753,ORL,Orlando Magic,ORL @ MIA,113,-3,Regular Season
22019,1610612752,NYK,New York Knicks,0021900921,2020-03-04T00:00:00Z,NYK vs. UTA,104,-8,1610612762,UTA,Utah Jazz,UTA @ NYK,112,8,Regular Season
22019,1610612749,MIL,Milwaukee Bucks,0021900924,2020-03-04T00:00:00Z,MIL vs. IND,119,19,1610612754,IND,Indiana Pacers,IND @ MIL,100,-19,Regular Season
22019,1610612739,CLE,Cleveland Cavaliers,0021900917,2020-03-04T00:00:00Z,CLE vs. BOS,106,-6,1610612738,BOS,Boston Celtics,BOS @ CLE,112,6,Regular Season
22019,1610612750,MIN,Minnesota Timberwolves,0021900922,2020-03-04T00:00:00Z,MIN vs. CHI,115,7,1610612741,CHI,Chicago Bulls,CHI @ MIN,108,-7,Regular Season
22019,1610612766,CHA,Charlotte Hornets,0021900926,2020-03-05T00:00:00Z,CHA vs. DEN,112,-2,1610612743,DEN,Denver Nuggets,DEN @ CHA,114,2,Regular Season
22019,1610612745,HOU,Houston Rockets,0021900927,2020-03-05T00:00:00Z,HOU vs. LAC,105,-15,1610612746,LAC,LA Clippers,LAC @ HOU,120,15,Regular Season
22019,1610612758,SAC,Sacramento Kings,0021900928,2020-03-05T00:00:00Z,SAC vs. PHI,108,-17,1610612755,PHI,Philadelphia 76ers,PHI @ SAC,125,17,Regular Season
22019,1610612744,GSW,Golden State Warriors,0021900929,2020-03-05T00:00:00Z,GSW vs. TOR,113,-8,1610612761,TOR,Toronto Raptors,TOR @ GSW,121,8,Regular Season
22019,1610612764,WAS,Washington Wizards,0021900930,2020-03-06T00:00:00Z,WAS vs. ATL,118,6,1610612737,ATL,Atlanta Hawks,ATL @ WAS,112,-6,Regular Season
22019,1610612740,NOP,New Orleans Pelicans,0021900936,2020-03-06T00:00:00Z,NOP vs. MIA,110,6,1610612748,MIA,Miami Heat,MIA @ NOP,104,-6,Regular Season
22019,1610612742,DAL,Dallas Mavericks,0021900937,2020-03-06T00:00:00Z,DAL vs. MEM,121,25,1610612763,MEM,Memphis Grizzlies,MEM @ DAL,96,-25,Regular Season
22019,1610612752,NYK,New York Knicks,0021900932,2020-03-06T00:00:00Z,NYK vs. OKC,103,-23,1610612760,OKC,Oklahoma City Thunder,OKC @ NYK,126,23,Regular Season
22019,1610612741,CHI,Chicago Bulls,0021900934,2020-03-06T00:00:00Z,CHI vs. IND,102,-6,1610612754,IND,Indiana Pacers,IND @ CHI,108,6,Regular Season
22019,1610612747,LAL,Los Angeles Lakers,0021900939,2020-03-06T00:00:00Z,LAL vs. MIL,113,10,1610612749,MIL,Milwaukee Bucks,MIL @ LAL,103,-10,Regular Season
22019,1610612750,MIN,Minnesota Timberwolves,0021900935,2020-03-06T00:00:00Z,MIN vs. ORL,118,-14,1610612753,ORL,Orlando Magic,ORL @ MIN,132,14,Regular Season
22019,1610612751,BKN,Brooklyn Nets,0021900931,2020-03-06T00:00:00Z,BKN vs. SAS,139,19,1610612759,SAS,San Antonio Spurs,SAS @ BKN,120,-19,Regular Season
22019,1610612756,PHX,Phoenix Suns,0021900938,2020-03-06T00:00:00Z,PHX vs. POR,127,10,1610612757,POR,Portland Trail Blazers,POR @ PHX,117,-10,Regular Season
22019,1610612738,BOS,Boston Celtics,0021900933,2020-03-06T00:00:00Z,BOS vs. UTA,94,-5,1610612762,UTA,Utah Jazz,UTA @ BOS,99,5,Regular Season
22019,1610612763,MEM,Memphis Grizzlies,0021900943,2020-03-07T00:00:00Z,MEM vs. ATL,118,17,1610612737,ATL,Atlanta Hawks,ATL @ MEM,101,-17,Regular Season
22019,1610612765,DET,Detroit Pistons,0021900941,2020-03-07T00:00:00Z,DET vs. UTA,105,-6,1610612762,UTA,Utah Jazz,UTA @ DET,111,6,Regular Season
22019,1610612744,GSW,Golden State Warriors,0021900944,2020-03-07T00:00:00Z,GSW vs. PHI,118,4,1610612755,PHI,Philadelphia 76ers,PHI @ GSW,114,-4,Regular Season
22019,1610612757,POR,Portland Trail Blazers,0021900945,2020-03-07T00:00:00Z,POR vs. SAC,111,-12,1610612758,SAC,Sacramento Kings,SAC @ POR,123,12,Regular Season
22019,1610612766,CHA,Charlotte Hornets,0021900940,2020-03-07T00:00:00Z,CHA vs. HOU,108,9,1610612745,HOU,Houston Rockets,HOU @ CHA,99,-9,Regular Season
22019,1610612739,CLE,Cleveland Cavaliers,0021900942,2020-03-07T00:00:00Z,CLE vs. DEN,104,2,1610612743,DEN,Denver Nuggets,DEN @ CLE,102,-2,Regular Season
22019,1610612746,LAC,LA Clippers,0021900948,2020-03-08T00:00:00Z,LAC vs. LAL,103,-9,1610612747,LAL,Los Angeles Lakers,LAL @ LAC,112,9,Regular Season
22019,1610612764,WAS,Washington Wizards,0021900951,2020-03-08T00:00:00Z,WAS vs. MIA,89,-11,1610612748,MIA,Miami Heat,MIA @ WAS,100,11,Regular Season
22019,1610612742,DAL,Dallas Mavericks,0021900952,2020-03-08T00:00:00Z,DAL vs. IND,109,-3,1610612754,IND,Indiana Pacers,IND @ DAL,112,3,Regular Season
22019,1610612739,CLE,Cleveland Cavaliers,0021900954,2020-03-08T00:00:00Z,CLE vs. SAS,132,3,1610612759,SAS,San Antonio Spurs,SAS @ CLE,129,-3,Regular Season
22019,1610612751,BKN,Brooklyn Nets,0021900946,2020-03-08T00:00:00Z,BKN vs. CHI,110,3,1610612741,CHI,Chicago Bulls,CHI @ BKN,107,-3,Regular Season
22019,1610612745,HOU,Houston Rockets,0021900953,2020-03-08T00:00:00Z,HOU vs. ORL,106,-20,1610612753,ORL,Orlando Magic,ORL @ HOU,126,20,Regular Season
22019,1610612738,BOS,Boston Celtics,0021900949,2020-03-08T00:00:00Z,BOS vs. OKC,104,-1,1610612760,OKC,Oklahoma City Thunder,OKC @ BOS,105,1,Regular Season
22019,1610612752,NYK,New York Knicks,0021900955,2020-03-08T00:00:00Z,NYK vs. DET,96,12,1610612765,DET,Detroit Pistons,DET @ NYK,84,-12,Regular Season
22019,1610612750,MIN,Minnesota Timberwolves,0021900947,2020-03-08T00:00:00Z,MIN vs. NOP,107,-13,1610612740,NOP,New Orleans Pelicans,NOP @ MIN,120,13,Regular Season
22019,1610612758,SAC,Sacramento Kings,0021900956,2020-03-08T00:00:00Z,SAC vs. TOR,113,-5,1610612761,TOR,Toronto Raptors,TOR @ SAC,118,5,Regular Season
22019,1610612756,PHX,Phoenix Suns,0021900950,2020-03-08T00:00:00Z,PHX vs. MIL,140,9,1610612749,MIL,Milwaukee Bucks,MIL @ PHX,131,-9,Regular Season
22019,1610612737,ATL,Atlanta Hawks,0021900957,2020-03-09T00:00:00Z,ATL vs. CHA,143,5,1610612766,CHA,Charlotte Hornets,CHA @ ATL,138,-5,Regular Season
22019,1610612743,DEN,Denver Nuggets,0021900958,2020-03-09T00:00:00Z,DEN vs. MIL,109,14,1610612749,MIL,Milwaukee Bucks,MIL @ DEN,95,-14,Regular Season
22019,1610612762,UTA,Utah Jazz,0021900959,2020-03-09T00:00:00Z,UTA vs. TOR,92,-9,1610612761,TOR,Toronto Raptors,TOR @ UTA,101,9,Regular Season
22019,1610612754,IND,Indiana Pacers,0021900960,2020-03-10T00:00:00Z,IND vs. BOS,111,-3,1610612738,BOS,Boston Celtics,BOS @ IND,114,3,Regular Season
22019,1610612744,GSW,Golden State Warriors,0021900967,2020-03-10T00:00:00Z,GSW vs. LAC,107,-24,1610612746,LAC,LA Clippers,LAC @ GSW,131,24,Regular Season
22019,1610612757,POR,Portland Trail Blazers,0021900966,2020-03-10T00:00:00Z,POR vs. PHX,121,16,1610612756,PHX,Phoenix Suns,PHX @ POR,105,-16,Regular Season
22019,1610612741,CHI,Chicago Bulls,0021900962,2020-03-10T00:00:00Z,CHI vs. CLE,108,5,1610612739,CLE,Cleveland Cavaliers,CLE @ CHI,103,-5,Regular Season
22019,1610612763,MEM,Memphis Grizzlies,0021900964,2020-03-10T00:00:00Z,MEM vs. ORL,115,-5,1610612753,ORL,Orlando Magic,ORL @ MEM,120,5,Regular Season
22019,1610612759,SAS,San Antonio Spurs,0021900965,2020-03-10T00:00:00Z,SAS vs. DAL,119,10,1610612742,DAL,Dallas Mavericks,DAL @ SAS,109,-10,Regular Season
22019,1610612764,WAS,Washington Wizards,0021900961,2020-03-10T00:00:00Z,WAS vs. NYK,122,7,1610612752,NYK,New York Knicks,NYK @ WAS,115,-7,Regular Season
22019,1610612745,HOU,Houston Rockets,0021900963,2020-03-10T00:00:00Z,HOU vs. MIN,117,6,1610612750,MIN,Minnesota Timberwolves,MIN @ HOU,111,-6,Regular Season
22019,1610612747,LAL,Los Angeles Lakers,0021900968,2020-03-10T00:00:00Z,LAL vs. BKN,102,-2,1610612751,BKN,Brooklyn Nets,BKN @ LAL,104,2,Regular Season
22019,1610612742,DAL,Dallas Mavericks,0021900973,2020-03-11T00:00:00Z,DAL vs. DEN,113,16,1610612743,DEN,Denver Nuggets,DEN @ DAL,97,-16,Regular Season
22019,1610612737,ATL,Atlanta Hawks,0021900969,2020-03-11T00:00:00Z,ATL vs. NYK,131,-5,1610612752,NYK,New York Knicks,NYK @ ATL,136,5,Regular Season
22019,1610612748,MIA,Miami Heat,0021900970,2020-03-11T00:00:00Z,MIA vs. CHA,98,-11,1610612766,CHA,Charlotte Hornets,CHA @ MIA,109,11,Regular Season
22019,1610612755,PHI,Philadelphia 76ers,0021900971,2020-03-11T00:00:00Z,PHI vs. DET,124,18,1610612765,DET,Detroit Pistons,DET @ PHI,106,-18,Regular Season
22019,1610612740,NOP,New Orleans Pelicans,0021901231,2020-07-30T00:00:00Z,NOP vs. UTA,104,-2,1610612762,UTA,Utah Jazz,UTA @ NOP,106,2,Regular Season
22019,1610612747,LAL,Los Angeles Lakers,0021901232,2020-07-30T00:00:00Z,LAL vs. LAC,103,2,1610612746,LAC,LA Clippers,LAC @ LAL,101,-2,Regular Season
22019,1610612757,POR,Portland Trail Blazers,0021901234,2020-07-31T00:00:00Z,POR vs. MEM,140,5,1610612763,MEM,Memphis Grizzlies,MEM @ POR,135,-5,Regular Season
22019,1610612742,DAL,Dallas Mavericks,0021901238,2020-07-31T00:00:00Z,DAL vs. HOU,149,-4,1610612745,HOU,Houston Rockets,HOU @ DAL,153,4,Regular Season
22019,1610612759,SAS,San Antonio Spurs,0021901237,2020-07-31T00:00:00Z,SAS vs. SAC,129,9,1610612758,SAC,Sacramento Kings,SAC @ SAS,120,-9,Regular Season
22019,1610612749,MIL,Milwaukee Bucks,0021901236,2020-07-31T00:00:00Z,MIL vs. BOS,119,7,1610612738,BOS,Boston Celtics,BOS @ MIL,112,-7,Regular Season
22019,1610612764,WAS,Washington Wizards,0021901235,2020-07-31T00:00:00Z,WAS vs. PHX,112,-13,1610612756,PHX,Phoenix Suns,PHX @ WAS,125,13,Regular Season
22019,1610612751,BKN,Brooklyn Nets,0021901233,2020-07-31T00:00:00Z,BKN vs. ORL,118,-10,1610612753,ORL,Orlando Magic,ORL @ BKN,128,10,Regular Season
22019,1610612760,OKC,Oklahoma City Thunder,0021901240,2020-08-01T00:00:00Z,OKC vs. UTA,110,16,1610612762,UTA,Utah Jazz,UTA @ OKC,94,-16,Regular Season
22019,1610612754,IND,Indiana Pacers,0021901242,2020-08-01T00:00:00Z,IND vs. PHI,127,6,1610612755,PHI,Philadelphia 76ers,PHI @ IND,121,-6,Regular Season
22019,1610612761,TOR,Toronto Raptors,0021901243,2020-08-01T00:00:00Z,TOR vs. LAL,107,15,1610612747,LAL,Los Angeles Lakers,LAL @ TOR,92,-15,Regular Season
22019,1610612743,DEN,Denver Nuggets,0021901239,2020-08-01T00:00:00Z,DEN vs. MIA,105,-20,1610612748,MIA,Miami Heat,MIA @ DEN,125,20,Regular Season
22019,1610612746,LAC,LA Clippers,0021901241,2020-08-01T00:00:00Z,LAC vs. NOP,126,23,1610612740,NOP,New Orleans Pelicans,NOP @ LAC,103,-23,Regular Season
22019,1610612763,MEM,Memphis Grizzlies,0021901246,2020-08-02T00:00:00Z,MEM vs. SAS,106,-2,1610612759,SAS,San Antonio Spurs,SAS @ MEM,108,2,Regular Season
22019,1610612738,BOS,Boston Celtics,0021901245,2020-08-02T00:00:00Z,BOS vs. POR,128,4,1610612757,POR,Portland Trail Blazers,POR @ BOS,124,-4,Regular Season
22019,1610612753,ORL,Orlando Magic,0021901247,2020-08-02T00:00:00Z,ORL vs. SAC,132,16,1610612758,SAC,Sacramento Kings,SAC @ ORL,116,-16,Regular Season
22019,1610612756,PHX,Phoenix Suns,0021901249,2020-08-02T00:00:00Z,PHX vs. DAL,117,2,1610612742,DAL,Dallas Mavericks,DAL @ PHX,115,-2,Regular Season
22019,1610612745,HOU,Houston Rockets,0021901248,2020-08-02T00:00:00Z,HOU vs. MIL,120,4,1610612749,MIL,Milwaukee Bucks,MIL @ HOU,116,-4,Regular Season
22019,1610612751,BKN,Brooklyn Nets,0021901244,2020-08-02T00:00:00Z,BKN vs. WAS,118,8,1610612764,WAS,Washington Wizards,WAS @ BKN,110,-8,Regular Season
22019,1610612748,MIA,Miami Heat,0021901250,2020-08-03T00:00:00Z,MIA vs. TOR,103,-4,1610612761,TOR,Toronto Raptors,TOR @ MIA,107,4,Regular Season
22019,1610612762,UTA,Utah Jazz,0021901255,2020-08-03T00:00:00Z,UTA vs. LAL,108,-8,1610612747,LAL,Los Angeles Lakers,LAL @ UTA,116,8,Regular Season
22019,1610612760,OKC,Oklahoma City Thunder,0021901251,2020-08-03T00:00:00Z,OKC vs. DEN,113,-8,1610612743,DEN,Denver Nuggets,DEN @ OKC,121,8,Regular Season
22019,1610612764,WAS,Washington Wizards,0021901252,2020-08-03T00:00:00Z,WAS vs. IND,100,-11,1610612754,IND,Indiana Pacers,IND @ WAS,111,11,Regular Season
22019,1610612740,NOP,New Orleans Pelicans,0021901253,2020-08-03T00:00:00Z,NOP vs. MEM,109,10,1610612763,MEM,Memphis Grizzlies,MEM @ NOP,99,-10,Regular Season
22019,1610612755,PHI,Philadelphia 76ers,0021901254,2020-08-03T00:00:00Z,PHI vs. SAS,132,2,1610612759,SAS,San Antonio Spurs,SAS @ PHI,130,-2,Regular Season
22019,1610612748,MIA,Miami Heat,0021901260,2020-08-04T00:00:00Z,MIA vs. BOS,112,6,1610612738,BOS,Boston Celtics,BOS @ MIA,106,-6,Regular Season
22019,1610612749,MIL,Milwaukee Bucks,0021901256,2020-08-04T00:00:00Z,MIL vs. BKN,116,-3,1610612751,BKN,Brooklyn Nets,BKN @ MIL,119,3,Regular Season
22019,1610612746,LAC,LA Clippers,0021901258,2020-08-04T00:00:00Z,LAC vs. PHX,115,-2,1610612756,PHX,Phoenix Suns,PHX @ LAC,117,2,Regular Season
22019,1610612757,POR,Portland Trail Blazers,0021901261,2020-08-04T00:00:00Z,POR vs. HOU,110,8,1610612745,HOU,Houston Rockets,HOU @ POR,102,-8,Regular Season
22019,1610612754,IND,Indiana Pacers,0021901259,2020-08-04T00:00:00Z,IND vs. ORL,120,11,1610612753,ORL,Orlando Magic,ORL @ IND,109,-11,Regular Season
22019,1610612758,SAC,Sacramento Kings,0021901257,2020-08-04T00:00:00Z,SAC vs. DAL,110,-4,1610612742,DAL,Dallas Mavericks,DAL @ SAC,114,4,Regular Season
22019,1610612747,LAL,Los Angeles Lakers,0021901265,2020-08-05T00:00:00Z,LAL vs. OKC,86,-19,1610612760,OKC,Oklahoma City Thunder,OKC @ LAL,105,19,Regular Season
22019,1610612753,ORL,Orlando Magic,0021901266,2020-08-05T00:00:00Z,ORL vs. TOR,99,-10,1610612761,TOR,Toronto Raptors,TOR @ ORL,109,10,Regular Season
22019,1610612764,WAS,Washington Wizards,0021901263,2020-08-05T00:00:00Z,WAS vs. PHI,98,-9,1610612755,PHI,Philadelphia 76ers,PHI @ WAS,107,9,Regular Season
22019,1610612762,UTA,Utah Jazz,0021901262,2020-08-05T00:00:00Z,UTA vs. MEM,124,9,1610612763,MEM,Memphis Grizzlies,MEM @ UTA,115,-9,Regular Season
22019,1610612759,SAS,San Antonio Spurs,0021901264,2020-08-05T00:00:00Z,SAS vs. DEN,126,-6,1610612743,DEN,Denver Nuggets,DEN @ SAS,132,6,Regular Season
22019,1610612738,BOS,Boston Celtics,0021901267,2020-08-05T00:00:00Z,BOS vs. BKN,149,34,1610612751,BKN,Brooklyn Nets,BKN @ BOS,115,-34,Regular Season
22019,1610612743,DEN,Denver Nuggets,0021901272,2020-08-06T00:00:00Z,DEN vs. POR,115,-10,1610612757,POR,Portland Trail Blazers,POR @ DEN,125,10,Regular Season
22019,1610612749,MIL,Milwaukee Bucks,0021901269,2020-08-06T00:00:00Z,MIL vs. MIA,130,14,1610612748,MIA,Miami Heat,MIA @ MIL,116,-14,Regular Season
22019,1610612745,HOU,Houston Rockets,0021901273,2020-08-06T00:00:00Z,HOU vs. LAL,113,16,1610612747,LAL,Los Angeles Lakers,LAL @ HOU,97,-16,Regular Season
22019,1610612758,SAC,Sacramento Kings,0021901268,2020-08-06T00:00:00Z,SAC vs. NOP,140,15,1610612740,NOP,New Orleans Pelicans,NOP @ SAC,125,-15,Regular Season
22019,1610612742,DAL,Dallas Mavericks,0021901271,2020-08-06T00:00:00Z,DAL vs. LAC,111,-15,1610612746,LAC,LA Clippers,LAC @ DAL,126,15,Regular Season
22019,1610612756,PHX,Phoenix Suns,0021901270,2020-08-06T00:00:00Z,PHX vs. IND,114,15,1610612754,IND,Indiana Pacers,IND @ PHX,99,-15,Regular Season
22019,1610612755,PHI,Philadelphia 76ers,0021901277,2020-08-07T00:00:00Z,PHI vs. ORL,108,7,1610612753,ORL,Orlando Magic,ORL @ PHI,101,-7,Regular Season
22019,1610612761,TOR,Toronto Raptors,0021901279,2020-08-07T00:00:00Z,TOR vs. BOS,100,-22,1610612738,BOS,Boston Celtics,BOS @ TOR,122,22,Regular Season
22019,1610612740,NOP,New Orleans Pelicans,0021901278,2020-08-07T00:00:00Z,NOP vs. WAS,118,11,1610612764,WAS,Washington Wizards,WAS @ NOP,107,-11,Regular Season
22019,1610612751,BKN,Brooklyn Nets,0021901276,2020-08-07T00:00:00Z,BKN vs. SAC,119,13,1610612758,SAC,Sacramento Kings,SAC @ BKN,106,-13,Regular Season
22019,1610612759,SAS,San Antonio Spurs,0021901274,2020-08-07T00:00:00Z,SAS vs. UTA,119,8,1610612762,UTA,Utah Jazz,UTA @ SAS,111,-8,Regular Season
22019,1610612763,MEM,Memphis Grizzlies,0021901275,2020-08-07T00:00:00Z,MEM vs. OKC,121,29,1610612760,OKC,Oklahoma City Thunder,OKC @ MEM,92,-29,Regular Season
22019,1610612754,IND,Indiana Pacers,0021901282,2020-08-08T00:00:00Z,IND vs. LAL,116,5,1610612747,LAL,Los Angeles Lakers,LAL @ IND,111,-5,Regular Season
22019,1610612742,DAL,Dallas Mavericks,0021901284,2020-08-08T00:00:00Z,DAL vs. MIL,136,4,1610612749,MIL,Milwaukee Bucks,MIL @ DAL,132,-4,Regular Season
22019,1610612748,MIA,Miami Heat,0021901283,2020-08-08T00:00:00Z,MIA vs. PHX,112,-7,1610612756,PHX,Phoenix Suns,PHX @ MIA,119,7,Regular Season
22019,1610612757,POR,Portland Trail Blazers,0021901280,2020-08-08T00:00:00Z,POR vs. LAC,117,-5,1610612746,LAC,LA Clippers,LAC @ POR,122,5,Regular Season
22019,1610612743,DEN,Denver Nuggets,0021901281,2020-08-08T00:00:00Z,DEN vs. UTA,134,2,1610612762,UTA,Utah Jazz,UTA @ DEN,132,-2,Regular Season
22019,1610612740,NOP,New Orleans Pelicans,0021901287,2020-08-09T00:00:00Z,NOP vs. SAS,113,-9,1610612759,SAS,San Antonio Spurs,SAS @ NOP,122,9,Regular Season
22019,1610612760,OKC,Oklahoma City Thunder,0021901285,2020-08-09T00:00:00Z,OKC vs. WAS,121,18,1610612764,WAS,Washington Wizards,WAS @ OKC,103,-18,Regular Season
22019,1610612761,TOR,Toronto Raptors,0021901286,2020-08-09T00:00:00Z,TOR vs. MEM,108,9,1610612763,MEM,Memphis Grizzlies,MEM @ TOR,99,-9,Regular Season
22019,1610612757,POR,Portland Trail Blazers,0021901289,2020-08-09T00:00:00Z,POR vs. PHI,124,3,1610612755,PHI,Philadelphia 76ers,PHI @ POR,121,-3,Regular Season
22019,1610612746,LAC,LA Clippers,0021901291,2020-08-09T00:00:00Z,LAC vs. BKN,120,-9,1610612751,BKN,Brooklyn Nets,BKN @ LAC,129,9,Regular Season
22019,1610612758,SAC,Sacramento Kings,0021901290,2020-08-09T00:00:00Z,SAC vs. HOU,112,-17,1610612745,HOU,Houston Rockets,HOU @ SAC,129,17,Regular Season
22019,1610612738,BOS,Boston Celtics,0021901288,2020-08-09T00:00:00Z,BOS vs. ORL,122,3,1610612753,ORL,Orlando Magic,ORL @ BOS,119,-3,Regular Season
22019,1610612756,PHX,Phoenix Suns,0021901292,2020-08-10T00:00:00Z,PHX vs. OKC,128,27,1610612760,OKC,Oklahoma City Thunder,OKC @ PHX,101,-27,Regular Season
22019,1610612747,LAL,Los Angeles Lakers,0021901296,2020-08-10T00:00:00Z,LAL vs. DEN,124,3,1610612743,DEN,Denver Nuggets,DEN @ LAL,121,-3,Regular Season
22019,1610612762,UTA,Utah Jazz,0021901293,2020-08-10T00:00:00Z,UTA vs. DAL,114,-8,1610612742,DAL,Dallas Mavericks,DAL @ UTA,122,8,Regular Season
22019,1610612748,MIA,Miami Heat,0021901295,2020-08-10T00:00:00Z,MIA vs. IND,114,22,1610612754,IND,Indiana Pacers,IND @ MIA,92,-22,Regular Season
22019,1610612749,MIL,Milwaukee Bucks,0021901294,2020-08-10T00:00:00Z,MIL vs. TOR,106,-8,1610612761,TOR,Toronto Raptors,TOR @ MIL,114,8,Regular Season
22019,1610612764,WAS,Washington Wizards,0021901303,2020-08-11T00:00:00Z,WAS vs. MIL,113,-13,1610612749,MIL,Milwaukee Bucks,MIL @ WAS,126,13,Regular Season
22019,1610612753,ORL,Orlando Magic,0021901297,2020-08-11T00:00:00Z,ORL vs. BKN,96,-12,1610612751,BKN,Brooklyn Nets,BKN @ ORL,108,12,Regular Season
22019,1610612758,SAC,Sacramento Kings,0021901302,2020-08-11T00:00:00Z,SAC vs. NOP,112,6,1610612740,NOP,New Orleans Pelicans,NOP @ SAC,106,-6,Regular Season
22019,1610612763,MEM,Memphis Grizzlies,0021901301,2020-08-11T00:00:00Z,MEM vs. BOS,107,-15,1610612738,BOS,Boston Celtics,BOS @ MEM,122,15,Regular Season
22019,1610612755,PHI,Philadelphia 76ers,0021901299,2020-08-11T00:00:00Z,PHI vs. PHX,117,-13,1610612756,PHX,Phoenix Suns,PHX @ PHI,130,13,Regular Season
22019,1610612742,DAL,Dallas Mavericks,0021901300,2020-08-11T00:00:00Z,DAL vs. POR,131,-3,1610612757,POR,Portland Trail Blazers,POR @ DAL,134,3,Regular Season
22019,1610612759,SAS,San Antonio Spurs,0021901298,2020-08-11T00:00:00Z,SAS vs. HOU,123,18,1610612745,HOU,Houston Rockets,HOU @ SAS,105,-18,Regular Season
22019,1610612745,HOU,Houston Rockets,0021901304,2020-08-12T00:00:00Z,HOU vs. IND,104,-4,1610612754,IND,Indiana Pacers,IND @ HOU,108,4,Regular Season
22019,1610612755,PHI,Philadelphia 76ers,0021901305,2020-08-12T00:00:00Z,PHI vs. TOR,121,-4,1610612761,TOR,Toronto Raptors,TOR @ PHI,125,4,Regular Season
22019,1610612760,OKC,Oklahoma City Thunder,0021901306,2020-08-12T00:00:00Z,OKC vs. MIA,116,1,1610612748,MIA,Miami Heat,MIA @ OKC,115,-1,Regular Season
22019,1610612743,DEN,Denver Nuggets,0021901307,2020-08-12T00:00:00Z,DEN vs. LAC,111,-13,1610612746,LAC,LA Clippers,LAC @ DEN,124,13,Regular Season
22019,1610612762,UTA,Utah Jazz,0021901314,2020-08-13T00:00:00Z,UTA vs. SAS,118,6,1610612759,SAS,San Antonio Spurs,SAS @ UTA,112,-6,Regular Season
22019,1610612756,PHX,Phoenix Suns,0021901313,2020-08-13T00:00:00Z,PHX vs. DAL,128,26,1610612742,DAL,Dallas Mavericks,DAL @ PHX,102,-26,Regular Season
22019,1610612738,BOS,Boston Celtics,0021901308,2020-08-13T00:00:00Z,BOS vs. WAS,90,-6,1610612764,WAS,Washington Wizards,WAS @ BOS,96,6,Regular Season
22019,1610612747,LAL,Los Angeles Lakers,0021901310,2020-08-13T00:00:00Z,LAL vs. SAC,122,-14,1610612758,SAC,Sacramento Kings,SAC @ LAL,136,14,Regular Season
22019,1610612753,ORL,Orlando Magic,0021901312,2020-08-13T00:00:00Z,ORL vs. NOP,133,6,1610612740,NOP,New Orleans Pelicans,NOP @ ORL,127,-6,Regular Season
22019,1610612763,MEM,Memphis Grizzlies,0021901311,2020-08-13T00:00:00Z,MEM vs. MIL,119,13,1610612749,MIL,Milwaukee Bucks,MIL @ MEM,106,-13,Regular Season
22019,1610612751,BKN,Brooklyn Nets,0021901309,2020-08-13T00:00:00Z,BKN vs. POR,133,-1,1610612757,POR,Portland Trail Blazers,POR @ BKN,134,1,Regular Season
22019,1610612746,LAC,LA Clippers,0021901317,2020-08-14T00:00:00Z,LAC vs. OKC,107,4,1610612760,OKC,Oklahoma City Thunder,OKC @ LAC,103,-4,Regular Season
22019,1610612754,IND,Indiana Pacers,0021901316,2020-08-14T00:00:00Z,IND vs. MIA,109,17,1610612748,MIA,Miami Heat,MIA @ IND,92,-17,Regular Season
22019,1610612745,HOU,Houston Rockets,0021901315,2020-08-14T00:00:00Z,HOU vs. PHI,96,-38,1610612755,PHI,Philadelphia 76ers,PHI @ HOU,134,38,Regular Season
22019,1610612761,TOR,Toronto Raptors,0021901318,2020-08-14T00:00:00Z,TOR vs. DEN,117,8,1610612743,DEN,Denver Nuggets,DEN @ TOR,109,-8,Regular Season
42019,1610612746,LAC,LA Clippers,0041900151,2020-08-17T00:00:00Z,LAC vs. DAL,118,8,1610612742,DAL,Dallas Mavericks,DAL @ LAC,110,-8,Playoffs
42019,1610612738,BOS,Boston Celtics,0041900121,2020-08-17T00:00:00Z,BOS vs. PHI,109,8,1610612755,PHI,Philadelphia 76ers,PHI @ BOS,101,-8,Playoffs
42019,1610612743,DEN,Denver Nuggets,0041900161,2020-08-17T00:00:00Z,DEN vs. UTA,135,10,1610612762,UTA,Utah Jazz,UTA @ DEN,125,-10,Playoffs
42019,1610612761,TOR,Toronto Raptors,0041900111,2020-08-17T00:00:00Z,TOR vs. BKN,134,24,1610612751,BKN,Brooklyn Nets,BKN @ TOR,110,-24,Playoffs
42019,1610612745,HOU,Houston Rockets,0041900171,2020-08-18T00:00:00Z,HOU vs. OKC,123,15,1610612760,OKC,Oklahoma City Thunder,OKC @ HOU,108,-15,Playoffs
42019,1610612747,LAL,Los Angeles Lakers,0041900141,2020-08-18T00:00:00Z,LAL vs. POR,93,-7,1610612757,POR,Portland Trail Blazers,POR @ LAL,100,7,Playoffs
42019,1610612754,IND,Indiana Pacers,0041900131,2020-08-18T00:00:00Z,IND vs. MIA,101,-12,1610612748,MIA,Miami Heat,MIA @ IND,113,12,Playoffs
42019,1610612749,MIL,Milwaukee Bucks,0041900101,2020-08-18T00:00:00Z,MIL vs. ORL,110,-12,1610612753,ORL,Orlando Magic,ORL @ MIL,122,12,Playoffs
42019,1610612738,BOS,Boston Celtics,0041900122,2020-08-19T00:00:00Z,BOS vs. PHI,128,27,1610612755,PHI,Philadelphia 76ers,PHI @ BOS,101,-27,Playoffs
42019,1610612746,LAC,LA Clippers,0041900152,2020-08-19T00:00:00Z,LAC vs. DAL,114,-13,1610612742,DAL,Dallas Mavericks,DAL @ LAC,127,13,Playoffs
42019,1610612743,DEN,Denver Nuggets,0041900162,2020-08-19T00:00:00Z,DEN vs. UTA,105,-19,1610612762,UTA,Utah Jazz,UTA @ DEN,124,19,Playoffs
42019,1610612761,TOR,Toronto Raptors,0041900112,2020-08-19T00:00:00Z,TOR vs. BKN,104,5,1610612751,BKN,Brooklyn Nets,BKN @ TOR,99,-5,Playoffs
42019,1610612749,MIL,Milwaukee Bucks,0041900102,2020-08-20T00:00:00Z,MIL vs. ORL,111,15,1610612753,ORL,Orlando Magic,ORL @ MIL,96,-15,Playoffs
42019,1610612745,HOU,Houston Rockets,0041900172,2020-08-20T00:00:00Z,HOU vs. OKC,111,13,1610612760,OKC,Oklahoma City Thunder,OKC @ HOU,98,-13,Playoffs
42019,1610612754,IND,Indiana Pacers,0041900132,2020-08-20T00:00:00Z,IND vs. MIA,100,-9,1610612748,MIA,Miami Heat,MIA @ IND,109,9,Playoffs
42019,1610612747,LAL,Los Angeles Lakers,0041900142,2020-08-20T00:00:00Z,LAL vs. POR,111,23,1610612757,POR,Portland Trail Blazers,POR @ LAL,88,-23,Playoffs
42019,1610612755,PHI,Philadelphia 76ers,0041900123,2020-08-21T00:00:00Z,PHI vs. BOS,94,-8,1610612738,BOS,Boston Celtics,BOS @ PHI,102,8,Playoffs
42019,1610612751,BKN,Brooklyn Nets,0041900113,2020-08-21T00:00:00Z,BKN vs. TOR,92,-25,1610612761,TOR,Toronto Raptors,TOR @ BKN,117,25,Playoffs
42019,1610612742,DAL,Dallas Mavericks,0041900153,2020-08-21T00:00:00Z,DAL vs. LAC,122,-8,1610612746,LAC,LA Clippers,LAC @ DAL,130,8,Playoffs
42019,1610612762,UTA,Utah Jazz,0041900163,2020-08-21T00:00:00Z,UTA vs. DEN,124,37,1610612743,DEN,Denver Nuggets,DEN @ UTA,87,-37,Playoffs
42019,1610612753,ORL,Orlando Magic,0041900103,2020-08-22T00:00:00Z,ORL vs. MIL,107,-14,1610612749,MIL,Milwaukee Bucks,MIL @ ORL,121,14,Playoffs
42019,1610612757,POR,Portland Trail Blazers,0041900143,2020-08-22T00:00:00Z,POR vs. LAL,108,-8,1610612747,LAL,Los Angeles Lakers,LAL @ POR,116,8,Playoffs
42019,1610612748,MIA,Miami Heat,0041900133,2020-08-22T00:00:00Z,MIA vs. IND,124,9,1610612754,IND,Indiana Pacers,IND @ MIA,115,-9,Playoffs
42019,1610612760,OKC,Oklahoma City Thunder,0041900173,2020-08-22T00:00:00Z,OKC vs. HOU,119,12,1610612745,HOU,Houston Rockets,HOU @ OKC,107,-12,Playoffs
42019,1610612755,PHI,Philadelphia 76ers,0041900124,2020-08-23T00:00:00Z,PHI vs. BOS,106,-4,1610612738,BOS,Boston Celtics,BOS @ PHI,110,4,Playoffs
42019,1610612762,UTA,Utah Jazz,0041900164,2020-08-23T00:00:00Z,UTA vs. DEN,129,2,1610612743,DEN,Denver Nuggets,DEN @ UTA,127,-2,Playoffs
42019,1610612751,BKN,Brooklyn Nets,0041900114,2020-08-23T00:00:00Z,BKN vs. TOR,122,-28,1610612761,TOR,Toronto Raptors,TOR @ BKN,150,28,Playoffs
42019,1610612742,DAL,Dallas Mavericks,0041900154,2020-08-23T00:00:00Z,DAL vs. LAC,135,2,1610612746,LAC,LA Clippers,LAC @ DAL,133,-2,Playoffs
42019,1610612760,OKC,Oklahoma City Thunder,0041900174,2020-08-24T00:00:00Z,OKC vs. HOU,117,3,1610612745,HOU,Houston Rockets,HOU @ OKC,114,-3,Playoffs
42019,1610612757,POR,Portland Trail Blazers,0041900144,2020-08-24T00:00:00Z,POR vs. LAL,115,-20,1610612747,LAL,Los Angeles Lakers,LAL @ POR,135,20,Playoffs
42019,1610612748,MIA,Miami Heat,0041900134,2020-08-24T00:00:00Z,MIA vs. IND,99,12,1610612754,IND,Indiana Pacers,IND @ MIA,87,-12,Playoffs
42019,1610612753,ORL,Orlando Magic,0041900104,2020-08-24T00:00:00Z,ORL vs. MIL,106,-15,1610612749,MIL,Milwaukee Bucks,MIL @ ORL,121,15,Playoffs
42019,1610612746,LAC,LA Clippers,0041900155,2020-08-25T00:00:00Z,LAC vs. DAL,154,43,1610612742,DAL,Dallas Mavericks,DAL @ LAC,111,-43,Playoffs
42019,1610612743,DEN,Denver Nuggets,0041900165,2020-08-25T00:00:00Z,DEN vs. UTA,117,10,1610612762,UTA,Utah Jazz,UTA @ DEN,107,-10,Playoffs
42019,1610612745,HOU,Houston Rockets,0041900175,2020-08-29T00:00:00Z,HOU vs. OKC,114,34,1610612760,OKC,Oklahoma City Thunder,OKC @ HOU,80,-34,Playoffs
42019,1610612749,MIL,Milwaukee Bucks,0041900105,2020-08-29T00:00:00Z,MIL vs. ORL,118,14,1610612753,ORL,Orlando Magic,ORL @ MIL,104,-14,Playoffs
42019,1610612747,LAL,Los Angeles Lakers,0041900145,2020-08-29T00:00:00Z,LAL vs. POR,131,9,1610612757,POR,Portland Trail Blazers,POR @ LAL,122,-9,Playoffs
42019,1610612762,UTA,Utah Jazz,0041900166,2020-08-30T00:00:00Z,UTA vs. DEN,107,-12,1610612743,DEN,Denver Nuggets,DEN @ UTA,119,12,Playoffs
42019,1610612761,TOR,Toronto Raptors,0041900211,2020-08-30T00:00:00Z,TOR vs. BOS,94,-18,1610612738,BOS,Boston Celtics,BOS @ TOR,112,18,Playoffs
42019,1610612742,DAL,Dallas Mavericks,0041900156,2020-08-30T00:00:00Z,DAL vs. LAC,97,-14,1610612746,LAC,LA Clippers,LAC @ DAL,111,14,Playoffs
42019,1610612760,OKC,Oklahoma City Thunder,0041900176,2020-08-31T00:00:00Z,OKC vs. HOU,104,4,1610612745,HOU,Houston Rockets,HOU @ OKC,100,-4,Playoffs
42019,1610612749,MIL,Milwaukee Bucks,0041900201,2020-08-31T00:00:00Z,MIL vs. MIA,104,-11,1610612748,MIA,Miami Heat,MIA @ MIL,115,11,Playoffs
42019,1610612761,TOR,Toronto Raptors,0041900212,2020-09-01T00:00:00Z,TOR vs. BOS,99,-3,1610612738,BOS,Boston Celtics,BOS @ TOR,102,3,Playoffs
42019,1610612743,DEN,Denver Nuggets,0041900167,2020-09-01T00:00:00Z,DEN vs. UTA,80,2,1610612762,UTA,Utah Jazz,UTA @ DEN,78,-2,Playoffs
42019,1610612745,HOU,Houston Rockets,0041900177,2020-09-02T00:00:00Z,HOU vs. OKC,104,2,1610612760,OKC,Oklahoma City Thunder,OKC @ HOU,102,-2,Playoffs
42019,1610612749,MIL,Milwaukee Bucks,0041900202,2020-09-02T00:00:00Z,MIL vs. MIA,114,-2,1610612748,MIA,Miami Heat,MIA @ MIL,116,2,Playoffs
42019,1610612738,BOS,Boston Celtics,0041900213,2020-09-03T00:00:00Z,BOS vs. TOR,103,-1,1610612761,TOR,Toronto Raptors,TOR @ BOS,104,1,Playoffs
42019,1610612746,LAC,LA Clippers,0041900231,2020-09-03T00:00:00Z,LAC vs. DEN,120,23,1610612743,DEN,Denver Nuggets,DEN @ LAC,97,-23,Playoffs
42019,1610612747,LAL,Los Angeles Lakers,0041900221,2020-09-04T00:00:00Z,LAL vs. HOU,97,-15,1610612745,HOU,Houston Rockets,HOU @ LAL,112,15,Playoffs
42019,1610612748,MIA,Miami Heat,0041900203,2020-09-04T00:00:00Z,MIA vs. MIL,115,15,1610612749,MIL,Milwaukee Bucks,MIL @ MIA,100,-15,Playoffs
42019,1610612738,BOS,Boston Celtics,0041900214,2020-09-05T00:00:00Z,BOS vs. TOR,93,-7,1610612761,TOR,Toronto Raptors,TOR @ BOS,100,7,Playoffs
42019,1610612746,LAC,LA Clippers,0041900232,2020-09-05T00:00:00Z,LAC vs. DEN,101,-9,1610612743,DEN,Denver Nuggets,DEN @ LAC,110,9,Playoffs
42019,1610612748,MIA,Miami Heat,0041900204,2020-09-06T00:00:00Z,MIA vs. MIL,115,-3,1610612749,MIL,Milwaukee Bucks,MIL @ MIA,118,3,Playoffs
42019,1610612747,LAL,Los Angeles Lakers,0041900222,2020-09-06T00:00:00Z,LAL vs. HOU,117,8,1610612745,HOU,Houston Rockets,HOU @ LAL,109,-8,Playoffs
42019,1610612761,TOR,Toronto Raptors,0041900215,2020-09-07T00:00:00Z,TOR vs. BOS,89,-22,1610612738,BOS,Boston Celtics,BOS @ TOR,111,22,Playoffs
42019,1610612743,DEN,Denver Nuggets,0041900233,2020-09-07T00:00:00Z,DEN vs. LAC,107,-6,1610612746,LAC,LA Clippers,LAC @ DEN,113,6,Playoffs
42019,1610612749,MIL,Milwaukee Bucks,0041900205,2020-09-08T00:00:00Z,MIL vs. MIA,94,-9,1610612748,MIA,Miami Heat,MIA @ MIL,103,9,Playoffs
42019,1610612745,HOU,Houston Rockets,0041900223,2020-09-08T00:00:00Z,HOU vs. LAL,102,-10,1610612747,LAL,Los Angeles Lakers,LAL @ HOU,112,10,Playoffs
42019,1610612743,DEN,Denver Nuggets,0041900234,2020-09-09T00:00:00Z,DEN vs. LAC,85,-11,1610612746,LAC,LA Clippers,LAC @ DEN,96,11,Playoffs
42019,1610612738,BOS,Boston Celtics,0041900216,2020-09-09T00:00:00Z,BOS vs. TOR,122,-3,1610612761,TOR,Toronto Raptors,TOR @ BOS,125,3,Playoffs
42019,1610612745,HOU,Houston Rockets,0041900224,2020-09-10T00:00:00Z,HOU vs. LAL,100,-10,1610612747,LAL,Los Angeles Lakers,LAL @ HOU,110,10,Playoffs
42019,1610612761,TOR,Toronto Raptors,0041900217,2020-09-11T00:00:00Z,TOR vs. BOS,87,-5,1610612738,BOS,Boston Celtics,BOS @ TOR,92,5,Playoffs
42019,1610612746,LAC,LA Clippers,0041900235,2020-09-11T00:00:00Z,LAC vs. DEN,105,-6,1610612743,DEN,Denver Nuggets,DEN @ LAC,111,6,Playoffs
42019,1610612747,LAL,Los Angeles Lakers,0041900225,2020-09-12T00:00:00Z,LAL vs. HOU,119,23,1610612745,HOU,Houston Rockets,HOU @ LAL,96,-23,Playoffs
42019,1610612743,DEN,Denver Nuggets,0041900236,2020-09-13T00:00:00Z,DEN vs. LAC,111,13,1610612746,LAC,LA Clippers,LAC @ DEN,98,-13,Playoffs
42019,1610612746,LAC,LA Clippers,0041900237,2020-09-15T00:00:00Z,LAC vs. DEN,89,-15,1610612743,DEN,Denver Nuggets,DEN @ LAC,104,15,Playoffs
42019,1610612738,BOS,Boston Celtics,0041900301,2020-09-15T00:00:00Z,BOS vs. MIA,114,-3,1610612748,MIA,Miami Heat,MIA @ BOS,117,3,Playoffs
42019,1610612738,BOS,Boston Celtics,0041900302,2020-09-17T00:00:00Z,BOS vs. MIA,101,-5,1610612748,MIA,Miami Heat,MIA @ BOS,106,5,Playoffs
42019,1610612747,LAL,Los Angeles Lakers,0041900311,2020-09-18T00:00:00Z,LAL vs. DEN,126,12,1610612743,DEN,Denver Nuggets,DEN @ LAL,114,-12,Playoffs
42019,1610612748,MIA,Miami Heat,0041900303,2020-09-19T00:00:00Z,MIA vs. BOS,106,-11,1610612738,BOS,Boston Celtics,BOS @ MIA,117,11,Playoffs
42019,1610612747,LAL,Los Angeles Lakers,0041900312,2020-09-20T00:00:00Z,LAL vs. DEN,105,2,1610612743,DEN,Denver Nuggets,DEN @ LAL,103,-2,Playoffs
42019,1610612743,DEN,Denver Nuggets,0041900313,2020-09-22T00:00:00Z,DEN vs. LAL,114,8,1610612747,LAL,Los Angeles Lakers,LAL @ DEN,106,-8,Playoffs
42019,1610612748,MIA,Miami Heat,0041900304,2020-09-23T00:00:00Z,MIA vs. BOS,112,3,1610612738,BOS,Boston Celtics,BOS @ MIA,109,-3,Playoffs
42019,1610612743,DEN,Denver Nuggets,0041900314,2020-09-24T00:00:00Z,DEN vs. LAL,108,-6,1610612747,LAL,Los Angeles Lakers,LAL @ DEN,114,6,Playoffs
42019,1610612738,BOS,Boston Celtics,0041900305,2020-09-25T00:00:00Z,BOS vs. MIA,121,13,1610612748,MIA,Miami Heat,MIA @ BOS,108,-13,Playoffs
42019,1610612747,LAL,Los Angeles Lakers,0041900315,2020-09-26T00:00:00Z,LAL vs. DEN,117,10,1610612743,DEN,Denver Nuggets,DEN @ LAL,107,-10,Playoffs
42019,1610612748,MIA,Miami Heat,0041900306,2020-09-27T00:00:00Z,MIA vs. BOS,125,12,1610612738,BOS,Boston Celtics,BOS @ MIA,113,-12,Playoffs
42019,1610612747,LAL,Los Angeles Lakers,0041900401,2020-09-30T00:00:00Z,LAL vs. MIA,116,18,1610612748,MIA,Miami Heat,MIA @ LAL,98,-18,Playoffs
42019,1610612747,LAL,Los Angeles Lakers,0041900402,2020-10-02T00:00:00Z,LAL vs. MIA,124,10,1610612748,MIA,Miami Heat,MIA @ LAL,114,-10,Playoffs
42019,1610612748,MIA,Miami Heat,0041900403,2020-10-04T00:00:00Z,MIA vs. LAL,115,11,1610612747,LAL,Los Angeles Lakers,LAL @ MIA,104,-11,Playoffs
42019,1610612748,MIA,Miami Heat,0041900404,2020-10-06T00:00:00Z,MIA vs. LAL,96,-6,1610612747,LAL,Los Angeles Lakers,LAL @ MIA,102,6,Playoffs
42019,1610612747,LAL,Los Angeles Lakers,0041900405,2020-10-09T00:00:00Z,LAL vs. MIA,108,-3,1610612748,MIA,Miami Heat,MIA @ LAL,111,3,Playoffs
42019,1610612748,MIA,Miami Heat,0041900406,2020-10-11T00:00:00Z,MIA vs. LAL,93,-13,1610612747,LAL,Los Angeles Lakers,LAL @ MIA,106,13,Playoffs
32019,1610616833,GNS,Team Giannis,0031900001,2020-02-16T00:00:00Z,GNS vs. LBN,155,-2,1610616834,LBN,Team LeBron,LBN @ GNS,157,2,All-Star
22020,1610612751,BKN,Brooklyn Nets,0022000001,2020-12-22T00:00:00Z,BKN vs. GSW,125,26,1610612744,GSW,Golden State Warriors,GSW @ BKN,99,-26,Regular Season
22020,1610612747,LAL,Los Angeles Lakers,0022000002,2020-12-22T00:00:00Z,LAL vs. LAC,109,-7,1610612746,LAC,LA Clippers,LAC @ LAL,116,7,Regular Season
22020,1610612757,POR,Portland Trail Blazers,0022000020,2020-12-23T00:00:00Z,POR vs. UTA,100,-20,1610612762,UTA,Utah Jazz,UTA @ POR,120,20,Regular Season
22020,1610612739,CLE,Cleveland Cavaliers,0022000010,2020-12-23T00:00:00Z,CLE vs. CHA,121,7,1610612766,CHA,Charlotte Hornets,CHA @ CLE,114,-7,Regular Season
22020,1610612763,MEM,Memphis Grizzlies,0022000017,2020-12-23T00:00:00Z,MEM vs. SAS,119,-12,1610612759,SAS,San Antonio Spurs,SAS @ MEM,131,12,Regular Season
22020,1610612741,CHI,Chicago Bulls,0022000015,2020-12-23T00:00:00Z,CHI vs. ATL,104,-20,1610612737,ATL,Atlanta Hawks,ATL @ CHI,124,20,Regular Season
22020,1610612755,PHI,Philadelphia 76ers,0022000013,2020-12-23T00:00:00Z,PHI vs. WAS,113,6,1610612764,WAS,Washington Wizards,WAS @ PHI,107,-6,Regular Season
22020,1610612750,MIN,Minnesota Timberwolves,0022000018,2020-12-23T00:00:00Z,MIN vs. DET,111,10,1610612765,DET,Detroit Pistons,DET @ MIN,101,-10,Regular Season
22020,1610612756,PHX,Phoenix Suns,0022000004,2020-12-23T00:00:00Z,PHX vs. DAL,106,4,1610612742,DAL,Dallas Mavericks,DAL @ PHX,102,-4,Regular Season
22020,1610612753,ORL,Orlando Magic,0022000012,2020-12-23T00:00:00Z,ORL vs. MIA,113,6,1610612748,MIA,Miami Heat,MIA @ ORL,107,-6,Regular Season
22020,1610612743,DEN,Denver Nuggets,0022000019,2020-12-23T00:00:00Z,DEN vs. SAC,122,-2,1610612758,SAC,Sacramento Kings,SAC @ DEN,124,2,Regular Season
22020,1610612754,IND,Indiana Pacers,0022000011,2020-12-23T00:00:00Z,IND vs. NYK,121,14,1610612752,NYK,New York Knicks,NYK @ IND,107,-14,Regular Season
22020,1610612738,BOS,Boston Celtics,0022000003,2020-12-23T00:00:00Z,BOS vs. MIL,122,1,1610612749,MIL,Milwaukee Bucks,MIL @ BOS,121,-1,Regular Season
22020,1610612761,TOR,Toronto Raptors,0022000014,2020-12-23T00:00:00Z,TOR vs. NOP,99,-14,1610612740,NOP,New Orleans Pelicans,NOP @ TOR,113,14,Regular Season
22020,1610612748,MIA,Miami Heat,0022000005,2020-12-25T00:00:00Z,MIA vs. NOP,111,13,1610612740,NOP,New Orleans Pelicans,NOP @ MIA,98,-13,Regular Season
22020,1610612747,LAL,Los Angeles Lakers,0022000008,2020-12-25T00:00:00Z,LAL vs. DAL,138,23,1610612742,DAL,Dallas Mavericks,DAL @ LAL,115,-23,Regular Season
22020,1610612738,BOS,Boston Celtics,0022000007,2020-12-25T00:00:00Z,BOS vs. BKN,95,-28,1610612751,BKN,Brooklyn Nets,BKN @ BOS,123,28,Regular Season
22020,1610612749,MIL,Milwaukee Bucks,0022000006,2020-12-25T00:00:00Z,MIL vs. GSW,138,39,1610612744,GSW,Golden State Warriors,GSW @ MIL,99,-39,Regular Season
22020,1610612743,DEN,Denver Nuggets,0022000009,2020-12-25T00:00:00Z,DEN vs. LAC,108,-13,1610612746,LAC,LA Clippers,LAC @ DEN,121,13,Regular Season
22020,1610612763,MEM,Memphis Grizzlies,0022000021,2020-12-26T00:00:00Z,MEM vs. ATL,112,-10,1610612737,ATL,Atlanta Hawks,ATL @ MEM,122,10,Regular Season
22020,1610612764,WAS,Washington Wizards,0022000024,2020-12-26T00:00:00Z,WAS vs. ORL,120,-10,1610612753,ORL,Orlando Magic,ORL @ WAS,130,10,Regular Season
22020,1610612759,SAS,San Antonio Spurs,0022000027,2020-12-26T00:00:00Z,SAS vs. TOR,119,5,1610612761,TOR,Toronto Raptors,TOR @ SAS,114,-5,Regular Season
22020,1610612741,CHI,Chicago Bulls,0022000026,2020-12-26T00:00:00Z,CHI vs. IND,106,-19,1610612754,IND,Indiana Pacers,IND @ CHI,125,19,Regular Season
22020,1610612758,SAC,Sacramento Kings,0022000030,2020-12-26T00:00:00Z,SAC vs. PHX,106,3,1610612756,PHX,Phoenix Suns,PHX @ SAC,103,-3,Regular Season
22020,1610612752,NYK,New York Knicks,0022000025,2020-12-26T00:00:00Z,NYK vs. PHI,89,-20,1610612755,PHI,Philadelphia 76ers,PHI @ NYK,109,20,Regular Season
22020,1610612765,DET,Detroit Pistons,0022000023,2020-12-26T00:00:00Z,DET vs. CLE,119,-9,1610612739,CLE,Cleveland Cavaliers,CLE @ DET,128,9,Regular Season
22020,1610612766,CHA,Charlotte Hornets,0022000022,2020-12-26T00:00:00Z,CHA vs. OKC,107,-2,1610612760,OKC,Oklahoma City Thunder,OKC @ CHA,109,2,Regular Season
22020,1610612757,POR,Portland Trail Blazers,0022000029,2020-12-26T00:00:00Z,POR vs. HOU,128,2,1610612745,HOU,Houston Rockets,HOU @ POR,126,-2,Regular Season
22020,1610612762,UTA,Utah Jazz,0022000028,2020-12-26T00:00:00Z,UTA vs. MIN,111,-5,1610612750,MIN,Minnesota Timberwolves,MIN @ UTA,116,5,Regular Season
22020,1610612747,LAL,Los Angeles Lakers,0022000040,2020-12-27T00:00:00Z,LAL vs. MIN,127,36,1610612750,MIN,Minnesota Timberwolves,MIN @ LAL,91,-36,Regular Season
22020,1610612739,CLE,Cleveland Cavaliers,0022000035,2020-12-27T00:00:00Z,CLE vs. PHI,118,24,1610612755,PHI,Philadelphia 76ers,PHI @ CLE,94,-24,Regular Season
22020,1610612752,NYK,New York Knicks,0022000036,2020-12-27T00:00:00Z,NYK vs. MIL,130,20,1610612749,MIL,Milwaukee Bucks,MIL @ NYK,110,-20,Regular Season
22020,1610612766,CHA,Charlotte Hornets,0022000032,2020-12-27T00:00:00Z,CHA vs. BKN,106,2,1610612751,BKN,Brooklyn Nets,BKN @ CHA,104,-2,Regular Season
22020,1610612740,NOP,New Orleans Pelicans,0022000034,2020-12-27T00:00:00Z,NOP vs. SAS,98,3,1610612759,SAS,San Antonio Spurs,SAS @ NOP,95,-3,Regular Season
22020,1610612754,IND,Indiana Pacers,0022000037,2020-12-27T00:00:00Z,IND vs. BOS,108,1,1610612738,BOS,Boston Celtics,BOS @ IND,107,-1,Regular Season
22020,1610612764,WAS,Washington Wizards,0022000033,2020-12-27T00:00:00Z,WAS vs. ORL,113,-7,1610612753,ORL,Orlando Magic,ORL @ WAS,120,7,Regular Season
22020,1610612741,CHI,Chicago Bulls,0022000038,2020-12-27T00:00:00Z,CHI vs. GSW,128,-1,1610612744,GSW,Golden State Warriors,GSW @ CHI,129,1,Regular Season
22020,1610612746,LAC,LA Clippers,0022000031,2020-12-27T00:00:00Z,LAC vs. DAL,73,-51,1610612742,DAL,Dallas Mavericks,DAL @ LAC,124,51,Regular Season
22020,1610612758,SAC,Sacramento Kings,0022000039,2020-12-27T00:00:00Z,SAC vs. PHX,100,-16,1610612756,PHX,Phoenix Suns,PHX @ SAC,116,16,Regular Season
22020,1610612743,DEN,Denver Nuggets,0022000044,2020-12-28T00:00:00Z,DEN vs. HOU,124,13,1610612745,HOU,Houston Rockets,HOU @ DEN,111,-13,Regular Season
22020,1610612760,OKC,Oklahoma City Thunder,0022000043,2020-12-28T00:00:00Z,OKC vs. UTA,109,-1,1610612762,UTA,Utah Jazz,UTA @ OKC,110,1,Regular Season
22020,1610612737,ATL,Atlanta Hawks,0022000041,2020-12-28T00:00:00Z,ATL vs. DET,128,8,1610612765,DET,Detroit Pistons,DET @ ATL,120,-8,Regular Season
22020,1610612747,LAL,Los Angeles Lakers,0022000045,2020-12-28T00:00:00Z,LAL vs. POR,107,-8,1610612757,POR,Portland Trail Blazers,POR @ LAL,115,8,Regular Season
22020,1610612751,BKN,Brooklyn Nets,0022000042,2020-12-28T00:00:00Z,BKN vs. MEM,111,-5,1610612763,MEM,Memphis Grizzlies,MEM @ BKN,116,5,Regular Season
22020,1610612754,IND,Indiana Pacers,0022000048,2020-12-29T00:00:00Z,IND vs. BOS,111,-5,1610612738,BOS,Boston Celtics,BOS @ IND,116,5,Regular Season
22020,1610612758,SAC,Sacramento Kings,0022000055,2020-12-29T00:00:00Z,SAC vs. DEN,125,10,1610612743,DEN,Denver Nuggets,DEN @ SAC,115,-10,Regular Season
22020,1610612765,DET,Detroit Pistons,0022000047,2020-12-29T00:00:00Z,DET vs. GSW,106,-10,1610612744,GSW,Golden State Warriors,GSW @ DET,116,10,Regular Season
22020,1610612755,PHI,Philadelphia 76ers,0022000049,2020-12-29T00:00:00Z,PHI vs. TOR,100,7,1610612761,TOR,Toronto Raptors,TOR @ PHI,93,-7,Regular Season
22020,1610612748,MIA,Miami Heat,0022000051,2020-12-29T00:00:00Z,MIA vs. MIL,97,-47,1610612749,MIL,Milwaukee Bucks,MIL @ MIA,144,47,Regular Season
22020,1610612746,LAC,LA Clippers,0022000054,2020-12-29T00:00:00Z,LAC vs. MIN,124,23,1610612750,MIN,Minnesota Timberwolves,MIN @ LAC,101,-23,Regular Season
22020,1610612756,PHX,Phoenix Suns,0022000053,2020-12-29T00:00:00Z,PHX vs. NOP,111,25,1610612740,NOP,New Orleans Pelicans,NOP @ PHX,86,-25,Regular Season
22020,1610612760,OKC,Oklahoma City Thunder,0022000052,2020-12-29T00:00:00Z,OKC vs. ORL,107,-11,1610612753,ORL,Orlando Magic,ORL @ OKC,118,11,Regular Season
22020,1610612764,WAS,Washington Wizards,0022000050,2020-12-29T00:00:00Z,WAS vs. CHI,107,-8,1610612741,CHI,Chicago Bulls,CHI @ WAS,115,8,Regular Season
22020,1610612739,CLE,Cleveland Cavaliers,0022000046,2020-12-29T00:00:00Z,CLE vs. NYK,86,-9,1610612752,NYK,New York Knicks,NYK @ CLE,95,9,Regular Season
22020,1610612738,BOS,Boston Celtics,0022000056,2020-12-30T00:00:00Z,BOS vs. MEM,126,19,1610612763,MEM,Memphis Grizzlies,MEM @ BOS,107,-19,Regular Season
22020,1610612746,LAC,LA Clippers,0022000061,2020-12-30T00:00:00Z,LAC vs. POR,128,23,1610612757,POR,Portland Trail Blazers,POR @ LAC,105,-23,Regular Season
22020,1610612748,MIA,Miami Heat,0022000058,2020-12-30T00:00:00Z,MIA vs. MIL,119,11,1610612749,MIL,Milwaukee Bucks,MIL @ MIA,108,-11,Regular Season
22020,1610612742,DAL,Dallas Mavericks,0022000059,2020-12-30T00:00:00Z,DAL vs. CHA,99,-19,1610612766,CHA,Charlotte Hornets,CHA @ DAL,118,19,Regular Season
22020,1610612751,BKN,Brooklyn Nets,0022000057,2020-12-30T00:00:00Z,BKN vs. ATL,145,4,1610612737,ATL,Atlanta Hawks,ATL @ BKN,141,-4,Regular Season
22020,1610612759,SAS,San Antonio Spurs,0022000060,2020-12-30T00:00:00Z,SAS vs. LAL,107,-14,1610612747,LAL,Los Angeles Lakers,LAL @ SAS,121,14,Regular Season
22020,1610612764,WAS,Washington Wizards,0022000063,2020-12-31T00:00:00Z,WAS vs. CHI,130,-3,1610612741,CHI,Chicago Bulls,CHI @ WAS,133,3,Regular Season
22020,1610612762,UTA,Utah Jazz,0022000068,2020-12-31T00:00:00Z,UTA vs. PHX,95,-11,1610612756,PHX,Phoenix Suns,PHX @ UTA,106,11,Regular Season
22020,1610612745,HOU,Houston Rockets,0022000065,2020-12-31T00:00:00Z,HOU vs. SAC,122,3,1610612758,SAC,Sacramento Kings,SAC @ HOU,119,-3,Regular Season
22020,1610612753,ORL,Orlando Magic,0022000064,2020-12-31T00:00:00Z,ORL vs. PHI,92,-24,1610612755,PHI,Philadelphia 76ers,PHI @ ORL,116,24,Regular Season
22020,1610612760,OKC,Oklahoma City Thunder,0022000067,2020-12-31T00:00:00Z,OKC vs. NOP,80,-33,1610612740,NOP,New Orleans Pelicans,NOP @ OKC,113,33,Regular Season
22020,1610612754,IND,Indiana Pacers,0022000062,2020-12-31T00:00:00Z,IND vs. CLE,119,20,1610612739,CLE,Cleveland Cavaliers,CLE @ IND,99,-20,Regular Season
22020,1610612761,TOR,Toronto Raptors,0022000066,2020-12-31T00:00:00Z,TOR vs. NYK,100,17,1610612752,NYK,New York Knicks,NYK @ TOR,83,-17,Regular Season
22020,1610612750,MIN,Minnesota Timberwolves,0022000074,2021-01-01T00:00:00Z,MIN vs. WAS,109,-21,1610612764,WAS,Washington Wizards,WAS @ MIN,130,21,Regular Season
22020,1610612762,UTA,Utah Jazz,0022000077,2021-01-01T00:00:00Z,UTA vs. LAC,106,6,1610612746,LAC,LA Clippers,LAC @ UTA,100,-6,Regular Season
22020,1610612759,SAS,San Antonio Spurs,0022000075,2021-01-01T00:00:00Z,SAS vs. LAL,103,-6,1610612747,LAL,Los Angeles Lakers,LAL @ SAS,109,6,Regular Season
22020,1610612765,DET,Detroit Pistons,0022000070,2021-01-01T00:00:00Z,DET vs. BOS,96,3,1610612738,BOS,Boston Celtics,BOS @ DET,93,-3,Regular Season
22020,1610612742,DAL,Dallas Mavericks,0022000071,2021-01-01T00:00:00Z,DAL vs. MIA,93,10,1610612748,MIA,Miami Heat,MIA @ DAL,83,-10,Regular Season
22020,1610612743,DEN,Denver Nuggets,0022000076,2021-01-01T00:00:00Z,DEN vs. PHX,103,-3,1610612756,PHX,Phoenix Suns,PHX @ DEN,106,3,Regular Season
22020,1610612766,CHA,Charlotte Hornets,0022000069,2021-01-01T00:00:00Z,CHA vs. MEM,93,-15,1610612763,MEM,Memphis Grizzlies,MEM @ CHA,108,15,Regular Season
22020,1610612749,MIL,Milwaukee Bucks,0022000073,2021-01-01T00:00:00Z,MIL vs. CHI,126,30,1610612741,CHI,Chicago Bulls,CHI @ MIL,96,-30,Regular Season
22020,1610612751,BKN,Brooklyn Nets,0022000072,2021-01-01T00:00:00Z,BKN vs. ATL,96,-18,1610612737,ATL,Atlanta Hawks,ATL @ BKN,114,18,Regular Season
22020,1610612744,GSW,Golden State Warriors,0022000078,2021-01-01T00:00:00Z,GSW vs. POR,98,-25,1610612757,POR,Portland Trail Blazers,POR @ GSW,123,25,Regular Season
22020,1610612755,PHI,Philadelphia 76ers,0022000082,2021-01-02T00:00:00Z,PHI vs. CHA,127,15,1610612766,CHA,Charlotte Hornets,CHA @ PHI,112,-15,Regular Season
22020,1610612740,NOP,New Orleans Pelicans,0022000084,2021-01-02T00:00:00Z,NOP vs. TOR,120,4,1610612761,TOR,Toronto Raptors,TOR @ NOP,116,-4,Regular Season
22020,1610612745,HOU,Houston Rockets,0022000079,2021-01-02T00:00:00Z,HOU vs. SAC,102,8,1610612758,SAC,Sacramento Kings,SAC @ HOU,94,-8,Regular Season
22020,1610612754,IND,Indiana Pacers,0022000080,2021-01-02T00:00:00Z,IND vs. NYK,102,-4,1610612752,NYK,New York Knicks,NYK @ IND,106,4,Regular Season
22020,1610612753,ORL,Orlando Magic,0022000081,2021-01-02T00:00:00Z,ORL vs. OKC,99,-9,1610612760,OKC,Oklahoma City Thunder,OKC @ ORL,108,9,Regular Season
22020,1610612737,ATL,Atlanta Hawks,0022000083,2021-01-02T00:00:00Z,ATL vs. CLE,91,-5,1610612739,CLE,Cleveland Cavaliers,CLE @ ATL,96,5,Regular Season
22020,1610612744,GSW,Golden State Warriors,0022000092,2021-01-03T00:00:00Z,GSW vs. POR,137,15,1610612757,POR,Portland Trail Blazers,POR @ GSW,122,-15,Regular Season
22020,1610612765,DET,Detroit Pistons,0022000085,2021-01-03T00:00:00Z,DET vs. BOS,120,-2,1610612738,BOS,Boston Celtics,BOS @ DET,122,2,Regular Season
22020,1610612750,MIN,Minnesota Timberwolves,0022000088,2021-01-03T00:00:00Z,MIN vs. DEN,109,-15,1610612743,DEN,Denver Nuggets,DEN @ MIN,124,15,Regular Season
22020,1610612763,MEM,Memphis Grizzlies,0022000087,2021-01-03T00:00:00Z,MEM vs. LAL,94,-14,1610612747,LAL,Los Angeles Lakers,LAL @ MEM,108,14,Regular Season
22020,1610612759,SAS,San Antonio Spurs,0022000089,2021-01-03T00:00:00Z,SAS vs. UTA,109,-21,1610612762,UTA,Utah Jazz,UTA @ SAS,130,21,Regular Season
22020,1610612756,PHX,Phoenix Suns,0022000091,2021-01-03T00:00:00Z,PHX vs. LAC,107,-5,1610612746,LAC,LA Clippers,LAC @ PHX,112,5,Regular Season
22020,1610612751,BKN,Brooklyn Nets,0022000086,2021-01-03T00:00:00Z,BKN vs. WAS,122,-1,1610612764,WAS,Washington Wizards,WAS @ BKN,123,1,Regular Season
22020,1610612741,CHI,Chicago Bulls,0022000090,2021-01-03T00:00:00Z,CHI vs. DAL,118,10,1610612742,DAL,Dallas Mavericks,DAL @ CHI,108,-10,Regular Season
22020,1610612749,MIL,Milwaukee Bucks,0022000099,2021-01-04T00:00:00Z,MIL vs. DET,125,10,1610612765,DET,Detroit Pistons,DET @ MIL,115,-10,Regular Season
22020,1610612737,ATL,Atlanta Hawks,0022000095,2021-01-04T00:00:00Z,ATL vs. NYK,108,-5,1610612752,NYK,New York Knicks,NYK @ ATL,113,5,Regular Season
22020,1610612745,HOU,Houston Rockets,0022000098,2021-01-04T00:00:00Z,HOU vs. DAL,100,-13,1610612742,DAL,Dallas Mavericks,DAL @ HOU,113,13,Regular Season
22020,1610612740,NOP,New Orleans Pelicans,0022000100,2021-01-04T00:00:00Z,NOP vs. IND,116,-2,1610612754,IND,Indiana Pacers,IND @ NOP,118,2,Regular Season
22020,1610612753,ORL,Orlando Magic,0022000093,2021-01-04T00:00:00Z,ORL vs. CLE,103,20,1610612739,CLE,Cleveland Cavaliers,CLE @ ORL,83,-20,Regular Season
22020,1610612761,TOR,Toronto Raptors,0022000097,2021-01-04T00:00:00Z,TOR vs. BOS,114,-12,1610612738,BOS,Boston Celtics,BOS @ TOR,126,12,Regular Season
22020,1610612744,GSW,Golden State Warriors,0022000101,2021-01-04T00:00:00Z,GSW vs. SAC,137,31,1610612758,SAC,Sacramento Kings,SAC @ GSW,106,-31,Regular Season
22020,1610612755,PHI,Philadelphia 76ers,0022000094,2021-01-04T00:00:00Z,PHI vs. CHA,118,17,1610612766,CHA,Charlotte Hornets,CHA @ PHI,101,-17,Regular Season
22020,1610612748,MIA,Miami Heat,0022000096,2021-01-04T00:00:00Z,MIA vs. OKC,118,28,1610612760,OKC,Oklahoma City Thunder,OKC @ MIA,90,-28,Regular Season
22020,1610612757,POR,Portland Trail Blazers,0022000106,2021-01-05T00:00:00Z,POR vs. CHI,108,-3,1610612741,CHI,Chicago Bulls,CHI @ POR,111,3,Regular Season
22020,1610612751,BKN,Brooklyn Nets,0022000102,2021-01-05T00:00:00Z,BKN vs. UTA,130,34,1610612762,UTA,Utah Jazz,UTA @ BKN,96,-34,Regular Season
22020,1610612763,MEM,Memphis Grizzlies,0022000103,2021-01-05T00:00:00Z,MEM vs. LAL,92,-2,1610612747,LAL,Los Angeles Lakers,LAL @ MEM,94,2,Regular Season
22020,1610612746,LAC,LA Clippers,0022000105,2021-01-05T00:00:00Z,LAC vs. SAS,113,-3,1610612759,SAS,San Antonio Spurs,SAS @ LAC,116,3,Regular Season
22020,1610612743,DEN,Denver Nuggets,0022000104,2021-01-05T00:00:00Z,DEN vs. MIN,123,7,1610612750,MIN,Minnesota Timberwolves,MIN @ DEN,116,-7,Regular Season
22020,1610612755,PHI,Philadelphia 76ers,0022000109,2021-01-06T00:00:00Z,PHI vs. WAS,141,5,1610612764,WAS,Washington Wizards,WAS @ PHI,136,-5,Regular Season
22020,1610612758,SAC,Sacramento Kings,0022000117,2021-01-06T00:00:00Z,SAC vs. CHI,128,4,1610612741,CHI,Chicago Bulls,CHI @ SAC,124,-4,Regular Season
22020,1610612754,IND,Indiana Pacers,0022000107,2021-01-06T00:00:00Z,IND vs. HOU,114,7,1610612745,HOU,Houston Rockets,HOU @ IND,107,-7,Regular Season
22020,1610612740,NOP,New Orleans Pelicans,0022000114,2021-01-06T00:00:00Z,NOP vs. OKC,110,-1,1610612760,OKC,Oklahoma City Thunder,OKC @ NOP,111,1,Regular Season
22020,1610612748,MIA,Miami Heat,0022000111,2021-01-06T00:00:00Z,MIA vs. BOS,105,-2,1610612738,BOS,Boston Celtics,BOS @ MIA,107,2,Regular Season
22020,1610612737,ATL,Atlanta Hawks,0022000110,2021-01-06T00:00:00Z,ATL vs. CHA,94,-8,1610612766,CHA,Charlotte Hornets,CHA @ ATL,102,8,Regular Season
22020,1610612756,PHX,Phoenix Suns,0022000115,2021-01-06T00:00:00Z,PHX vs. TOR,123,8,1610612761,TOR,Toronto Raptors,TOR @ PHX,115,-8,Regular Season
22020,1610612752,NYK,New York Knicks,0022000112,2021-01-06T00:00:00Z,NYK vs. UTA,112,12,1610612762,UTA,Utah Jazz,UTA @ NYK,100,-12,Regular Season
22020,1610612749,MIL,Milwaukee Bucks,0022000113,2021-01-06T00:00:00Z,MIL vs. DET,130,15,1610612765,DET,Detroit Pistons,DET @ MIL,115,-15,Regular Season
22020,1610612753,ORL,Orlando Magic,0022000108,2021-01-06T00:00:00Z,ORL vs. CLE,105,11,1610612739,CLE,Cleveland Cavaliers,CLE @ ORL,94,-11,Regular Season
22020,1610612744,GSW,Golden State Warriors,0022000116,2021-01-06T00:00:00Z,GSW vs. LAC,101,-7,1610612746,LAC,LA Clippers,LAC @ GSW,108,7,Regular Season
22020,1610612751,BKN,Brooklyn Nets,0022000118,2021-01-07T00:00:00Z,BKN vs. PHI,122,13,1610612755,PHI,Philadelphia 76ers,PHI @ BKN,109,-13,Regular Season
22020,1610612747,LAL,Los Angeles Lakers,0022000121,2021-01-07T00:00:00Z,LAL vs. SAS,109,-9,1610612759,SAS,San Antonio Spurs,SAS @ LAL,118,9,Regular Season
22020,1610612743,DEN,Denver Nuggets,0022000120,2021-01-07T00:00:00Z,DEN vs. DAL,117,-7,1610612742,DAL,Dallas Mavericks,DAL @ DEN,124,7,Regular Season
22020,1610612763,MEM,Memphis Grizzlies,0022000119,2021-01-07T00:00:00Z,MEM vs. CLE,90,-4,1610612739,CLE,Cleveland Cavaliers,CLE @ MEM,94,4,Regular Season
22020,1610612757,POR,Portland Trail Blazers,0022000122,2021-01-07T00:00:00Z,POR vs. MIN,135,18,1610612750,MIN,Minnesota Timberwolves,MIN @ POR,117,-18,Regular Season
22020,1610612765,DET,Detroit Pistons,0022000123,2021-01-08T00:00:00Z,DET vs. PHX,110,5,1610612756,PHX,Phoenix Suns,PHX @ DET,105,-5,Regular Season
22020,1610612758,SAC,Sacramento Kings,0022000132,2021-01-08T00:00:00Z,SAC vs. TOR,123,-21,1610612761,TOR,Toronto Raptors,TOR @ SAC,144,21,Regular Season
22020,1610612738,BOS,Boston Celtics,0022000124,2021-01-08T00:00:00Z,BOS vs. WAS,116,9,1610612764,WAS,Washington Wizards,WAS @ BOS,107,-9,Regular Season
22020,1610612749,MIL,Milwaukee Bucks,0022000129,2021-01-08T00:00:00Z,MIL vs. UTA,118,-13,1610612762,UTA,Utah Jazz,UTA @ MIL,131,13,Regular Season
22020,1610612745,HOU,Houston Rockets,0022000127,2021-01-08T00:00:00Z,HOU vs. ORL,132,42,1610612753,ORL,Orlando Magic,ORL @ HOU,90,-42,Regular Season
22020,1610612747,LAL,Los Angeles Lakers,0022000131,2021-01-08T00:00:00Z,LAL vs. CHI,117,2,1610612741,CHI,Chicago Bulls,CHI @ LAL,115,-2,Regular Season
22020,1610612763,MEM,Memphis Grizzlies,0022000128,2021-01-08T00:00:00Z,MEM vs. BKN,115,5,1610612751,BKN,Brooklyn Nets,BKN @ MEM,110,-5,Regular Season
22020,1610612752,NYK,New York Knicks,0022000125,2021-01-08T00:00:00Z,NYK vs. OKC,89,-12,1610612760,OKC,Oklahoma City Thunder,OKC @ NYK,101,12,Regular Season
22020,1610612740,NOP,New Orleans Pelicans,0022000126,2021-01-08T00:00:00Z,NOP vs. CHA,110,-8,1610612766,CHA,Charlotte Hornets,CHA @ NOP,118,8,Regular Season
22020,1610612744,GSW,Golden State Warriors,0022000130,2021-01-08T00:00:00Z,GSW vs. LAC,115,10,1610612746,LAC,LA Clippers,LAC @ GSW,105,-10,Regular Season
22020,1610612749,MIL,Milwaukee Bucks,0022000137,2021-01-09T00:00:00Z,MIL vs. CLE,100,10,1610612739,CLE,Cleveland Cavaliers,CLE @ MIL,90,-10,Regular Season
22020,1610612750,MIN,Minnesota Timberwolves,0022000138,2021-01-09T00:00:00Z,MIN vs. SAS,122,-3,1610612759,SAS,San Antonio Spurs,SAS @ MIN,125,3,Regular Season
22020,1610612754,IND,Indiana Pacers,0022000135,2021-01-09T00:00:00Z,IND vs. PHX,117,-8,1610612756,PHX,Phoenix Suns,PHX @ IND,125,8,Regular Season
22020,1610612764,WAS,Washington Wizards,0022000136,2021-01-09T00:00:00Z,WAS vs. MIA,124,-4,1610612748,MIA,Miami Heat,MIA @ WAS,128,4,Regular Season
22020,1610612766,CHA,Charlotte Hornets,0022000134,2021-01-09T00:00:00Z,CHA vs. ATL,113,8,1610612737,ATL,Atlanta Hawks,ATL @ CHA,105,-8,Regular Season
22020,1610612742,DAL,Dallas Mavericks,0022000139,2021-01-09T00:00:00Z,DAL vs. ORL,112,14,1610612753,ORL,Orlando Magic,ORL @ DAL,98,-14,Regular Season
22020,1610612758,SAC,Sacramento Kings,0022000140,2021-01-09T00:00:00Z,SAC vs. POR,99,-26,1610612757,POR,Portland Trail Blazers,POR @ SAC,125,26,Regular Season
22020,1610612755,PHI,Philadelphia 76ers,0022000133,2021-01-09T00:00:00Z,PHI vs. DEN,103,-12,1610612743,DEN,Denver Nuggets,DEN @ PHI,115,12,Regular Season
22020,1610612750,MIN,Minnesota Timberwolves,0022000147,2021-01-10T00:00:00Z,MIN vs. SAS,96,8,1610612759,SAS,San Antonio Spurs,SAS @ MIN,88,-8,Regular Season
22020,1610612746,LAC,LA Clippers,0022000142,2021-01-10T00:00:00Z,LAC vs. CHI,130,3,1610612741,CHI,Chicago Bulls,CHI @ LAC,127,-3,Regular Season
22020,1610612765,DET,Detroit Pistons,0022000141,2021-01-10T00:00:00Z,DET vs. UTA,86,-10,1610612762,UTA,Utah Jazz,UTA @ DET,96,10,Regular Season
22020,1610612745,HOU,Houston Rockets,0022000146,2021-01-10T00:00:00Z,HOU vs. LAL,102,-18,1610612747,LAL,Los Angeles Lakers,LAL @ HOU,120,18,Regular Season
22020,1610612744,GSW,Golden State Warriors,0022000148,2021-01-10T00:00:00Z,GSW vs. TOR,106,1,1610612761,TOR,Toronto Raptors,TOR @ GSW,105,-1,Regular Season
22020,1610612752,NYK,New York Knicks,0022000144,2021-01-10T00:00:00Z,NYK vs. DEN,89,-25,1610612743,DEN,Denver Nuggets,DEN @ NYK,114,25,Regular Season
22020,1610612751,BKN,Brooklyn Nets,0022000143,2021-01-10T00:00:00Z,BKN vs. OKC,116,-13,1610612760,OKC,Oklahoma City Thunder,OKC @ BKN,129,13,Regular Season
22020,1610612737,ATL,Atlanta Hawks,0022000153,2021-01-11T00:00:00Z,ATL vs. PHI,112,18,1610612755,PHI,Philadelphia 76ers,PHI @ ATL,94,-18,Regular Season
22020,1610612739,CLE,Cleveland Cavaliers,0022000150,2021-01-11T00:00:00Z,CLE vs. MEM,91,-10,1610612763,MEM,Memphis Grizzlies,MEM @ CLE,101,10,Regular Season
22020,1610612758,SAC,Sacramento Kings,0022000156,2021-01-11T00:00:00Z,SAC vs. IND,127,5,1610612754,IND,Indiana Pacers,IND @ SAC,122,-5,Regular Season
22020,1610612753,ORL,Orlando Magic,0022000151,2021-01-11T00:00:00Z,ORL vs. MIL,99,-22,1610612749,MIL,Milwaukee Bucks,MIL @ ORL,121,22,Regular Season
22020,1610612764,WAS,Washington Wizards,0022000152,2021-01-11T00:00:00Z,WAS vs. PHX,128,21,1610612756,PHX,Phoenix Suns,PHX @ WAS,107,-21,Regular Season
22020,1610612757,POR,Portland Trail Blazers,0022000155,2021-01-11T00:00:00Z,POR vs. TOR,112,1,1610612761,TOR,Toronto Raptors,TOR @ POR,111,-1,Regular Season
22020,1610612766,CHA,Charlotte Hornets,0022000149,2021-01-11T00:00:00Z,CHA vs. NYK,109,21,1610612752,NYK,New York Knicks,NYK @ CHA,88,-21,Regular Season
22020,1610612745,HOU,Houston Rockets,0022000161,2021-01-12T00:00:00Z,HOU vs. LAL,100,-17,1610612747,LAL,Los Angeles Lakers,LAL @ HOU,117,17,Regular Season
22020,1610612739,CLE,Cleveland Cavaliers,0022000159,2021-01-12T00:00:00Z,CLE vs. UTA,87,-30,1610612762,UTA,Utah Jazz,UTA @ CLE,117,30,Regular Season
22020,1610612760,OKC,Oklahoma City Thunder,0022000162,2021-01-12T00:00:00Z,OKC vs. SAS,102,-10,1610612759,SAS,San Antonio Spurs,SAS @ OKC,112,10,Regular Season
22020,1610612744,GSW,Golden State Warriors,0022000163,2021-01-12T00:00:00Z,GSW vs. IND,95,-9,1610612754,IND,Indiana Pacers,IND @ GSW,104,9,Regular Season
22020,1610612755,PHI,Philadelphia 76ers,0022000157,2021-01-12T00:00:00Z,PHI vs. MIA,137,3,1610612748,MIA,Miami Heat,MIA @ PHI,134,-3,Regular Season
22020,1610612751,BKN,Brooklyn Nets,0022000158,2021-01-12T00:00:00Z,BKN vs. DEN,122,6,1610612743,DEN,Denver Nuggets,DEN @ BKN,116,-6,Regular Season
22020,1610612765,DET,Detroit Pistons,0022000165,2021-01-13T00:00:00Z,DET vs. MIL,101,-9,1610612749,MIL,Milwaukee Bucks,MIL @ DET,110,9,Regular Season
22020,1610612750,MIN,Minnesota Timberwolves,0022000169,2021-01-13T00:00:00Z,MIN vs. MEM,107,-11,1610612763,MEM,Memphis Grizzlies,MEM @ MIN,118,11,Regular Season
22020,1610612746,LAC,LA Clippers,0022000172,2021-01-13T00:00:00Z,LAC vs. NOP,111,5,1610612740,NOP,New Orleans Pelicans,NOP @ LAC,106,-5,Regular Season
22020,1610612752,NYK,New York Knicks,0022000168,2021-01-13T00:00:00Z,NYK vs. BKN,109,-7,1610612751,BKN,Brooklyn Nets,BKN @ NYK,116,7,Regular Season
22020,1610612766,CHA,Charlotte Hornets,0022000164,2021-01-13T00:00:00Z,CHA vs. DAL,93,-11,1610612742,DAL,Dallas Mavericks,DAL @ CHA,104,11,Regular Season
22020,1610612760,OKC,Oklahoma City Thunder,0022000170,2021-01-13T00:00:00Z,OKC vs. LAL,99,-29,1610612747,LAL,Los Angeles Lakers,LAL @ OKC,128,29,Regular Season
22020,1610612758,SAC,Sacramento Kings,0022000173,2021-01-13T00:00:00Z,SAC vs. POR,126,-6,1610612757,POR,Portland Trail Blazers,POR @ SAC,132,6,Regular Season
22020,1610612761,TOR,Toronto Raptors,0022000175,2021-01-14T00:00:00Z,TOR vs. CHA,111,3,1610612766,CHA,Charlotte Hornets,CHA @ TOR,108,-3,Regular Season
22020,1610612743,DEN,Denver Nuggets,0022000177,2021-01-14T00:00:00Z,DEN vs. GSW,114,10,1610612744,GSW,Golden State Warriors,GSW @ DEN,104,-10,Regular Season
22020,1610612755,PHI,Philadelphia 76ers,0022000174,2021-01-14T00:00:00Z,PHI vs. MIA,125,17,1610612748,MIA,Miami Heat,MIA @ PHI,108,-17,Regular Season
22020,1610612759,SAS,San Antonio Spurs,0022000176,2021-01-14T00:00:00Z,SAS vs. HOU,105,-4,1610612745,HOU,Houston Rockets,HOU @ SAS,109,4,Regular Season
22020,1610612757,POR,Portland Trail Blazers,0022000178,2021-01-14T00:00:00Z,POR vs. IND,87,-24,1610612754,IND,Indiana Pacers,IND @ POR,111,24,Regular Season
22020,1610612749,MIL,Milwaukee Bucks,0022000182,2021-01-15T00:00:00Z,MIL vs. DAL,112,3,1610612742,DAL,Dallas Mavericks,DAL @ MIL,109,-3,Regular Season
22020,1610612758,SAC,Sacramento Kings,0022000188,2021-01-15T00:00:00Z,SAC vs. LAC,100,-38,1610612746,LAC,LA Clippers,LAC @ SAC,138,38,Regular Season
22020,1610612762,UTA,Utah Jazz,0022000186,2021-01-15T00:00:00Z,UTA vs. ATL,116,24,1610612737,ATL,Atlanta Hawks,ATL @ UTA,92,-24,Regular Season
22020,1610612739,CLE,Cleveland Cavaliers,0022000181,2021-01-15T00:00:00Z,CLE vs. NYK,106,3,1610612752,NYK,New York Knicks,NYK @ CLE,103,-3,Regular Season
22020,1610612760,OKC,Oklahoma City Thunder,0022000184,2021-01-15T00:00:00Z,OKC vs. CHI,127,2,1610612741,CHI,Chicago Bulls,CHI @ OKC,125,-2,Regular Season
22020,1610612747,LAL,Los Angeles Lakers,0022000187,2021-01-15T00:00:00Z,LAL vs. NOP,112,17,1610612740,NOP,New Orleans Pelicans,NOP @ LAL,95,-17,Regular Season
22020,1610612738,BOS,Boston Celtics,0022000180,2021-01-15T00:00:00Z,BOS vs. ORL,124,27,1610612753,ORL,Orlando Magic,ORL @ BOS,97,-27,Regular Season
22020,1610612761,TOR,Toronto Raptors,0022000191,2021-01-16T00:00:00Z,TOR vs. CHA,116,3,1610612766,CHA,Charlotte Hornets,CHA @ TOR,113,-3,Regular Season
22020,1610612757,POR,Portland Trail Blazers,0022000195,2021-01-16T00:00:00Z,POR vs. ATL,112,6,1610612737,ATL,Atlanta Hawks,ATL @ POR,106,-6,Regular Season
22020,1610612751,BKN,Brooklyn Nets,0022000190,2021-01-16T00:00:00Z,BKN vs. ORL,122,7,1610612753,ORL,Orlando Magic,ORL @ BKN,115,-7,Regular Season
22020,1610612763,MEM,Memphis Grizzlies,0022000193,2021-01-16T00:00:00Z,MEM vs. PHI,106,2,1610612755,PHI,Philadelphia 76ers,PHI @ MEM,104,-2,Regular Season
22020,1610612748,MIA,Miami Heat,0022000192,2021-01-16T00:00:00Z,MIA vs. DET,100,-20,1610612765,DET,Detroit Pistons,DET @ MIA,120,20,Regular Season
22020,1610612759,SAS,San Antonio Spurs,0022000189,2021-01-16T00:00:00Z,SAS vs. HOU,103,12,1610612745,HOU,Houston Rockets,HOU @ SAS,91,-12,Regular Season
22020,1610612738,BOS,Boston Celtics,0022000196,2021-01-17T00:00:00Z,BOS vs. NYK,75,-30,1610612752,NYK,New York Knicks,NYK @ BOS,105,30,Regular Season
22020,1610612743,DEN,Denver Nuggets,0022000200,2021-01-17T00:00:00Z,DEN vs. UTA,105,-4,1610612762,UTA,Utah Jazz,UTA @ DEN,109,4,Regular Season
22020,1610612742,DAL,Dallas Mavericks,0022000198,2021-01-17T00:00:00Z,DAL vs. CHI,101,-16,1610612741,CHI,Chicago Bulls,CHI @ DAL,117,16,Regular Season
22020,1610612746,LAC,LA Clippers,0022000202,2021-01-17T00:00:00Z,LAC vs. IND,129,33,1610612754,IND,Indiana Pacers,IND @ LAC,96,-33,Regular Season
22020,1610612758,SAC,Sacramento Kings,0022000201,2021-01-17T00:00:00Z,SAC vs. NOP,123,-5,1610612740,NOP,New Orleans Pelicans,NOP @ SAC,128,5,Regular Season
22020,1610612757,POR,Portland Trail Blazers,0022000207,2021-01-18T00:00:00Z,POR vs. SAS,104,-21,1610612759,SAS,San Antonio Spurs,SAS @ POR,125,21,Regular Season
22020,1610612763,MEM,Memphis Grizzlies,0022000208,2021-01-18T00:00:00Z,MEM vs. PHX,108,4,1610612756,PHX,Phoenix Suns,PHX @ MEM,104,-4,Regular Season
22020,1610612751,BKN,Brooklyn Nets,0022000209,2021-01-18T00:00:00Z,BKN vs. MIL,125,2,1610612749,MIL,Milwaukee Bucks,MIL @ BKN,123,-2,Regular Season
22020,1610612737,ATL,Atlanta Hawks,0022000205,2021-01-18T00:00:00Z,ATL vs. MIN,108,11,1610612750,MIN,Minnesota Timberwolves,MIN @ ATL,97,-11,Regular Season
22020,1610612748,MIA,Miami Heat,0022000206,2021-01-18T00:00:00Z,MIA vs. DET,113,6,1610612765,DET,Detroit Pistons,DET @ MIA,107,-6,Regular Season
22020,1610612761,TOR,Toronto Raptors,0022000210,2021-01-18T00:00:00Z,TOR vs. DAL,116,23,1610612742,DAL,Dallas Mavericks,DAL @ TOR,93,-23,Regular Season
22020,1610612741,CHI,Chicago Bulls,0022000211,2021-01-18T00:00:00Z,CHI vs. HOU,125,5,1610612745,HOU,Houston Rockets,HOU @ CHI,120,-5,Regular Season
22020,1610612747,LAL,Los Angeles Lakers,0022000212,2021-01-18T00:00:00Z,LAL vs. GSW,113,-2,1610612744,GSW,Golden State Warriors,GSW @ LAL,115,2,Regular Season
22020,1610612752,NYK,New York Knicks,0022000203,2021-01-18T00:00:00Z,NYK vs. ORL,91,7,1610612753,ORL,Orlando Magic,ORL @ NYK,84,-7,Regular Season
22020,1610612762,UTA,Utah Jazz,0022000214,2021-01-19T00:00:00Z,UTA vs. NOP,118,16,1610612740,NOP,New Orleans Pelicans,NOP @ UTA,102,-16,Regular Season
22020,1610612743,DEN,Denver Nuggets,0022000213,2021-01-19T00:00:00Z,DEN vs. OKC,119,18,1610612760,OKC,Oklahoma City Thunder,OKC @ DEN,101,-18,Regular Season
22020,1610612754,IND,Indiana Pacers,0022000217,2021-01-20T00:00:00Z,IND vs. DAL,112,-12,1610612742,DAL,Dallas Mavericks,DAL @ IND,124,12,Regular Season
22020,1610612737,ATL,Atlanta Hawks,0022000219,2021-01-20T00:00:00Z,ATL vs. DET,123,8,1610612765,DET,Detroit Pistons,DET @ ATL,115,-8,Regular Season
22020,1610612746,LAC,LA Clippers,0022000224,2021-01-20T00:00:00Z,LAC vs. SAC,115,19,1610612758,SAC,Sacramento Kings,SAC @ LAC,96,-19,Regular Season
22020,1610612744,GSW,Golden State Warriors,0022000223,2021-01-20T00:00:00Z,GSW vs. SAS,121,22,1610612759,SAS,San Antonio Spurs,SAS @ GSW,99,-22,Regular Season
22020,1610612761,TOR,Toronto Raptors,0022000220,2021-01-20T00:00:00Z,TOR vs. MIA,102,-9,1610612748,MIA,Miami Heat,MIA @ TOR,111,9,Regular Season
22020,1610612750,MIN,Minnesota Timberwolves,0022000221,2021-01-20T00:00:00Z,MIN vs. ORL,96,-1,1610612753,ORL,Orlando Magic,ORL @ MIN,97,1,Regular Season
22020,1610612745,HOU,Houston Rockets,0022000222,2021-01-20T00:00:00Z,HOU vs. PHX,103,-6,1610612756,PHX,Phoenix Suns,PHX @ HOU,109,6,Regular Season
22020,1610612739,CLE,Cleveland Cavaliers,0022000216,2021-01-20T00:00:00Z,CLE vs. BKN,147,12,1610612751,BKN,Brooklyn Nets,BKN @ CLE,135,-12,Regular Season
22020,1610612755,PHI,Philadelphia 76ers,0022000218,2021-01-20T00:00:00Z,PHI vs. BOS,117,8,1610612738,BOS,Boston Celtics,BOS @ PHI,109,-8,Regular Season
22020,1610612749,MIL,Milwaukee Bucks,0022000226,2021-01-21T00:00:00Z,MIL vs. LAL,106,-7,1610612747,LAL,Los Angeles Lakers,LAL @ MIL,113,7,Regular Season
22020,1610612762,UTA,Utah Jazz,0022000227,2021-01-21T00:00:00Z,UTA vs. NOP,129,11,1610612740,NOP,New Orleans Pelicans,NOP @ UTA,118,-11,Regular Season
22020,1610612744,GSW,Golden State Warriors,0022000228,2021-01-21T00:00:00Z,GSW vs. NYK,104,-15,1610612752,NYK,New York Knicks,NYK @ GSW,119,15,Regular Season
22020,1610612755,PHI,Philadelphia 76ers,0022000233,2021-01-22T00:00:00Z,PHI vs. BOS,122,12,1610612738,BOS,Boston Celtics,BOS @ PHI,110,-12,Regular Season
22020,1610612759,SAS,San Antonio Spurs,0022000237,2021-01-22T00:00:00Z,SAS vs. DAL,117,-5,1610612742,DAL,Dallas Mavericks,DAL @ SAS,122,5,Regular Season
22020,1610612739,CLE,Cleveland Cavaliers,0022000232,2021-01-22T00:00:00Z,CLE vs. BKN,125,12,1610612751,BKN,Brooklyn Nets,BKN @ CLE,113,-12,Regular Season
22020,1610612761,TOR,Toronto Raptors,0022000234,2021-01-22T00:00:00Z,TOR vs. MIA,101,20,1610612748,MIA,Miami Heat,MIA @ TOR,81,-20,Regular Season
22020,1610612756,PHX,Phoenix Suns,0022000238,2021-01-22T00:00:00Z,PHX vs. DEN,126,-4,1610612743,DEN,Denver Nuggets,DEN @ PHX,130,4,Regular Season
22020,1610612758,SAC,Sacramento Kings,0022000241,2021-01-22T00:00:00Z,SAC vs. NYK,103,9,1610612752,NYK,New York Knicks,NYK @ SAC,94,-9,Regular Season
22020,1610612765,DET,Detroit Pistons,0022000230,2021-01-22T00:00:00Z,DET vs. HOU,102,-1,1610612745,HOU,Houston Rockets,HOU @ DET,103,1,Regular Season
22020,1610612766,CHA,Charlotte Hornets,0022000229,2021-01-22T00:00:00Z,CHA vs. CHI,110,-13,1610612741,CHI,Chicago Bulls,CHI @ CHA,123,13,Regular Season
22020,1610612746,LAC,LA Clippers,0022000239,2021-01-22T00:00:00Z,LAC vs. OKC,120,14,1610612760,OKC,Oklahoma City Thunder,OKC @ LAC,106,-14,Regular Season
22020,1610612754,IND,Indiana Pacers,0022000231,2021-01-22T00:00:00Z,IND vs. ORL,120,2,1610612753,ORL,Orlando Magic,ORL @ IND,118,-2,Regular Season
22020,1610612750,MIN,Minnesota Timberwolves,0022000236,2021-01-22T00:00:00Z,MIN vs. ATL,98,-18,1610612737,ATL,Atlanta Hawks,ATL @ MIN,116,18,Regular Season
22020,1610612751,BKN,Brooklyn Nets,0022000244,2021-01-23T00:00:00Z,BKN vs. MIA,128,4,1610612748,MIA,Miami Heat,MIA @ BKN,124,-4,Regular Season
22020,1610612762,UTA,Utah Jazz,0022000242,2021-01-23T00:00:00Z,UTA vs. GSW,127,19,1610612744,GSW,Golden State Warriors,GSW @ UTA,108,-19,Regular Season
22020,1610612750,MIN,Minnesota Timberwolves,0022000246,2021-01-23T00:00:00Z,MIN vs. NOP,120,10,1610612740,NOP,New Orleans Pelicans,NOP @ MIN,110,-10,Regular Season
22020,1610612741,CHI,Chicago Bulls,0022000245,2021-01-23T00:00:00Z,CHI vs. LAL,90,-11,1610612747,LAL,Los Angeles Lakers,LAL @ CHI,101,11,Regular Season
22020,1610612765,DET,Detroit Pistons,0022000243,2021-01-23T00:00:00Z,DET vs. PHI,110,-4,1610612755,PHI,Philadelphia 76ers,PHI @ DET,114,4,Regular Season
22020,1610612756,PHX,Phoenix Suns,0022000248,2021-01-23T00:00:00Z,PHX vs. DEN,112,-8,1610612743,DEN,Denver Nuggets,DEN @ PHX,120,8,Regular Season
22020,1610612742,DAL,Dallas Mavericks,0022000247,2021-01-23T00:00:00Z,DAL vs. HOU,108,-25,1610612745,HOU,Houston Rockets,HOU @ DAL,133,25,Regular Season
22020,1610612749,MIL,Milwaukee Bucks,0022000254,2021-01-24T00:00:00Z,MIL vs. ATL,129,14,1610612737,ATL,Atlanta Hawks,ATL @ MIL,115,-14,Regular Season
22020,1610612757,POR,Portland Trail Blazers,0022000256,2021-01-24T00:00:00Z,POR vs. NYK,116,3,1610612752,NYK,New York Knicks,NYK @ POR,113,-3,Regular Season
22020,1610612738,BOS,Boston Celtics,0022000250,2021-01-24T00:00:00Z,BOS vs. CLE,141,38,1610612739,CLE,Cleveland Cavaliers,CLE @ BOS,103,-38,Regular Season
22020,1610612754,IND,Indiana Pacers,0022000249,2021-01-24T00:00:00Z,IND vs. TOR,102,-5,1610612761,TOR,Toronto Raptors,TOR @ IND,107,5,Regular Season
22020,1610612753,ORL,Orlando Magic,0022000252,2021-01-24T00:00:00Z,ORL vs. CHA,104,-3,1610612766,CHA,Charlotte Hornets,CHA @ ORL,107,3,Regular Season
22020,1610612759,SAS,San Antonio Spurs,0022000253,2021-01-24T00:00:00Z,SAS vs. WAS,121,20,1610612764,WAS,Washington Wizards,WAS @ SAS,101,-20,Regular Season
22020,1610612746,LAC,LA Clippers,0022000251,2021-01-24T00:00:00Z,LAC vs. OKC,108,8,1610612760,OKC,Oklahoma City Thunder,OKC @ LAC,100,-8,Regular Season
22020,1610612757,POR,Portland Trail Blazers,0022000267,2021-01-25T00:00:00Z,POR vs. OKC,122,-3,1610612760,OKC,Oklahoma City Thunder,OKC @ POR,125,3,Regular Season
22020,1610612742,DAL,Dallas Mavericks,0022000265,2021-01-25T00:00:00Z,DAL vs. DEN,113,-4,1610612743,DEN,Denver Nuggets,DEN @ DAL,117,4,Regular Season
22020,1610612754,IND,Indiana Pacers,0022000258,2021-01-25T00:00:00Z,IND vs. TOR,129,15,1610612761,TOR,Toronto Raptors,TOR @ IND,114,-15,Regular Season
22020,1610612751,BKN,Brooklyn Nets,0022000260,2021-01-25T00:00:00Z,BKN vs. MIA,98,13,1610612748,MIA,Miami Heat,MIA @ BKN,85,-13,Regular Season
22020,1610612765,DET,Detroit Pistons,0022000257,2021-01-25T00:00:00Z,DET vs. PHI,119,15,1610612755,PHI,Philadelphia 76ers,PHI @ DET,104,-15,Regular Season
22020,1610612741,CHI,Chicago Bulls,0022000262,2021-01-25T00:00:00Z,CHI vs. BOS,103,-16,1610612738,BOS,Boston Celtics,BOS @ CHI,119,16,Regular Season
22020,1610612739,CLE,Cleveland Cavaliers,0022000261,2021-01-25T00:00:00Z,CLE vs. LAL,108,-7,1610612747,LAL,Los Angeles Lakers,LAL @ CLE,115,7,Regular Season
22020,1610612744,GSW,Golden State Warriors,0022000266,2021-01-25T00:00:00Z,GSW vs. MIN,130,22,1610612750,MIN,Minnesota Timberwolves,MIN @ GSW,108,-22,Regular Season
22020,1610612753,ORL,Orlando Magic,0022000259,2021-01-25T00:00:00Z,ORL vs. CHA,117,9,1610612766,CHA,Charlotte Hornets,CHA @ ORL,108,-9,Regular Season
22020,1610612737,ATL,Atlanta Hawks,0022000268,2021-01-26T00:00:00Z,ATL vs. LAC,108,9,1610612746,LAC,LA Clippers,LAC @ ATL,99,-9,Regular Season
22020,1610612762,UTA,Utah Jazz,0022000270,2021-01-26T00:00:00Z,UTA vs. NYK,108,14,1610612752,NYK,New York Knicks,NYK @ UTA,94,-14,Regular Season
22020,1610612745,HOU,Houston Rockets,0022000269,2021-01-26T00:00:00Z,HOU vs. WAS,107,19,1610612764,WAS,Washington Wizards,WAS @ HOU,88,-19,Regular Season
22020,1610612755,PHI,Philadelphia 76ers,0022000276,2021-01-27T00:00:00Z,PHI vs. LAL,107,1,1610612747,LAL,Los Angeles Lakers,LAL @ PHI,106,-1,Regular Season
22020,1610612753,ORL,Orlando Magic,0022000273,2021-01-27T00:00:00Z,ORL vs. SAC,107,-14,1610612758,SAC,Sacramento Kings,SAC @ ORL,121,14,Regular Season
22020,1610612748,MIA,Miami Heat,0022000275,2021-01-27T00:00:00Z,MIA vs. DEN,82,-27,1610612743,DEN,Denver Nuggets,DEN @ MIA,109,27,Regular Season
22020,1610612756,PHX,Phoenix Suns,0022000281,2021-01-27T00:00:00Z,PHX vs. OKC,97,-5,1610612760,OKC,Oklahoma City Thunder,OKC @ PHX,102,5,Regular Season
22020,1610612766,CHA,Charlotte Hornets,0022000271,2021-01-27T00:00:00Z,CHA vs. IND,106,-10,1610612754,IND,Indiana Pacers,IND @ CHA,116,10,Regular Season
22020,1610612762,UTA,Utah Jazz,0022000282,2021-01-27T00:00:00Z,UTA vs. DAL,116,12,1610612742,DAL,Dallas Mavericks,DAL @ UTA,104,-12,Regular Season
22020,1610612739,CLE,Cleveland Cavaliers,0022000272,2021-01-27T00:00:00Z,CLE vs. DET,122,15,1610612765,DET,Detroit Pistons,DET @ CLE,107,-15,Regular Season
22020,1610612740,NOP,New Orleans Pelicans,0022000279,2021-01-27T00:00:00Z,NOP vs. WAS,124,18,1610612764,WAS,Washington Wizards,WAS @ NOP,106,-18,Regular Season
22020,1610612761,TOR,Toronto Raptors,0022000277,2021-01-27T00:00:00Z,TOR vs. MIL,108,-7,1610612749,MIL,Milwaukee Bucks,MIL @ TOR,115,7,Regular Season
22020,1610612759,SAS,San Antonio Spurs,0022000280,2021-01-27T00:00:00Z,SAS vs. BOS,110,4,1610612738,BOS,Boston Celtics,BOS @ SAS,106,-4,Regular Season
22020,1610612744,GSW,Golden State Warriors,0022000283,2021-01-27T00:00:00Z,GSW vs. MIN,123,12,1610612750,MIN,Minnesota Timberwolves,MIN @ GSW,111,-12,Regular Season
22020,1610612737,ATL,Atlanta Hawks,0022000274,2021-01-27T00:00:00Z,ATL vs. BKN,128,-4,1610612751,BKN,Brooklyn Nets,BKN @ ATL,132,4,Regular Season
22020,1610612765,DET,Detroit Pistons,0022000284,2021-01-28T00:00:00Z,DET vs. LAL,107,15,1610612747,LAL,Los Angeles Lakers,LAL @ DET,92,-15,Regular Season
22020,1610612756,PHX,Phoenix Suns,0022000286,2021-01-28T00:00:00Z,PHX vs. GSW,114,21,1610612744,GSW,Golden State Warriors,GSW @ PHX,93,-21,Regular Season
22020,1610612748,MIA,Miami Heat,0022000285,2021-01-28T00:00:00Z,MIA vs. LAC,105,-4,1610612746,LAC,LA Clippers,LAC @ MIA,109,4,Regular Season
22020,1610612745,HOU,Houston Rockets,0022000287,2021-01-28T00:00:00Z,HOU vs. POR,104,3,1610612757,POR,Portland Trail Blazers,POR @ HOU,101,-3,Regular Season
22020,1610612764,WAS,Washington Wizards,0022000290,2021-01-29T00:00:00Z,WAS vs. ATL,100,-16,1610612737,ATL,Atlanta Hawks,ATL @ WAS,116,16,Regular Season
22020,1610612766,CHA,Charlotte Hornets,0022000288,2021-01-29T00:00:00Z,CHA vs. IND,108,3,1610612754,IND,Indiana Pacers,IND @ CHA,105,-3,Regular Season
22020,1610612762,UTA,Utah Jazz,0022000297,2021-01-29T00:00:00Z,UTA vs. DAL,120,19,1610612742,DAL,Dallas Mavericks,DAL @ UTA,101,-19,Regular Season
22020,1610612752,NYK,New York Knicks,0022000291,2021-01-29T00:00:00Z,NYK vs. CLE,102,21,1610612739,CLE,Cleveland Cavaliers,CLE @ NYK,81,-21,Regular Season
22020,1610612760,OKC,Oklahoma City Thunder,0022000295,2021-01-29T00:00:00Z,OKC vs. BKN,125,-22,1610612751,BKN,Brooklyn Nets,BKN @ OKC,147,22,Regular Season
22020,1610612753,ORL,Orlando Magic,0022000289,2021-01-29T00:00:00Z,ORL vs. LAC,90,-26,1610612746,LAC,LA Clippers,LAC @ ORL,116,26,Regular Season
22020,1610612761,TOR,Toronto Raptors,0022000292,2021-01-29T00:00:00Z,TOR vs. SAC,124,-2,1610612758,SAC,Sacramento Kings,SAC @ TOR,126,2,Regular Season
22020,1610612750,MIN,Minnesota Timberwolves,0022000294,2021-01-29T00:00:00Z,MIN vs. PHI,94,-24,1610612755,PHI,Philadelphia 76ers,PHI @ MIN,118,24,Regular Season
22020,1610612759,SAS,San Antonio Spurs,0022000296,2021-01-29T00:00:00Z,SAS vs. DEN,119,10,1610612743,DEN,Denver Nuggets,DEN @ SAS,109,-10,Regular Season
22020,1610612740,NOP,New Orleans Pelicans,0022000293,2021-01-29T00:00:00Z,NOP vs. MIL,131,5,1610612749,MIL,Milwaukee Bucks,MIL @ NOP,126,-5,Regular Season
22020,1610612740,NOP,New Orleans Pelicans,0022000300,2021-01-30T00:00:00Z,NOP vs. HOU,112,-14,1610612745,HOU,Houston Rockets,HOU @ NOP,126,14,Regular Season
22020,1610612744,GSW,Golden State Warriors,0022000305,2021-01-30T00:00:00Z,GSW vs. DET,118,27,1610612765,DET,Detroit Pistons,DET @ GSW,91,-27,Regular Season
22020,1610612738,BOS,Boston Celtics,0022000302,2021-01-30T00:00:00Z,BOS vs. LAL,95,-1,1610612747,LAL,Los Angeles Lakers,LAL @ BOS,96,1,Regular Season
22020,1610612766,CHA,Charlotte Hornets,0022000299,2021-01-30T00:00:00Z,CHA vs. MIL,126,12,1610612749,MIL,Milwaukee Bucks,MIL @ CHA,114,-12,Regular Season
22020,1610612748,MIA,Miami Heat,0022000301,2021-01-30T00:00:00Z,MIA vs. SAC,105,1,1610612758,SAC,Sacramento Kings,SAC @ MIA,104,-1,Regular Season
22020,1610612741,CHI,Chicago Bulls,0022000298,2021-01-30T00:00:00Z,CHI vs. POR,122,-1,1610612757,POR,Portland Trail Blazers,POR @ CHI,123,1,Regular Season
22020,1610612759,SAS,San Antonio Spurs,0022000304,2021-01-30T00:00:00Z,SAS vs. MEM,112,-17,1610612763,MEM,Memphis Grizzlies,MEM @ SAS,129,17,Regular Season
22020,1610612742,DAL,Dallas Mavericks,0022000303,2021-01-30T00:00:00Z,DAL vs. PHX,105,-6,1610612756,PHX,Phoenix Suns,PHX @ DAL,111,6,Regular Season
22020,1610612750,MIN,Minnesota Timberwolves,0022000311,2021-01-31T00:00:00Z,MIN vs. CLE,109,5,1610612739,CLE,Cleveland Cavaliers,CLE @ MIN,104,-5,Regular Season
22020,1610612761,TOR,Toronto Raptors,0022000309,2021-01-31T00:00:00Z,TOR vs. ORL,115,13,1610612753,ORL,Orlando Magic,ORL @ TOR,102,-13,Regular Season
22020,1610612743,DEN,Denver Nuggets,0022000306,2021-01-31T00:00:00Z,DEN vs. UTA,128,11,1610612762,UTA,Utah Jazz,UTA @ DEN,117,-11,Regular Season
22020,1610612764,WAS,Washington Wizards,0022000310,2021-01-31T00:00:00Z,WAS vs. BKN,149,3,1610612751,BKN,Brooklyn Nets,BKN @ WAS,146,-3,Regular Season
22020,1610612752,NYK,New York Knicks,0022000308,2021-01-31T00:00:00Z,NYK vs. LAC,115,-14,1610612746,LAC,LA Clippers,LAC @ NYK,129,14,Regular Season
22020,1610612754,IND,Indiana Pacers,0022000307,2021-01-31T00:00:00Z,IND vs. PHI,110,-9,1610612755,PHI,Philadelphia 76ers,PHI @ IND,119,9,Regular Season
22020,1610612741,CHI,Chicago Bulls,0022000315,2021-02-01T00:00:00Z,CHI vs. NYK,110,8,1610612752,NYK,New York Knicks,NYK @ CHI,102,-8,Regular Season
22020,1610612748,MIA,Miami Heat,0022000314,2021-02-01T00:00:00Z,MIA vs. CHA,121,-8,1610612766,CHA,Charlotte Hornets,CHA @ MIA,129,8,Regular Season
22020,1610612742,DAL,Dallas Mavericks,0022000319,2021-02-01T00:00:00Z,DAL vs. PHX,108,-1,1610612756,PHX,Phoenix Suns,PHX @ DAL,109,1,Regular Season
22020,1610612739,CLE,Cleveland Cavaliers,0022000312,2021-02-01T00:00:00Z,CLE vs. MIN,100,2,1610612750,MIN,Minnesota Timberwolves,MIN @ CLE,98,-2,Regular Season
22020,1610612759,SAS,San Antonio Spurs,0022000320,2021-02-01T00:00:00Z,SAS vs. MEM,102,-31,1610612763,MEM,Memphis Grizzlies,MEM @ SAS,133,31,Regular Season
22020,1610612749,MIL,Milwaukee Bucks,0022000316,2021-02-01T00:00:00Z,MIL vs. POR,134,28,1610612757,POR,Portland Trail Blazers,POR @ MIL,106,-28,Regular Season
22020,1610612760,OKC,Oklahoma City Thunder,0022000318,2021-02-01T00:00:00Z,OKC vs. HOU,106,-30,1610612745,HOU,Houston Rockets,HOU @ OKC,136,30,Regular Season
22020,1610612737,ATL,Atlanta Hawks,0022000313,2021-02-01T00:00:00Z,ATL vs. LAL,99,-8,1610612747,LAL,Los Angeles Lakers,LAL @ ATL,107,8,Regular Season
22020,1610612740,NOP,New Orleans Pelicans,0022000317,2021-02-01T00:00:00Z,NOP vs. SAC,109,-9,1610612758,SAC,Sacramento Kings,SAC @ NOP,118,9,Regular Season
22020,1610612753,ORL,Orlando Magic,0022000323,2021-02-02T00:00:00Z,ORL vs. TOR,108,-15,1610612761,TOR,Toronto Raptors,TOR @ ORL,123,15,Regular Season
22020,1610612751,BKN,Brooklyn Nets,0022000324,2021-02-02T00:00:00Z,BKN vs. LAC,124,4,1610612746,LAC,LA Clippers,LAC @ BKN,120,-4,Regular Season
22020,1610612762,UTA,Utah Jazz,0022000325,2021-02-02T00:00:00Z,UTA vs. DET,117,12,1610612765,DET,Detroit Pistons,DET @ UTA,105,-12,Regular Season
22020,1610612754,IND,Indiana Pacers,0022000322,2021-02-02T00:00:00Z,IND vs. MEM,134,18,1610612763,MEM,Memphis Grizzlies,MEM @ IND,116,-18,Regular Season
22020,1610612744,GSW,Golden State Warriors,0022000326,2021-02-02T00:00:00Z,GSW vs. BOS,107,-4,1610612738,BOS,Boston Celtics,BOS @ GSW,111,4,Regular Season
22020,1610612764,WAS,Washington Wizards,0022000559,2021-02-02T00:00:00Z,WAS vs. POR,121,-11,1610612757,POR,Portland Trail Blazers,POR @ WAS,132,11,Regular Season
22020,1610612760,OKC,Oklahoma City Thunder,0022000333,2021-02-03T00:00:00Z,OKC vs. HOU,104,17,1610612745,HOU,Houston Rockets,HOU @ OKC,87,-17,Regular Season
22020,1610612741,CHI,Chicago Bulls,0022000332,2021-02-03T00:00:00Z,CHI vs. NYK,103,-4,1610612752,NYK,New York Knicks,NYK @ CHI,107,4,Regular Season
22020,1610612759,SAS,San Antonio Spurs,0022000334,2021-02-03T00:00:00Z,SAS vs. MIN,111,3,1610612750,MIN,Minnesota Timberwolves,MIN @ SAS,108,-3,Regular Season
22020,1610612748,MIA,Miami Heat,0022000331,2021-02-03T00:00:00Z,MIA vs. WAS,100,-3,1610612764,WAS,Washington Wizards,WAS @ MIA,103,3,Regular Season
22020,1610612740,NOP,New Orleans Pelicans,0022000335,2021-02-03T00:00:00Z,NOP vs. PHX,123,22,1610612756,PHX,Phoenix Suns,PHX @ NOP,101,-22,Regular Season
22020,1610612766,CHA,Charlotte Hornets,0022000327,2021-02-03T00:00:00Z,CHA vs. PHI,111,-7,1610612755,PHI,Philadelphia 76ers,PHI @ CHA,118,7,Regular Season
22020,1610612758,SAC,Sacramento Kings,0022000336,2021-02-03T00:00:00Z,SAC vs. BOS,116,5,1610612738,BOS,Boston Celtics,BOS @ SAC,111,-5,Regular Season
22020,1610612739,CLE,Cleveland Cavaliers,0022000328,2021-02-03T00:00:00Z,CLE vs. LAC,99,-22,1610612746,LAC,LA Clippers,LAC @ CLE,121,22,Regular Season
22020,1610612737,ATL,Atlanta Hawks,0022000330,2021-02-03T00:00:00Z,ATL vs. DAL,116,-6,1610612742,DAL,Dallas Mavericks,DAL @ ATL,122,6,Regular Season
22020,1610612749,MIL,Milwaukee Bucks,0022000329,2021-02-03T00:00:00Z,MIL vs. IND,130,20,1610612754,IND,Indiana Pacers,IND @ MIL,110,-20,Regular Season
22020,1610612763,MEM,Memphis Grizzlies,0022000340,2021-02-04T00:00:00Z,MEM vs. HOU,103,-12,1610612745,HOU,Houston Rockets,HOU @ MEM,115,12,Regular Season
22020,1610612737,ATL,Atlanta Hawks,0022000338,2021-02-04T00:00:00Z,ATL vs. UTA,91,-21,1610612762,UTA,Utah Jazz,UTA @ ATL,112,21,Regular Season
22020,1610612742,DAL,Dallas Mavericks,0022000339,2021-02-04T00:00:00Z,DAL vs. GSW,116,-31,1610612744,GSW,Golden State Warriors,GSW @ DAL,147,31,Regular Season
22020,1610612755,PHI,Philadelphia 76ers,0022000337,2021-02-04T00:00:00Z,PHI vs. POR,105,-16,1610612757,POR,Portland Trail Blazers,POR @ PHI,121,16,Regular Season
22020,1610612747,LAL,Los Angeles Lakers,0022000341,2021-02-04T00:00:00Z,LAL vs. DEN,114,21,1610612743,DEN,Denver Nuggets,DEN @ LAL,93,-21,Regular Season
22020,1610612748,MIA,Miami Heat,0022000347,2021-02-05T00:00:00Z,MIA vs. WAS,122,27,1610612764,WAS,Washington Wizards,WAS @ MIA,95,-27,Regular Season
22020,1610612754,IND,Indiana Pacers,0022000343,2021-02-05T00:00:00Z,IND vs. NOP,113,-1,1610612740,NOP,New Orleans Pelicans,NOP @ IND,114,1,Regular Season
22020,1610612766,CHA,Charlotte Hornets,0022000342,2021-02-05T00:00:00Z,CHA vs. UTA,121,-17,1610612762,UTA,Utah Jazz,UTA @ CHA,138,17,Regular Season
22020,1610612756,PHX,Phoenix Suns,0022000349,2021-02-05T00:00:00Z,PHX vs. DET,109,17,1610612765,DET,Detroit Pistons,DET @ PHX,92,-17,Regular Season
22020,1610612753,ORL,Orlando Magic,0022000344,2021-02-05T00:00:00Z,ORL vs. CHI,123,4,1610612741,CHI,Chicago Bulls,CHI @ ORL,119,-4,Regular Season
22020,1610612751,BKN,Brooklyn Nets,0022000345,2021-02-05T00:00:00Z,BKN vs. TOR,117,-6,1610612761,TOR,Toronto Raptors,TOR @ BKN,123,6,Regular Season
22020,1610612746,LAC,LA Clippers,0022000350,2021-02-05T00:00:00Z,LAC vs. BOS,115,-4,1610612738,BOS,Boston Celtics,BOS @ LAC,119,4,Regular Season
22020,1610612739,CLE,Cleveland Cavaliers,0022000346,2021-02-05T00:00:00Z,CLE vs. MIL,105,-18,1610612749,MIL,Milwaukee Bucks,MIL @ CLE,123,18,Regular Season
22020,1610612760,OKC,Oklahoma City Thunder,0022000348,2021-02-05T00:00:00Z,OKC vs. MIN,103,-3,1610612750,MIN,Minnesota Timberwolves,MIN @ OKC,106,3,Regular Season
22020,1610612758,SAC,Sacramento Kings,0022000352,2021-02-06T00:00:00Z,SAC vs. DEN,119,5,1610612743,DEN,Denver Nuggets,DEN @ SAC,114,-5,Regular Season
22020,1610612755,PHI,Philadelphia 76ers,0022000354,2021-02-06T00:00:00Z,PHI vs. BKN,124,16,1610612751,BKN,Brooklyn Nets,BKN @ PHI,108,-16,Regular Season
22020,1610612760,OKC,Oklahoma City Thunder,0022000359,2021-02-06T00:00:00Z,OKC vs. MIN,120,2,1610612750,MIN,Minnesota Timberwolves,MIN @ OKC,118,-2,Regular Season
22020,1610612747,LAL,Los Angeles Lakers,0022000361,2021-02-06T00:00:00Z,LAL vs. DET,135,6,1610612765,DET,Detroit Pistons,DET @ LAL,129,-6,Regular Season
22020,1610612740,NOP,New Orleans Pelicans,0022000355,2021-02-06T00:00:00Z,NOP vs. MEM,118,9,1610612763,MEM,Memphis Grizzlies,MEM @ NOP,109,-9,Regular Season
22020,1610612739,CLE,Cleveland Cavaliers,0022000357,2021-02-06T00:00:00Z,CLE vs. MIL,99,-25,1610612749,MIL,Milwaukee Bucks,MIL @ CLE,124,25,Regular Season
22020,1610612752,NYK,New York Knicks,0022000351,2021-02-06T00:00:00Z,NYK vs. POR,110,11,1610612757,POR,Portland Trail Blazers,POR @ NYK,99,-11,Regular Season
22020,1610612745,HOU,Houston Rockets,0022000358,2021-02-06T00:00:00Z,HOU vs. SAS,106,-5,1610612759,SAS,San Antonio Spurs,SAS @ HOU,111,5,Regular Season
22020,1610612737,ATL,Atlanta Hawks,0022000356,2021-02-06T00:00:00Z,ATL vs. TOR,132,11,1610612761,TOR,Toronto Raptors,TOR @ ATL,121,-11,Regular Season
22020,1610612742,DAL,Dallas Mavericks,0022000360,2021-02-06T00:00:00Z,DAL vs. GSW,134,2,1610612744,GSW,Golden State Warriors,GSW @ DAL,132,-2,Regular Season
22020,1610612753,ORL,Orlando Magic,0022000353,2021-02-06T00:00:00Z,ORL vs. CHI,92,-26,1610612741,CHI,Chicago Bulls,CHI @ ORL,118,26,Regular Season
22020,1610612746,LAC,LA Clippers,0022000366,2021-02-07T00:00:00Z,LAC vs. SAC,110,-3,1610612758,SAC,Sacramento Kings,SAC @ LAC,113,3,Regular Season
22020,1610612766,CHA,Charlotte Hornets,0022000215,2021-02-07T00:00:00Z,CHA vs. WAS,119,22,1610612764,WAS,Washington Wizards,WAS @ CHA,97,-22,Regular Season
22020,1610612754,IND,Indiana Pacers,0022000363,2021-02-07T00:00:00Z,IND vs. UTA,95,-8,1610612762,UTA,Utah Jazz,UTA @ IND,103,8,Regular Season
22020,1610612756,PHX,Phoenix Suns,0022000365,2021-02-07T00:00:00Z,PHX vs. BOS,100,9,1610612738,BOS,Boston Celtics,BOS @ PHX,91,-9,Regular Season
22020,1610612752,NYK,New York Knicks,0022000364,2021-02-07T00:00:00Z,NYK vs. MIA,103,-6,1610612748,MIA,Miami Heat,MIA @ NYK,109,6,Regular Season
22020,1610612743,DEN,Denver Nuggets,0022000373,2021-02-08T00:00:00Z,DEN vs. MIL,112,-13,1610612749,MIL,Milwaukee Bucks,MIL @ DEN,125,13,Regular Season
22020,1610612756,PHX,Phoenix Suns,0022000372,2021-02-08T00:00:00Z,PHX vs. CLE,119,6,1610612739,CLE,Cleveland Cavaliers,CLE @ PHX,113,-6,Regular Season
22020,1610612747,LAL,Los Angeles Lakers,0022000374,2021-02-08T00:00:00Z,LAL vs. OKC,119,7,1610612760,OKC,Oklahoma City Thunder,OKC @ LAL,112,-7,Regular Season
22020,1610612742,DAL,Dallas Mavericks,0022000370,2021-02-08T00:00:00Z,DAL vs. MIN,127,5,1610612750,MIN,Minnesota Timberwolves,MIN @ DAL,122,-5,Regular Season
22020,1610612741,CHI,Chicago Bulls,0022000368,2021-02-08T00:00:00Z,CHI vs. WAS,101,-4,1610612764,WAS,Washington Wizards,WAS @ CHI,105,4,Regular Season
22020,1610612766,CHA,Charlotte Hornets,0022000367,2021-02-08T00:00:00Z,CHA vs. HOU,119,25,1610612745,HOU,Houston Rockets,HOU @ CHA,94,-25,Regular Season
22020,1610612763,MEM,Memphis Grizzlies,0022000369,2021-02-08T00:00:00Z,MEM vs. TOR,113,-15,1610612761,TOR,Toronto Raptors,TOR @ MEM,128,15,Regular Season
22020,1610612759,SAS,San Antonio Spurs,0022000371,2021-02-08T00:00:00Z,SAS vs. GSW,105,5,1610612744,GSW,Golden State Warriors,GSW @ SAS,100,-5,Regular Season
22020,1610612758,SAC,Sacramento Kings,0022000381,2021-02-09T00:00:00Z,SAC vs. PHI,111,-8,1610612755,PHI,Philadelphia 76ers,PHI @ SAC,119,8,Regular Season
22020,1610612748,MIA,Miami Heat,0022000376,2021-02-09T00:00:00Z,MIA vs. NYK,98,2,1610612752,NYK,New York Knicks,NYK @ MIA,96,-2,Regular Season
22020,1610612765,DET,Detroit Pistons,0022000375,2021-02-09T00:00:00Z,DET vs. BKN,122,11,1610612751,BKN,Brooklyn Nets,BKN @ DET,111,-11,Regular Season
22020,1610612762,UTA,Utah Jazz,0022000379,2021-02-09T00:00:00Z,UTA vs. BOS,122,14,1610612738,BOS,Boston Celtics,BOS @ UTA,108,-14,Regular Season
22020,1610612740,NOP,New Orleans Pelicans,0022000377,2021-02-09T00:00:00Z,NOP vs. HOU,130,29,1610612745,HOU,Houston Rockets,HOU @ NOP,101,-29,Regular Season
22020,1610612759,SAS,San Antonio Spurs,0022000378,2021-02-09T00:00:00Z,SAS vs. GSW,91,-23,1610612744,GSW,Golden State Warriors,GSW @ SAS,114,23,Regular Season
22020,1610612757,POR,Portland Trail Blazers,0022000380,2021-02-09T00:00:00Z,POR vs. ORL,106,9,1610612753,ORL,Orlando Magic,ORL @ POR,97,-9,Regular Season
22020,1610612751,BKN,Brooklyn Nets,0022000383,2021-02-10T00:00:00Z,BKN vs. IND,104,10,1610612754,IND,Indiana Pacers,IND @ BKN,94,-10,Regular Season
22020,1610612742,DAL,Dallas Mavericks,0022000384,2021-02-10T00:00:00Z,DAL vs. ATL,118,1,1610612737,ATL,Atlanta Hawks,ATL @ DAL,117,-1,Regular Season
22020,1610612747,LAL,Los Angeles Lakers,0022000390,2021-02-10T00:00:00Z,LAL vs. OKC,114,1,1610612760,OKC,Oklahoma City Thunder,OKC @ LAL,113,-1,Regular Season
22020,1610612763,MEM,Memphis Grizzlies,0022000386,2021-02-10T00:00:00Z,MEM vs. CHA,130,16,1610612766,CHA,Charlotte Hornets,CHA @ MEM,114,-16,Regular Season
22020,1610612741,CHI,Chicago Bulls,0022000385,2021-02-10T00:00:00Z,CHI vs. NOP,129,13,1610612740,NOP,New Orleans Pelicans,NOP @ CHI,116,-13,Regular Season
22020,1610612764,WAS,Washington Wizards,0022000382,2021-02-10T00:00:00Z,WAS vs. TOR,115,-22,1610612761,TOR,Toronto Raptors,TOR @ WAS,137,22,Regular Season
22020,1610612743,DEN,Denver Nuggets,0022000388,2021-02-10T00:00:00Z,DEN vs. CLE,133,38,1610612739,CLE,Cleveland Cavaliers,CLE @ DEN,95,-38,Regular Season
22020,1610612750,MIN,Minnesota Timberwolves,0022000387,2021-02-10T00:00:00Z,MIN vs. LAC,112,-7,1610612746,LAC,LA Clippers,LAC @ MIN,119,7,Regular Season
22020,1610612756,PHX,Phoenix Suns,0022000389,2021-02-10T00:00:00Z,PHX vs. MIL,125,1,1610612749,MIL,Milwaukee Bucks,MIL @ PHX,124,-1,Regular Season
22020,1610612744,GSW,Golden State Warriors,0022000393,2021-02-11T00:00:00Z,GSW vs. ORL,111,6,1610612753,ORL,Orlando Magic,ORL @ GSW,105,-6,Regular Season
22020,1610612745,HOU,Houston Rockets,0022000392,2021-02-11T00:00:00Z,HOU vs. MIA,94,-7,1610612748,MIA,Miami Heat,MIA @ HOU,101,7,Regular Season
22020,1610612757,POR,Portland Trail Blazers,0022000394,2021-02-11T00:00:00Z,POR vs. PHI,118,4,1610612755,PHI,Philadelphia 76ers,PHI @ POR,114,-4,Regular Season
22020,1610612765,DET,Detroit Pistons,0022000391,2021-02-11T00:00:00Z,DET vs. IND,95,-16,1610612754,IND,Indiana Pacers,IND @ DET,111,16,Regular Season
22020,1610612738,BOS,Boston Celtics,0022000398,2021-02-11T00:00:00Z,BOS vs. TOR,120,14,1610612761,TOR,Toronto Raptors,TOR @ BOS,106,-14,Regular Season
22020,1610612766,CHA,Charlotte Hornets,0022000395,2021-02-12T00:00:00Z,CHA vs. MIN,120,6,1610612750,MIN,Minnesota Timberwolves,MIN @ CHA,114,-6,Regular Season
22020,1610612743,DEN,Denver Nuggets,0022000401,2021-02-12T00:00:00Z,DEN vs. OKC,97,2,1610612760,OKC,Oklahoma City Thunder,OKC @ DEN,95,-2,Regular Season
22020,1610612742,DAL,Dallas Mavericks,0022000399,2021-02-12T00:00:00Z,DAL vs. NOP,143,13,1610612740,NOP,New Orleans Pelicans,NOP @ DAL,130,-13,Regular Season
22020,1610612762,UTA,Utah Jazz,0022000402,2021-02-12T00:00:00Z,UTA vs. MIL,129,14,1610612749,MIL,Milwaukee Bucks,MIL @ UTA,115,-14,Regular Season
22020,1610612758,SAC,Sacramento Kings,0022000405,2021-02-12T00:00:00Z,SAC vs. ORL,112,-11,1610612753,ORL,Orlando Magic,ORL @ SAC,123,11,Regular Season
22020,1610612741,CHI,Chicago Bulls,0022000400,2021-02-12T00:00:00Z,CHI vs. LAC,106,-19,1610612746,LAC,LA Clippers,LAC @ CHI,125,19,Regular Season
22020,1610612737,ATL,Atlanta Hawks,0022000397,2021-02-12T00:00:00Z,ATL vs. SAS,114,-11,1610612759,SAS,San Antonio Spurs,SAS @ ATL,125,11,Regular Season
22020,1610612764,WAS,Washington Wizards,0022000396,2021-02-12T00:00:00Z,WAS vs. NYK,91,-18,1610612752,NYK,New York Knicks,NYK @ WAS,109,18,Regular Season
22020,1610612757,POR,Portland Trail Blazers,0022000404,2021-02-12T00:00:00Z,POR vs. CLE,129,19,1610612739,CLE,Cleveland Cavaliers,CLE @ POR,110,-19,Regular Season
22020,1610612747,LAL,Los Angeles Lakers,0022000403,2021-02-12T00:00:00Z,LAL vs. MEM,115,10,1610612763,MEM,Memphis Grizzlies,MEM @ LAL,105,-10,Regular Season
22020,1610612738,BOS,Boston Celtics,0022000412,2021-02-12T00:00:00Z,BOS vs. DET,102,-6,1610612765,DET,Detroit Pistons,DET @ BOS,108,6,Regular Season
22020,1610612737,ATL,Atlanta Hawks,0022000407,2021-02-13T00:00:00Z,ATL vs. IND,113,-12,1610612754,IND,Indiana Pacers,IND @ ATL,125,12,Regular Season
22020,1610612744,GSW,Golden State Warriors,0022000409,2021-02-13T00:00:00Z,GSW vs. BKN,117,-17,1610612751,BKN,Brooklyn Nets,BKN @ GSW,134,17,Regular Season
22020,1610612762,UTA,Utah Jazz,0022000410,2021-02-13T00:00:00Z,UTA vs. MIA,112,18,1610612748,MIA,Miami Heat,MIA @ UTA,94,-18,Regular Season
22020,1610612752,NYK,New York Knicks,0022000408,2021-02-13T00:00:00Z,NYK vs. HOU,121,22,1610612745,HOU,Houston Rockets,HOU @ NYK,99,-22,Regular Season
22020,1610612756,PHX,Phoenix Suns,0022000406,2021-02-13T00:00:00Z,PHX vs. PHI,120,9,1610612755,PHI,Philadelphia 76ers,PHI @ PHX,111,-9,Regular Season
22020,1610612743,DEN,Denver Nuggets,0022000416,2021-02-14T00:00:00Z,DEN vs. LAL,122,17,1610612747,LAL,Los Angeles Lakers,LAL @ DEN,105,-17,Regular Season
22020,1610612742,DAL,Dallas Mavericks,0022000411,2021-02-14T00:00:00Z,DAL vs. POR,118,-3,1610612757,POR,Portland Trail Blazers,POR @ DAL,121,3,Regular Season
22020,1610612756,PHX,Phoenix Suns,0022000417,2021-02-14T00:00:00Z,PHX vs. ORL,109,19,1610612753,ORL,Orlando Magic,ORL @ PHX,90,-19,Regular Season
22020,1610612766,CHA,Charlotte Hornets,0022000414,2021-02-14T00:00:00Z,CHA vs. SAS,110,-12,1610612759,SAS,San Antonio Spurs,SAS @ CHA,122,12,Regular Season
22020,1610612765,DET,Detroit Pistons,0022000561,2021-02-14T00:00:00Z,DET vs. NOP,123,11,1610612740,NOP,New Orleans Pelicans,NOP @ DET,112,-11,Regular Season
22020,1610612758,SAC,Sacramento Kings,0022000418,2021-02-14T00:00:00Z,SAC vs. MEM,110,-14,1610612763,MEM,Memphis Grizzlies,MEM @ SAC,124,14,Regular Season
22020,1610612764,WAS,Washington Wizards,0022000560,2021-02-14T00:00:00Z,WAS vs. BOS,104,13,1610612738,BOS,Boston Celtics,BOS @ WAS,91,-13,Regular Season
22020,1610612761,TOR,Toronto Raptors,0022000413,2021-02-14T00:00:00Z,TOR vs. MIN,112,-4,1610612750,MIN,Minnesota Timberwolves,MIN @ TOR,116,4,Regular Season
22020,1610612760,OKC,Oklahoma City Thunder,0022000415,2021-02-14T00:00:00Z,OKC vs. MIL,114,5,1610612749,MIL,Milwaukee Bucks,MIL @ OKC,109,-5,Regular Season
22020,1610612746,LAC,LA Clippers,0022000419,2021-02-14T00:00:00Z,LAC vs. CLE,128,17,1610612739,CLE,Cleveland Cavaliers,CLE @ LAC,111,-17,Regular Season
22020,1610612758,SAC,Sacramento Kings,0022000426,2021-02-15T00:00:00Z,SAC vs. BKN,125,-11,1610612751,BKN,Brooklyn Nets,BKN @ SAC,136,11,Regular Season
22020,1610612764,WAS,Washington Wizards,0022000421,2021-02-15T00:00:00Z,WAS vs. HOU,131,12,1610612745,HOU,Houston Rockets,HOU @ WAS,119,-12,Regular Season
22020,1610612752,NYK,New York Knicks,0022000422,2021-02-15T00:00:00Z,NYK vs. ATL,123,11,1610612737,ATL,Atlanta Hawks,ATL @ NYK,112,-11,Regular Season
22020,1610612744,GSW,Golden State Warriors,0022000424,2021-02-15T00:00:00Z,GSW vs. CLE,129,31,1610612739,CLE,Cleveland Cavaliers,CLE @ GSW,98,-31,Regular Season
22020,1610612762,UTA,Utah Jazz,0022000423,2021-02-15T00:00:00Z,UTA vs. PHI,134,11,1610612755,PHI,Philadelphia 76ers,PHI @ UTA,123,-11,Regular Season
22020,1610612754,IND,Indiana Pacers,0022000420,2021-02-15T00:00:00Z,IND vs. CHI,112,-8,1610612741,CHI,Chicago Bulls,CHI @ IND,120,8,Regular Season
22020,1610612746,LAC,LA Clippers,0022000425,2021-02-15T00:00:00Z,LAC vs. MIA,125,7,1610612748,MIA,Miami Heat,MIA @ LAC,118,-7,Regular Season
22020,1610612738,BOS,Boston Celtics,0022000427,2021-02-16T00:00:00Z,BOS vs. DEN,112,13,1610612743,DEN,Denver Nuggets,DEN @ BOS,99,-13,Regular Season
22020,1610612760,OKC,Oklahoma City Thunder,0022000432,2021-02-16T00:00:00Z,OKC vs. POR,104,-11,1610612757,POR,Portland Trail Blazers,POR @ OKC,115,11,Regular Season
22020,1610612763,MEM,Memphis Grizzlies,0022000429,2021-02-16T00:00:00Z,MEM vs. NOP,113,-31,1610612740,NOP,New Orleans Pelicans,NOP @ MEM,144,31,Regular Season
22020,1610612756,PHX,Phoenix Suns,0022000433,2021-02-16T00:00:00Z,PHX vs. BKN,124,-4,1610612751,BKN,Brooklyn Nets,BKN @ PHX,128,4,Regular Season
22020,1610612750,MIN,Minnesota Timberwolves,0022000431,2021-02-16T00:00:00Z,MIN vs. LAL,104,-8,1610612747,LAL,Los Angeles Lakers,LAL @ MIN,112,8,Regular Season
22020,1610612749,MIL,Milwaukee Bucks,0022000430,2021-02-16T00:00:00Z,MIL vs. TOR,113,-11,1610612761,TOR,Toronto Raptors,TOR @ MIL,124,11,Regular Season
22020,1610612738,BOS,Boston Celtics,0022000438,2021-02-17T00:00:00Z,BOS vs. ATL,114,-8,1610612737,ATL,Atlanta Hawks,ATL @ BOS,122,8,Regular Season
22020,1610612753,ORL,Orlando Magic,0022000436,2021-02-17T00:00:00Z,ORL vs. NYK,107,18,1610612752,NYK,New York Knicks,NYK @ ORL,89,-18,Regular Season
22020,1610612750,MIN,Minnesota Timberwolves,0022000440,2021-02-17T00:00:00Z,MIN vs. IND,128,-6,1610612754,IND,Indiana Pacers,IND @ MIN,134,6,Regular Season
22020,1610612746,LAC,LA Clippers,0022000444,2021-02-17T00:00:00Z,LAC vs. UTA,96,-18,1610612762,UTA,Utah Jazz,UTA @ LAC,114,18,Regular Season
22020,1610612744,GSW,Golden State Warriors,0022000443,2021-02-17T00:00:00Z,GSW vs. MIA,120,8,1610612748,MIA,Miami Heat,MIA @ GSW,112,-8,Regular Season
22020,1610612740,NOP,New Orleans Pelicans,0022000441,2021-02-17T00:00:00Z,NOP vs. POR,124,-2,1610612757,POR,Portland Trail Blazers,POR @ NOP,126,2,Regular Season
22020,1610612764,WAS,Washington Wizards,0022000437,2021-02-17T00:00:00Z,WAS vs. DEN,130,2,1610612743,DEN,Denver Nuggets,DEN @ WAS,128,-2,Regular Season
22020,1610612755,PHI,Philadelphia 76ers,0022000439,2021-02-17T00:00:00Z,PHI vs. HOU,118,5,1610612745,HOU,Houston Rockets,HOU @ PHI,113,-5,Regular Season
22020,1610612763,MEM,Memphis Grizzlies,0022000562,2021-02-17T00:00:00Z,MEM vs. OKC,122,9,1610612760,OKC,Oklahoma City Thunder,OKC @ MEM,113,-9,Regular Season
22020,1610612741,CHI,Chicago Bulls,0022000564,2021-02-17T00:00:00Z,CHI vs. DET,105,3,1610612765,DET,Detroit Pistons,DET @ CHI,102,-3,Regular Season
22020,1610612749,MIL,Milwaukee Bucks,0022000445,2021-02-18T00:00:00Z,MIL vs. TOR,96,-14,1610612761,TOR,Toronto Raptors,TOR @ MIL,110,14,Regular Season
22020,1610612758,SAC,Sacramento Kings,0022000447,2021-02-18T00:00:00Z,SAC vs. MIA,110,-8,1610612748,MIA,Miami Heat,MIA @ SAC,118,8,Regular Season
22020,1610612747,LAL,Los Angeles Lakers,0022000446,2021-02-18T00:00:00Z,LAL vs. BKN,98,-11,1610612751,BKN,Brooklyn Nets,BKN @ LAL,109,11,Regular Season
22020,1610612763,MEM,Memphis Grizzlies,0022000452,2021-02-19T00:00:00Z,MEM vs. DET,109,14,1610612765,DET,Detroit Pistons,DET @ MEM,95,-14,Regular Season
22020,1610612755,PHI,Philadelphia 76ers,0022000450,2021-02-19T00:00:00Z,PHI vs. CHI,112,7,1610612741,CHI,Chicago Bulls,CHI @ PHI,105,-7,Regular Season
22020,1610612739,CLE,Cleveland Cavaliers,0022000563,2021-02-19T00:00:00Z,CLE vs. DEN,103,-17,1610612743,DEN,Denver Nuggets,DEN @ CLE,120,17,Regular Season
22020,1610612740,NOP,New Orleans Pelicans,0022000455,2021-02-19T00:00:00Z,NOP vs. PHX,114,-18,1610612756,PHX,Phoenix Suns,PHX @ NOP,132,18,Regular Season
22020,1610612738,BOS,Boston Celtics,0022000451,2021-02-19T00:00:00Z,BOS vs. ATL,121,12,1610612737,ATL,Atlanta Hawks,ATL @ BOS,109,-12,Regular Season
22020,1610612753,ORL,Orlando Magic,0022000449,2021-02-19T00:00:00Z,ORL vs. GSW,124,4,1610612744,GSW,Golden State Warriors,GSW @ ORL,120,-4,Regular Season
22020,1610612749,MIL,Milwaukee Bucks,0022000453,2021-02-19T00:00:00Z,MIL vs. OKC,98,13,1610612760,OKC,Oklahoma City Thunder,OKC @ MIL,85,-13,Regular Season
22020,1610612750,MIN,Minnesota Timberwolves,0022000454,2021-02-19T00:00:00Z,MIN vs. TOR,81,-5,1610612761,TOR,Toronto Raptors,TOR @ MIN,86,5,Regular Season
22020,1610612746,LAC,LA Clippers,0022000457,2021-02-19T00:00:00Z,LAC vs. UTA,116,4,1610612762,UTA,Utah Jazz,UTA @ LAC,112,-4,Regular Season
22020,1610612741,CHI,Chicago Bulls,0022000460,2021-02-20T00:00:00Z,CHI vs. SAC,122,8,1610612758,SAC,Sacramento Kings,SAC @ CHI,114,-8,Regular Season
22020,1610612757,POR,Portland Trail Blazers,0022000464,2021-02-20T00:00:00Z,POR vs. WAS,111,-7,1610612764,WAS,Washington Wizards,WAS @ POR,118,7,Regular Season
22020,1610612747,LAL,Los Angeles Lakers,0022000463,2021-02-20T00:00:00Z,LAL vs. MIA,94,-2,1610612748,MIA,Miami Heat,MIA @ LAL,96,2,Regular Season
22020,1610612763,MEM,Memphis Grizzlies,0022000462,2021-02-20T00:00:00Z,MEM vs. PHX,97,-31,1610612756,PHX,Phoenix Suns,PHX @ MEM,128,31,Regular Season
22020,1610612766,CHA,Charlotte Hornets,0022000459,2021-02-20T00:00:00Z,CHA vs. GSW,102,2,1610612744,GSW,Golden State Warriors,GSW @ CHA,100,-2,Regular Season
22020,1610612752,NYK,New York Knicks,0022000469,2021-02-21T00:00:00Z,NYK vs. MIN,103,4,1610612750,MIN,Minnesota Timberwolves,MIN @ NYK,99,-4,Regular Season
22020,1610612749,MIL,Milwaukee Bucks,0022000471,2021-02-21T00:00:00Z,MIL vs. SAC,128,13,1610612758,SAC,Sacramento Kings,SAC @ MIL,115,-13,Regular Season
22020,1610612739,CLE,Cleveland Cavaliers,0022000466,2021-02-21T00:00:00Z,CLE vs. OKC,101,-16,1610612760,OKC,Oklahoma City Thunder,OKC @ CLE,117,16,Regular Season
22020,1610612740,NOP,New Orleans Pelicans,0022000465,2021-02-21T00:00:00Z,NOP vs. BOS,120,5,1610612738,BOS,Boston Celtics,BOS @ NOP,115,-5,Regular Season
22020,1610612746,LAC,LA Clippers,0022000472,2021-02-21T00:00:00Z,LAC vs. BKN,108,-4,1610612751,BKN,Brooklyn Nets,BKN @ LAC,112,4,Regular Season
22020,1610612761,TOR,Toronto Raptors,0022000468,2021-02-21T00:00:00Z,TOR vs. PHI,110,7,1610612755,PHI,Philadelphia 76ers,PHI @ TOR,103,-7,Regular Season
22020,1610612753,ORL,Orlando Magic,0022000467,2021-02-21T00:00:00Z,ORL vs. DET,105,9,1610612765,DET,Detroit Pistons,DET @ ORL,96,-9,Regular Season
22020,1610612737,ATL,Atlanta Hawks,0022000470,2021-02-21T00:00:00Z,ATL vs. DEN,123,8,1610612743,DEN,Denver Nuggets,DEN @ ATL,115,-8,Regular Season
22020,1610612745,HOU,Houston Rockets,0022000474,2021-02-22T00:00:00Z,HOU vs. CHI,100,-20,1610612741,CHI,Chicago Bulls,CHI @ HOU,120,20,Regular Season
22020,1610612756,PHX,Phoenix Suns,0022000477,2021-02-22T00:00:00Z,PHX vs. POR,132,32,1610612757,POR,Portland Trail Blazers,POR @ PHX,100,-32,Regular Season
22020,1610612742,DAL,Dallas Mavericks,0022000476,2021-02-22T00:00:00Z,DAL vs. MEM,102,10,1610612763,MEM,Memphis Grizzlies,MEM @ DAL,92,-10,Regular Season
22020,1610612747,LAL,Los Angeles Lakers,0022000479,2021-02-22T00:00:00Z,LAL vs. WAS,124,-3,1610612764,WAS,Washington Wizards,WAS @ LAL,127,3,Regular Season
22020,1610612762,UTA,Utah Jazz,0022000478,2021-02-22T00:00:00Z,UTA vs. CHA,132,22,1610612766,CHA,Charlotte Hornets,CHA @ UTA,110,-22,Regular Season
22020,1610612760,OKC,Oklahoma City Thunder,0022000475,2021-02-22T00:00:00Z,OKC vs. MIA,94,-14,1610612748,MIA,Miami Heat,MIA @ OKC,108,14,Regular Season
22020,1610612751,BKN,Brooklyn Nets,0022000482,2021-02-23T00:00:00Z,BKN vs. SAC,127,9,1610612758,SAC,Sacramento Kings,SAC @ BKN,118,-9,Regular Season
22020,1610612743,DEN,Denver Nuggets,0022000487,2021-02-23T00:00:00Z,DEN vs. POR,111,5,1610612757,POR,Portland Trail Blazers,POR @ DEN,106,-5,Regular Season
22020,1610612753,ORL,Orlando Magic,0022000481,2021-02-23T00:00:00Z,ORL vs. DET,93,-12,1610612765,DET,Detroit Pistons,DET @ ORL,105,12,Regular Season
22020,1610612746,LAC,LA Clippers,0022000488,2021-02-23T00:00:00Z,LAC vs. WAS,135,19,1610612764,WAS,Washington Wizards,WAS @ LAC,116,-19,Regular Season
22020,1610612749,MIL,Milwaukee Bucks,0022000486,2021-02-23T00:00:00Z,MIL vs. MIN,139,27,1610612750,MIN,Minnesota Timberwolves,MIN @ MIL,112,-27,Regular Season
22020,1610612752,NYK,New York Knicks,0022000483,2021-02-23T00:00:00Z,NYK vs. GSW,106,-8,1610612744,GSW,Golden State Warriors,GSW @ NYK,114,8,Regular Season
22020,1610612742,DAL,Dallas Mavericks,0022000485,2021-02-23T00:00:00Z,DAL vs. BOS,110,3,1610612738,BOS,Boston Celtics,BOS @ DAL,107,-3,Regular Season
22020,1610612739,CLE,Cleveland Cavaliers,0022000480,2021-02-23T00:00:00Z,CLE vs. ATL,112,1,1610612737,ATL,Atlanta Hawks,ATL @ CLE,111,-1,Regular Season
22020,1610612761,TOR,Toronto Raptors,0022000484,2021-02-23T00:00:00Z,TOR vs. PHI,102,-7,1610612755,PHI,Philadelphia 76ers,PHI @ TOR,109,7,Regular Season
22020,1610612756,PHX,Phoenix Suns,0022000496,2021-02-24T00:00:00Z,PHX vs. CHA,121,-3,1610612766,CHA,Charlotte Hornets,CHA @ PHX,124,3,Regular Season
22020,1610612741,CHI,Chicago Bulls,0022000493,2021-02-24T00:00:00Z,CHI vs. MIN,133,7,1610612750,MIN,Minnesota Timberwolves,MIN @ CHI,126,-7,Regular Season
22020,1610612748,MIA,Miami Heat,0022000492,2021-02-24T00:00:00Z,MIA vs. TOR,116,8,1610612761,TOR,Toronto Raptors,TOR @ MIA,108,-8,Regular Season
22020,1610612754,IND,Indiana Pacers,0022000489,2021-02-24T00:00:00Z,IND vs. GSW,107,-4,1610612744,GSW,Golden State Warriors,GSW @ IND,111,4,Regular Season
22020,1610612762,UTA,Utah Jazz,0022000497,2021-02-24T00:00:00Z,UTA vs. LAL,114,25,1610612747,LAL,Los Angeles Lakers,LAL @ UTA,89,-25,Regular Season
22020,1610612760,OKC,Oklahoma City Thunder,0022000495,2021-02-24T00:00:00Z,OKC vs. SAS,102,3,1610612759,SAS,San Antonio Spurs,SAS @ OKC,99,-3,Regular Season
22020,1610612740,NOP,New Orleans Pelicans,0022000494,2021-02-24T00:00:00Z,NOP vs. DET,128,10,1610612765,DET,Detroit Pistons,DET @ NOP,118,-10,Regular Season
22020,1610612739,CLE,Cleveland Cavaliers,0022000491,2021-02-24T00:00:00Z,CLE vs. HOU,112,16,1610612745,HOU,Houston Rockets,HOU @ CLE,96,-16,Regular Season
22020,1610612737,ATL,Atlanta Hawks,0022000490,2021-02-24T00:00:00Z,ATL vs. BOS,127,15,1610612738,BOS,Boston Celtics,BOS @ ATL,112,-15,Regular Season
22020,1610612755,PHI,Philadelphia 76ers,0022000498,2021-02-25T00:00:00Z,PHI vs. DAL,111,14,1610612742,DAL,Dallas Mavericks,DAL @ PHI,97,-14,Regular Season
22020,1610612743,DEN,Denver Nuggets,0022000502,2021-02-25T00:00:00Z,DEN vs. WAS,110,-2,1610612764,WAS,Washington Wizards,WAS @ DEN,112,2,Regular Season
22020,1610612763,MEM,Memphis Grizzlies,0022000501,2021-02-25T00:00:00Z,MEM vs. LAC,122,28,1610612746,LAC,LA Clippers,LAC @ MEM,94,-28,Regular Season
22020,1610612752,NYK,New York Knicks,0022000500,2021-02-25T00:00:00Z,NYK vs. SAC,140,19,1610612758,SAC,Sacramento Kings,SAC @ NYK,121,-19,Regular Season
22020,1610612749,MIL,Milwaukee Bucks,0022000503,2021-02-25T00:00:00Z,MIL vs. NOP,129,4,1610612740,NOP,New Orleans Pelicans,NOP @ MIL,125,-4,Regular Season
22020,1610612751,BKN,Brooklyn Nets,0022000499,2021-02-25T00:00:00Z,BKN vs. ORL,129,37,1610612753,ORL,Orlando Magic,ORL @ BKN,92,-37,Regular Season
22020,1610612738,BOS,Boston Celtics,0022000505,2021-02-26T00:00:00Z,BOS vs. IND,118,6,1610612754,IND,Indiana Pacers,IND @ BOS,112,-6,Regular Season
22020,1610612765,DET,Detroit Pistons,0022000504,2021-02-26T00:00:00Z,DET vs. SAC,107,-3,1610612758,SAC,Sacramento Kings,SAC @ DET,110,3,Regular Season
22020,1610612747,LAL,Los Angeles Lakers,0022000512,2021-02-26T00:00:00Z,LAL vs. POR,102,9,1610612757,POR,Portland Trail Blazers,POR @ LAL,93,-9,Regular Season
22020,1610612748,MIA,Miami Heat,0022000507,2021-02-26T00:00:00Z,MIA vs. UTA,124,8,1610612762,UTA,Utah Jazz,UTA @ MIA,116,-8,Regular Season
22020,1610612760,OKC,Oklahoma City Thunder,0022000510,2021-02-26T00:00:00Z,OKC vs. ATL,118,9,1610612737,ATL,Atlanta Hawks,ATL @ OKC,109,-9,Regular Season
22020,1610612761,TOR,Toronto Raptors,0022000506,2021-02-26T00:00:00Z,TOR vs. HOU,122,11,1610612745,HOU,Houston Rockets,HOU @ TOR,111,-11,Regular Season
22020,1610612741,CHI,Chicago Bulls,0022000508,2021-02-26T00:00:00Z,CHI vs. PHX,97,-9,1610612756,PHX,Phoenix Suns,PHX @ CHI,106,9,Regular Season
22020,1610612744,GSW,Golden State Warriors,0022000511,2021-02-26T00:00:00Z,GSW vs. CHA,130,9,1610612766,CHA,Charlotte Hornets,CHA @ GSW,121,-9,Regular Season
22020,1610612763,MEM,Memphis Grizzlies,0022000509,2021-02-26T00:00:00Z,MEM vs. LAC,99,-20,1610612746,LAC,LA Clippers,LAC @ MEM,119,20,Regular Season
22020,1610612755,PHI,Philadelphia 76ers,0022000513,2021-02-27T00:00:00Z,PHI vs. CLE,109,-3,1610612739,CLE,Cleveland Cavaliers,CLE @ PHI,112,3,Regular Season
22020,1610612760,OKC,Oklahoma City Thunder,0022000518,2021-02-27T00:00:00Z,OKC vs. DEN,96,-30,1610612743,DEN,Denver Nuggets,DEN @ OKC,126,30,Regular Season
22020,1610612752,NYK,New York Knicks,0022000515,2021-02-27T00:00:00Z,NYK vs. IND,110,3,1610612754,IND,Indiana Pacers,IND @ NYK,107,-3,Regular Season
22020,1610612759,SAS,San Antonio Spurs,0022000514,2021-02-27T00:00:00Z,SAS vs. NOP,117,3,1610612740,NOP,New Orleans Pelicans,NOP @ SAS,114,-3,Regular Season
22020,1610612753,ORL,Orlando Magic,0022000516,2021-02-27T00:00:00Z,ORL vs. UTA,109,-15,1610612762,UTA,Utah Jazz,UTA @ ORL,124,15,Regular Season
22020,1610612764,WAS,Washington Wizards,0022000517,2021-02-27T00:00:00Z,WAS vs. MIN,128,16,1610612750,MIN,Minnesota Timberwolves,MIN @ WAS,112,-16,Regular Season
22020,1610612751,BKN,Brooklyn Nets,0022000519,2021-02-27T00:00:00Z,BKN vs. DAL,98,-17,1610612742,DAL,Dallas Mavericks,DAL @ BKN,115,17,Regular Season
22020,1610612745,HOU,Houston Rockets,0022000525,2021-02-28T00:00:00Z,HOU vs. MEM,84,-49,1610612763,MEM,Memphis Grizzlies,MEM @ HOU,133,49,Regular Season
22020,1610612748,MIA,Miami Heat,0022000522,2021-02-28T00:00:00Z,MIA vs. ATL,109,10,1610612737,ATL,Atlanta Hawks,ATL @ MIA,99,-10,Regular Season
22020,1610612747,LAL,Los Angeles Lakers,0022000527,2021-02-28T00:00:00Z,LAL vs. GSW,117,26,1610612744,GSW,Golden State Warriors,GSW @ LAL,91,-26,Regular Season
22020,1610612758,SAC,Sacramento Kings,0022000528,2021-02-28T00:00:00Z,SAC vs. CHA,126,-1,1610612766,CHA,Charlotte Hornets,CHA @ SAC,127,1,Regular Season
22020,1610612765,DET,Detroit Pistons,0022000521,2021-02-28T00:00:00Z,DET vs. NYK,90,-19,1610612752,NYK,New York Knicks,NYK @ DET,109,19,Regular Season
22020,1610612738,BOS,Boston Celtics,0022000524,2021-02-28T00:00:00Z,BOS vs. WAS,111,1,1610612764,WAS,Washington Wizards,WAS @ BOS,110,-1,Regular Season
22020,1610612750,MIN,Minnesota Timberwolves,0022000526,2021-02-28T00:00:00Z,MIN vs. PHX,99,-19,1610612756,PHX,Phoenix Suns,PHX @ MIN,118,19,Regular Season
22020,1610612749,MIL,Milwaukee Bucks,0022000520,2021-02-28T00:00:00Z,MIL vs. LAC,105,5,1610612746,LAC,LA Clippers,LAC @ MIL,100,-5,Regular Season
22020,1610612755,PHI,Philadelphia 76ers,0022000530,2021-03-01T00:00:00Z,PHI vs. IND,130,16,1610612754,IND,Indiana Pacers,IND @ PHI,114,-16,Regular Season
22020,1610612759,SAS,San Antonio Spurs,0022000534,2021-03-01T00:00:00Z,SAS vs. BKN,113,-11,1610612751,BKN,Brooklyn Nets,BKN @ SAS,124,11,Regular Season
22020,1610612745,HOU,Houston Rockets,0022000532,2021-03-01T00:00:00Z,HOU vs. CLE,90,-11,1610612739,CLE,Cleveland Cavaliers,CLE @ HOU,101,11,Regular Season
22020,1610612741,CHI,Chicago Bulls,0022000531,2021-03-01T00:00:00Z,CHI vs. DEN,112,-6,1610612743,DEN,Denver Nuggets,DEN @ CHI,118,6,Regular Season
22020,1610612757,POR,Portland Trail Blazers,0022000535,2021-03-01T00:00:00Z,POR vs. CHA,123,12,1610612766,CHA,Charlotte Hornets,CHA @ POR,111,-12,Regular Season
22020,1610612740,NOP,New Orleans Pelicans,0022000533,2021-03-01T00:00:00Z,NOP vs. UTA,129,5,1610612762,UTA,Utah Jazz,UTA @ NOP,124,-5,Regular Season
22020,1610612753,ORL,Orlando Magic,0022000529,2021-03-01T00:00:00Z,ORL vs. DAL,124,-6,1610612742,DAL,Dallas Mavericks,DAL @ ORL,130,6,Regular Season
22020,1610612759,SAS,San Antonio Spurs,0022000541,2021-03-02T00:00:00Z,SAS vs. NYK,119,26,1610612752,NYK,New York Knicks,NYK @ SAS,93,-26,Regular Season
22020,1610612764,WAS,Washington Wizards,0022000536,2021-03-02T00:00:00Z,WAS vs. MEM,111,-14,1610612763,MEM,Memphis Grizzlies,MEM @ WAS,125,14,Regular Season
22020,1610612738,BOS,Boston Celtics,0022000537,2021-03-02T00:00:00Z,BOS vs. LAC,117,5,1610612746,LAC,LA Clippers,LAC @ BOS,112,-5,Regular Season
22020,1610612747,LAL,Los Angeles Lakers,0022000542,2021-03-02T00:00:00Z,LAL vs. PHX,104,-10,1610612756,PHX,Phoenix Suns,PHX @ LAL,114,10,Regular Season
22020,1610612748,MIA,Miami Heat,0022000538,2021-03-02T00:00:00Z,MIA vs. ATL,80,-14,1610612737,ATL,Atlanta Hawks,ATL @ MIA,94,14,Regular Season
22020,1610612749,MIL,Milwaukee Bucks,0022000540,2021-03-02T00:00:00Z,MIL vs. DEN,97,-31,1610612743,DEN,Denver Nuggets,DEN @ MIL,128,31,Regular Season
22020,1610612761,TOR,Toronto Raptors,0022000539,2021-03-03T00:00:00Z,TOR vs. DET,105,-24,1610612765,DET,Detroit Pistons,DET @ TOR,129,24,Regular Season
22020,1610612753,ORL,Orlando Magic,0022000544,2021-03-03T00:00:00Z,ORL vs. ATL,112,-3,1610612737,ATL,Atlanta Hawks,ATL @ ORL,115,3,Regular Season
22020,1610612758,SAC,Sacramento Kings,0022000551,2021-03-03T00:00:00Z,SAC vs. LAL,123,3,1610612747,LAL,Los Angeles Lakers,LAL @ SAC,120,-3,Regular Season
22020,1610612755,PHI,Philadelphia 76ers,0022000545,2021-03-03T00:00:00Z,PHI vs. UTA,131,8,1610612762,UTA,Utah Jazz,UTA @ PHI,123,-8,Regular Season
22020,1610612757,POR,Portland Trail Blazers,0022000550,2021-03-03T00:00:00Z,POR vs. GSW,108,2,1610612744,GSW,Golden State Warriors,GSW @ POR,106,-2,Regular Season
22020,1610612742,DAL,Dallas Mavericks,0022000549,2021-03-03T00:00:00Z,DAL vs. OKC,87,9,1610612760,OKC,Oklahoma City Thunder,OKC @ DAL,78,-9,Regular Season
22020,1610612745,HOU,Houston Rockets,0022000546,2021-03-03T00:00:00Z,HOU vs. BKN,114,-18,1610612751,BKN,Brooklyn Nets,BKN @ HOU,132,18,Regular Season
22020,1610612740,NOP,New Orleans Pelicans,0022000548,2021-03-03T00:00:00Z,NOP vs. CHI,124,-4,1610612741,CHI,Chicago Bulls,CHI @ NOP,128,4,Regular Season
22020,1610612739,CLE,Cleveland Cavaliers,0022000543,2021-03-03T00:00:00Z,CLE vs. IND,111,-3,1610612754,IND,Indiana Pacers,IND @ CLE,114,3,Regular Season
22020,1610612750,MIN,Minnesota Timberwolves,0022000547,2021-03-03T00:00:00Z,MIN vs. CHA,102,-33,1610612766,CHA,Charlotte Hornets,CHA @ MIN,135,33,Regular Season
22020,1610612759,SAS,San Antonio Spurs,0022000556,2021-03-04T00:00:00Z,SAS vs. OKC,102,-5,1610612760,OKC,Oklahoma City Thunder,OKC @ SAS,107,5,Regular Season
22020,1610612763,MEM,Memphis Grizzlies,0022000555,2021-03-04T00:00:00Z,MEM vs. MIL,111,-1,1610612749,MIL,Milwaukee Bucks,MIL @ MEM,112,1,Regular Season
22020,1610612756,PHX,Phoenix Suns,0022000185,2021-03-04T00:00:00Z,PHX vs. GSW,120,22,1610612744,GSW,Golden State Warriors,GSW @ PHX,98,-22,Regular Season
22020,1610612757,POR,Portland Trail Blazers,0022000558,2021-03-04T00:00:00Z,POR vs. SAC,123,4,1610612758,SAC,Sacramento Kings,SAC @ POR,119,-4,Regular Season
22020,1610612764,WAS,Washington Wizards,0022000554,2021-03-04T00:00:00Z,WAS vs. LAC,119,2,1610612746,LAC,LA Clippers,LAC @ WAS,117,-2,Regular Season
22020,1610612754,IND,Indiana Pacers,0022000553,2021-03-04T00:00:00Z,IND vs. DEN,103,-10,1610612743,DEN,Denver Nuggets,DEN @ IND,113,10,Regular Season
22020,1610612752,NYK,New York Knicks,0022000565,2021-03-04T00:00:00Z,NYK vs. DET,114,10,1610612765,DET,Detroit Pistons,DET @ NYK,104,-10,Regular Season
22020,1610612740,NOP,New Orleans Pelicans,0022000557,2021-03-04T00:00:00Z,NOP vs. MIA,93,-10,1610612748,MIA,Miami Heat,MIA @ NOP,103,10,Regular Season
22020,1610612738,BOS,Boston Celtics,0022000552,2021-03-04T00:00:00Z,BOS vs. TOR,132,7,1610612761,TOR,Toronto Raptors,TOR @ BOS,125,-7,Regular Season
22020,1610612742,DAL,Dallas Mavericks,0022000567,2021-03-10T00:00:00Z,DAL vs. SAS,115,11,1610612759,SAS,San Antonio Spurs,SAS @ DAL,104,-11,Regular Season
22020,1610612763,MEM,Memphis Grizzlies,0022000566,2021-03-10T00:00:00Z,MEM vs. WAS,127,15,1610612764,WAS,Washington Wizards,WAS @ MEM,112,-15,Regular Season
22020,1610612741,CHI,Chicago Bulls,0022000572,2021-03-11T00:00:00Z,CHI vs. PHI,105,-22,1610612755,PHI,Philadelphia 76ers,PHI @ CHI,127,22,Regular Season
22020,1610612751,BKN,Brooklyn Nets,0022000569,2021-03-11T00:00:00Z,BKN vs. BOS,121,12,1610612738,BOS,Boston Celtics,BOS @ BKN,109,-12,Regular Season
22020,1610612748,MIA,Miami Heat,0022000571,2021-03-11T00:00:00Z,MIA vs. ORL,111,8,1610612753,ORL,Orlando Magic,ORL @ MIA,103,-8,Regular Season
22020,1610612761,TOR,Toronto Raptors,0022000570,2021-03-11T00:00:00Z,TOR vs. ATL,120,-1,1610612737,ATL,Atlanta Hawks,ATL @ TOR,121,1,Regular Season
22020,1610612757,POR,Portland Trail Blazers,0022000577,2021-03-11T00:00:00Z,POR vs. PHX,121,-6,1610612756,PHX,Phoenix Suns,PHX @ POR,127,6,Regular Season
22020,1610612760,OKC,Oklahoma City Thunder,0022000575,2021-03-11T00:00:00Z,OKC vs. DAL,116,8,1610612742,DAL,Dallas Mavericks,DAL @ OKC,108,-8,Regular Season
22020,1610612758,SAC,Sacramento Kings,0022000578,2021-03-11T00:00:00Z,SAC vs. HOU,125,20,1610612745,HOU,Houston Rockets,HOU @ SAC,105,-20,Regular Season
22020,1610612746,LAC,LA Clippers,0022000576,2021-03-11T00:00:00Z,LAC vs. GSW,130,26,1610612744,GSW,Golden State Warriors,GSW @ LAC,104,-26,Regular Season
22020,1610612740,NOP,New Orleans Pelicans,0022000574,2021-03-11T00:00:00Z,NOP vs. MIN,105,-30,1610612750,MIN,Minnesota Timberwolves,MIN @ NOP,135,30,Regular Season
22020,1610612749,MIL,Milwaukee Bucks,0022000573,2021-03-11T00:00:00Z,MIL vs. NYK,134,33,1610612752,NYK,New York Knicks,NYK @ MIL,101,-33,Regular Season
22020,1610612766,CHA,Charlotte Hornets,0022000568,2021-03-11T00:00:00Z,CHA vs. DET,105,3,1610612765,DET,Detroit Pistons,DET @ CHA,102,-3,Regular Season
22020,1610612741,CHI,Chicago Bulls,0022000582,2021-03-12T00:00:00Z,CHI vs. MIA,90,-11,1610612748,MIA,Miami Heat,MIA @ CHI,101,11,Regular Season
22020,1610612759,SAS,San Antonio Spurs,0022000583,2021-03-12T00:00:00Z,SAS vs. ORL,104,27,1610612753,ORL,Orlando Magic,ORL @ SAS,77,-27,Regular Season
22020,1610612740,NOP,New Orleans Pelicans,0022000581,2021-03-12T00:00:00Z,NOP vs. CLE,116,34,1610612739,CLE,Cleveland Cavaliers,CLE @ NOP,82,-34,Regular Season
22020,1610612763,MEM,Memphis Grizzlies,0022000580,2021-03-12T00:00:00Z,MEM vs. DEN,102,-1,1610612743,DEN,Denver Nuggets,DEN @ MEM,103,1,Regular Season
22020,1610612764,WAS,Washington Wizards,0022000579,2021-03-12T00:00:00Z,WAS vs. PHI,101,-26,1610612755,PHI,Philadelphia 76ers,PHI @ WAS,127,26,Regular Season
22020,1610612747,LAL,Los Angeles Lakers,0022000585,2021-03-12T00:00:00Z,LAL vs. IND,105,5,1610612754,IND,Indiana Pacers,IND @ LAL,100,-5,Regular Season
22020,1610612762,UTA,Utah Jazz,0022000584,2021-03-12T00:00:00Z,UTA vs. HOU,114,15,1610612745,HOU,Houston Rockets,HOU @ UTA,99,-15,Regular Season
22020,1610612756,PHX,Phoenix Suns,0022000194,2021-03-13T00:00:00Z,PHX vs. IND,111,-11,1610612754,IND,Indiana Pacers,IND @ PHX,122,11,Regular Season
22020,1610612750,MIN,Minnesota Timberwolves,0022000591,2021-03-13T00:00:00Z,MIN vs. POR,121,-4,1610612757,POR,Portland Trail Blazers,POR @ MIN,125,4,Regular Season
22020,1610612760,OKC,Oklahoma City Thunder,0022000586,2021-03-13T00:00:00Z,OKC vs. NYK,97,-22,1610612752,NYK,New York Knicks,NYK @ OKC,119,22,Regular Season
22020,1610612764,WAS,Washington Wizards,0022000589,2021-03-13T00:00:00Z,WAS vs. MIL,119,-6,1610612749,MIL,Milwaukee Bucks,MIL @ WAS,125,6,Regular Season
22020,1610612751,BKN,Brooklyn Nets,0022000587,2021-03-13T00:00:00Z,BKN vs. DET,100,5,1610612765,DET,Detroit Pistons,DET @ BKN,95,-5,Regular Season
22020,1610612737,ATL,Atlanta Hawks,0022000590,2021-03-13T00:00:00Z,ATL vs. SAC,121,15,1610612758,SAC,Sacramento Kings,SAC @ ATL,106,-15,Regular Season
22020,1610612743,DEN,Denver Nuggets,0022000592,2021-03-13T00:00:00Z,DEN vs. DAL,103,-13,1610612742,DAL,Dallas Mavericks,DAL @ DEN,116,13,Regular Season
22020,1610612766,CHA,Charlotte Hornets,0022000588,2021-03-13T00:00:00Z,CHA vs. TOR,114,10,1610612761,TOR,Toronto Raptors,TOR @ CHA,104,-10,Regular Season
22020,1610612741,CHI,Chicago Bulls,0022000600,2021-03-14T00:00:00Z,CHI vs. TOR,118,23,1610612761,TOR,Toronto Raptors,TOR @ CHI,95,-23,Regular Season
22020,1610612744,GSW,Golden State Warriors,0022000594,2021-03-14T00:00:00Z,GSW vs. UTA,131,12,1610612762,UTA,Utah Jazz,UTA @ GSW,119,-12,Regular Season
22020,1610612737,ATL,Atlanta Hawks,0022000597,2021-03-14T00:00:00Z,ATL vs. CLE,100,18,1610612739,CLE,Cleveland Cavaliers,CLE @ ATL,82,-18,Regular Season
22020,1610612750,MIN,Minnesota Timberwolves,0022000599,2021-03-14T00:00:00Z,MIN vs. POR,114,2,1610612757,POR,Portland Trail Blazers,POR @ MIN,112,-2,Regular Season
22020,1610612760,OKC,Oklahoma City Thunder,0022000593,2021-03-14T00:00:00Z,OKC vs. MEM,128,6,1610612763,MEM,Memphis Grizzlies,MEM @ OKC,122,-6,Regular Season
22020,1610612755,PHI,Philadelphia 76ers,0022000595,2021-03-14T00:00:00Z,PHI vs. SAS,134,35,1610612759,SAS,San Antonio Spurs,SAS @ PHI,99,-35,Regular Season
22020,1610612740,NOP,New Orleans Pelicans,0022000601,2021-03-14T00:00:00Z,NOP vs. LAC,135,20,1610612746,LAC,LA Clippers,LAC @ NOP,115,-20,Regular Season
22020,1610612745,HOU,Houston Rockets,0022000598,2021-03-14T00:00:00Z,HOU vs. BOS,107,-27,1610612738,BOS,Boston Celtics,BOS @ HOU,134,27,Regular Season
22020,1610612753,ORL,Orlando Magic,0022000596,2021-03-14T00:00:00Z,ORL vs. MIA,97,-5,1610612748,MIA,Miami Heat,MIA @ ORL,102,5,Regular Season
22020,1610612764,WAS,Washington Wizards,0022000603,2021-03-15T00:00:00Z,WAS vs. MIL,122,-11,1610612749,MIL,Milwaukee Bucks,MIL @ WAS,133,11,Regular Season
22020,1610612756,PHX,Phoenix Suns,0022000607,2021-03-15T00:00:00Z,PHX vs. MEM,122,23,1610612763,MEM,Memphis Grizzlies,MEM @ PHX,99,-23,Regular Season
22020,1610612751,BKN,Brooklyn Nets,0022000604,2021-03-15T00:00:00Z,BKN vs. NYK,117,5,1610612752,NYK,New York Knicks,NYK @ BKN,112,-5,Regular Season
22020,1610612765,DET,Detroit Pistons,0022000428,2021-03-15T00:00:00Z,DET vs. SAS,99,-10,1610612759,SAS,San Antonio Spurs,SAS @ DET,109,10,Regular Season
22020,1610612743,DEN,Denver Nuggets,0022000606,2021-03-15T00:00:00Z,DEN vs. IND,121,15,1610612754,IND,Indiana Pacers,IND @ DEN,106,-15,Regular Season
22020,1610612766,CHA,Charlotte Hornets,0022000602,2021-03-15T00:00:00Z,CHA vs. SAC,122,6,1610612758,SAC,Sacramento Kings,SAC @ CHA,116,-6,Regular Season
22020,1610612742,DAL,Dallas Mavericks,0022000605,2021-03-15T00:00:00Z,DAL vs. LAC,99,-10,1610612746,LAC,LA Clippers,LAC @ DAL,109,10,Regular Season
22020,1610612744,GSW,Golden State Warriors,0022000608,2021-03-15T00:00:00Z,GSW vs. LAL,97,-31,1610612747,LAL,Los Angeles Lakers,LAL @ GSW,128,31,Regular Season
22020,1610612747,LAL,Los Angeles Lakers,0022000615,2021-03-16T00:00:00Z,LAL vs. MIN,137,16,1610612750,MIN,Minnesota Timberwolves,MIN @ LAL,121,-16,Regular Season
22020,1610612757,POR,Portland Trail Blazers,0022000614,2021-03-16T00:00:00Z,POR vs. NOP,125,1,1610612740,NOP,New Orleans Pelicans,NOP @ POR,124,-1,Regular Season
22020,1610612745,HOU,Houston Rockets,0022000613,2021-03-16T00:00:00Z,HOU vs. ATL,107,-12,1610612737,ATL,Atlanta Hawks,ATL @ HOU,119,12,Regular Season
22020,1610612748,MIA,Miami Heat,0022000610,2021-03-16T00:00:00Z,MIA vs. CLE,113,15,1610612739,CLE,Cleveland Cavaliers,CLE @ MIA,98,-15,Regular Season
22020,1610612738,BOS,Boston Celtics,0022000609,2021-03-16T00:00:00Z,BOS vs. UTA,109,-8,1610612762,UTA,Utah Jazz,UTA @ BOS,117,8,Regular Season
22020,1610612755,PHI,Philadelphia 76ers,0022000611,2021-03-16T00:00:00Z,PHI vs. NYK,99,3,1610612752,NYK,New York Knicks,NYK @ PHI,96,-3,Regular Season
22020,1610612741,CHI,Chicago Bulls,0022000612,2021-03-16T00:00:00Z,CHI vs. OKC,123,21,1610612760,OKC,Oklahoma City Thunder,OKC @ CHI,102,-21,Regular Season
22020,1610612742,DAL,Dallas Mavericks,0022000625,2021-03-17T00:00:00Z,DAL vs. LAC,105,16,1610612746,LAC,LA Clippers,LAC @ DAL,89,-16,Regular Season
22020,1610612764,WAS,Washington Wizards,0022000619,2021-03-17T00:00:00Z,WAS vs. SAC,119,-2,1610612758,SAC,Sacramento Kings,SAC @ WAS,121,2,Regular Season
22020,1610612754,IND,Indiana Pacers,0022000617,2021-03-17T00:00:00Z,IND vs. BKN,115,-9,1610612751,BKN,Brooklyn Nets,BKN @ IND,124,9,Regular Season
22020,1610612755,PHI,Philadelphia 76ers,0022000618,2021-03-17T00:00:00Z,PHI vs. MIL,105,-4,1610612749,MIL,Milwaukee Bucks,MIL @ PHI,109,4,Regular Season
22020,1610612763,MEM,Memphis Grizzlies,0022000623,2021-03-17T00:00:00Z,MEM vs. MIA,89,4,1610612748,MIA,Miami Heat,MIA @ MEM,85,-4,Regular Season
22020,1610612743,DEN,Denver Nuggets,0022000624,2021-03-17T00:00:00Z,DEN vs. CHA,129,25,1610612766,CHA,Charlotte Hornets,CHA @ DEN,104,-25,Regular Season
22020,1610612765,DET,Detroit Pistons,0022000616,2021-03-17T00:00:00Z,DET vs. TOR,116,4,1610612761,TOR,Toronto Raptors,TOR @ DET,112,-4,Regular Season
22020,1610612739,CLE,Cleveland Cavaliers,0022000620,2021-03-17T00:00:00Z,CLE vs. BOS,117,7,1610612738,BOS,Boston Celtics,BOS @ CLE,110,-7,Regular Season
22020,1610612745,HOU,Houston Rockets,0022000622,2021-03-17T00:00:00Z,HOU vs. GSW,94,-14,1610612744,GSW,Golden State Warriors,GSW @ HOU,108,14,Regular Season
22020,1610612741,CHI,Chicago Bulls,0022000621,2021-03-17T00:00:00Z,CHI vs. SAS,99,-7,1610612759,SAS,San Antonio Spurs,SAS @ CHI,106,7,Regular Season
22020,1610612737,ATL,Atlanta Hawks,0022000626,2021-03-18T00:00:00Z,ATL vs. OKC,116,23,1610612760,OKC,Oklahoma City Thunder,OKC @ ATL,93,-23,Regular Season
22020,1610612757,POR,Portland Trail Blazers,0022000629,2021-03-18T00:00:00Z,POR vs. NOP,101,8,1610612740,NOP,New Orleans Pelicans,NOP @ POR,93,-8,Regular Season
22020,1610612756,PHX,Phoenix Suns,0022000628,2021-03-18T00:00:00Z,PHX vs. MIN,119,-4,1610612750,MIN,Minnesota Timberwolves,MIN @ PHX,123,4,Regular Season
22020,1610612747,LAL,Los Angeles Lakers,0022000630,2021-03-18T00:00:00Z,LAL vs. CHA,116,11,1610612766,CHA,Charlotte Hornets,CHA @ LAL,105,-11,Regular Season
22020,1610612752,NYK,New York Knicks,0022000627,2021-03-18T00:00:00Z,NYK vs. ORL,94,1,1610612753,ORL,Orlando Magic,ORL @ NYK,93,-1,Regular Season
22020,1610612764,WAS,Washington Wizards,0022000166,2021-03-18T00:00:00Z,WAS vs. UTA,131,9,1610612762,UTA,Utah Jazz,UTA @ WAS,122,-9,Regular Season
22020,1610612745,HOU,Houston Rockets,0022000635,2021-03-19T00:00:00Z,HOU vs. DET,100,-13,1610612765,DET,Detroit Pistons,DET @ HOU,113,13,Regular Season
22020,1610612743,DEN,Denver Nuggets,0022000637,2021-03-19T00:00:00Z,DEN vs. CHI,131,4,1610612741,CHI,Chicago Bulls,CHI @ DEN,127,-4,Regular Season
22020,1610612738,BOS,Boston Celtics,0022000631,2021-03-19T00:00:00Z,BOS vs. SAC,96,-11,1610612758,SAC,Sacramento Kings,SAC @ BOS,107,11,Regular Season
22020,1610612757,POR,Portland Trail Blazers,0022000639,2021-03-19T00:00:00Z,POR vs. DAL,125,6,1610612742,DAL,Dallas Mavericks,DAL @ POR,119,-6,Regular Season
22020,1610612756,PHX,Phoenix Suns,0022000638,2021-03-19T00:00:00Z,PHX vs. MIN,113,12,1610612750,MIN,Minnesota Timberwolves,MIN @ PHX,101,-12,Regular Season
22020,1610612763,MEM,Memphis Grizzlies,0022000636,2021-03-19T00:00:00Z,MEM vs. GSW,103,-13,1610612744,GSW,Golden State Warriors,GSW @ MEM,116,13,Regular Season
22020,1610612753,ORL,Orlando Magic,0022000633,2021-03-19T00:00:00Z,ORL vs. BKN,121,8,1610612751,BKN,Brooklyn Nets,BKN @ ORL,113,-8,Regular Season
22020,1610612739,CLE,Cleveland Cavaliers,0022000435,2021-03-19T00:00:00Z,CLE vs. SAS,110,-6,1610612759,SAS,San Antonio Spurs,SAS @ CLE,116,6,Regular Season
22020,1610612748,MIA,Miami Heat,0022000632,2021-03-19T00:00:00Z,MIA vs. IND,110,-27,1610612754,IND,Indiana Pacers,IND @ MIA,137,27,Regular Season
22020,1610612761,TOR,Toronto Raptors,0022000634,2021-03-19T00:00:00Z,TOR vs. UTA,112,-3,1610612762,UTA,Utah Jazz,UTA @ TOR,115,3,Regular Season
22020,1610612749,MIL,Milwaukee Bucks,0022000643,2021-03-20T00:00:00Z,MIL vs. SAS,120,7,1610612759,SAS,San Antonio Spurs,SAS @ MIL,113,-7,Regular Season
22020,1610612763,MEM,Memphis Grizzlies,0022000642,2021-03-20T00:00:00Z,MEM vs. GSW,111,8,1610612744,GSW,Golden State Warriors,GSW @ MEM,103,-8,Regular Season
22020,1610612747,LAL,Los Angeles Lakers,0022000640,2021-03-20T00:00:00Z,LAL vs. ATL,94,-5,1610612737,ATL,Atlanta Hawks,ATL @ LAL,99,5,Regular Season
22020,1610612746,LAC,LA Clippers,0022000644,2021-03-20T00:00:00Z,LAC vs. CHA,125,27,1610612766,CHA,Charlotte Hornets,CHA @ LAC,98,-27,Regular Season
22020,1610612755,PHI,Philadelphia 76ers,0022000641,2021-03-20T00:00:00Z,PHI vs. SAC,129,24,1610612758,SAC,Sacramento Kings,SAC @ PHI,105,-24,Regular Season
22020,1610612756,PHX,Phoenix Suns,0022000651,2021-03-21T00:00:00Z,PHX vs. LAL,111,17,1610612747,LAL,Los Angeles Lakers,LAL @ PHX,94,-17,Regular Season
22020,1610612765,DET,Detroit Pistons,0022000649,2021-03-21T00:00:00Z,DET vs. CHI,86,-14,1610612741,CHI,Chicago Bulls,CHI @ DET,100,14,Regular Season
22020,1610612745,HOU,Houston Rockets,0022000016,2021-03-21T00:00:00Z,HOU vs. OKC,112,-2,1610612760,OKC,Oklahoma City Thunder,OKC @ HOU,114,2,Regular Season
22020,1610612743,DEN,Denver Nuggets,0022000646,2021-03-21T00:00:00Z,DEN vs. NOP,108,-5,1610612740,NOP,New Orleans Pelicans,NOP @ DEN,113,5,Regular Season
22020,1610612739,CLE,Cleveland Cavaliers,0022000648,2021-03-21T00:00:00Z,CLE vs. TOR,116,11,1610612761,TOR,Toronto Raptors,TOR @ CLE,105,-11,Regular Season
22020,1610612738,BOS,Boston Celtics,0022000167,2021-03-21T00:00:00Z,BOS vs. ORL,112,16,1610612753,ORL,Orlando Magic,ORL @ BOS,96,-16,Regular Season
22020,1610612752,NYK,New York Knicks,0022000650,2021-03-21T00:00:00Z,NYK vs. PHI,100,-1,1610612755,PHI,Philadelphia 76ers,PHI @ NYK,101,1,Regular Season
22020,1610612748,MIA,Miami Heat,0022000645,2021-03-21T00:00:00Z,MIA vs. IND,106,-3,1610612754,IND,Indiana Pacers,IND @ MIA,109,3,Regular Season
22020,1610612757,POR,Portland Trail Blazers,0022000652,2021-03-21T00:00:00Z,POR vs. DAL,92,-40,1610612742,DAL,Dallas Mavericks,DAL @ POR,132,40,Regular Season
22020,1610612751,BKN,Brooklyn Nets,0022000647,2021-03-21T00:00:00Z,BKN vs. WAS,113,7,1610612764,WAS,Washington Wizards,WAS @ BKN,106,-7,Regular Season
22020,1610612759,SAS,San Antonio Spurs,0022000655,2021-03-22T00:00:00Z,SAS vs. CHA,97,-3,1610612766,CHA,Charlotte Hornets,CHA @ SAS,100,3,Regular Season
22020,1610612746,LAC,LA Clippers,0022000660,2021-03-22T00:00:00Z,LAC vs. ATL,119,9,1610612737,ATL,Atlanta Hawks,ATL @ LAC,110,-9,Regular Season
22020,1610612739,CLE,Cleveland Cavaliers,0022000653,2021-03-22T00:00:00Z,CLE vs. SAC,105,-14,1610612758,SAC,Sacramento Kings,SAC @ CLE,119,14,Regular Season
22020,1610612749,MIL,Milwaukee Bucks,0022000659,2021-03-22T00:00:00Z,MIL vs. IND,140,27,1610612754,IND,Indiana Pacers,IND @ MIL,113,-27,Regular Season
22020,1610612741,CHI,Chicago Bulls,0022000656,2021-03-22T00:00:00Z,CHI vs. UTA,95,-25,1610612762,UTA,Utah Jazz,UTA @ CHI,120,25,Regular Season
22020,1610612763,MEM,Memphis Grizzlies,0022000658,2021-03-22T00:00:00Z,MEM vs. BOS,132,6,1610612738,BOS,Boston Celtics,BOS @ MEM,126,-6,Regular Season
22020,1610612750,MIN,Minnesota Timberwolves,0022000654,2021-03-22T00:00:00Z,MIN vs. OKC,103,-9,1610612760,OKC,Oklahoma City Thunder,OKC @ MIN,112,9,Regular Season
22020,1610612745,HOU,Houston Rockets,0022000657,2021-03-22T00:00:00Z,HOU vs. TOR,117,18,1610612761,TOR,Toronto Raptors,TOR @ HOU,99,-18,Regular Season
22020,1610612748,MIA,Miami Heat,0022000664,2021-03-23T00:00:00Z,MIA vs. PHX,100,-10,1610612756,PHX,Phoenix Suns,PHX @ MIA,110,10,Regular Season
22020,1610612757,POR,Portland Trail Blazers,0022000666,2021-03-23T00:00:00Z,POR vs. BKN,112,-4,1610612751,BKN,Brooklyn Nets,BKN @ POR,116,4,Regular Season
22020,1610612744,GSW,Golden State Warriors,0022000665,2021-03-23T00:00:00Z,GSW vs. PHI,98,-10,1610612755,PHI,Philadelphia 76ers,PHI @ GSW,108,10,Regular Season
22020,1610612740,NOP,New Orleans Pelicans,0022000663,2021-03-23T00:00:00Z,NOP vs. LAL,128,17,1610612747,LAL,Los Angeles Lakers,LAL @ NOP,111,-17,Regular Season
22020,1610612752,NYK,New York Knicks,0022000662,2021-03-23T00:00:00Z,NYK vs. WAS,131,18,1610612764,WAS,Washington Wizards,WAS @ NYK,113,-18,Regular Season
22020,1610612753,ORL,Orlando Magic,0022000661,2021-03-23T00:00:00Z,ORL vs. DEN,99,-11,1610612743,DEN,Denver Nuggets,DEN @ ORL,110,11,Regular Season
22020,1610612759,SAS,San Antonio Spurs,0022000675,2021-03-24T00:00:00Z,SAS vs. LAC,101,-33,1610612746,LAC,LA Clippers,LAC @ SAS,134,33,Regular Season
22020,1610612749,MIL,Milwaukee Bucks,0022000669,2021-03-24T00:00:00Z,MIL vs. BOS,121,2,1610612738,BOS,Boston Celtics,BOS @ MIL,119,-2,Regular Season
22020,1610612753,ORL,Orlando Magic,0022000670,2021-03-24T00:00:00Z,ORL vs. PHX,112,1,1610612756,PHX,Phoenix Suns,PHX @ ORL,111,-1,Regular Season
22020,1610612754,IND,Indiana Pacers,0022000667,2021-03-24T00:00:00Z,IND vs. DET,116,5,1610612765,DET,Detroit Pistons,DET @ IND,111,-5,Regular Season
22020,1610612758,SAC,Sacramento Kings,0022000677,2021-03-24T00:00:00Z,SAC vs. ATL,110,2,1610612737,ATL,Atlanta Hawks,ATL @ SAC,108,-2,Regular Season
22020,1610612750,MIN,Minnesota Timberwolves,0022000673,2021-03-24T00:00:00Z,MIN vs. DAL,108,-20,1610612742,DAL,Dallas Mavericks,DAL @ MIN,128,20,Regular Season
22020,1610612760,OKC,Oklahoma City Thunder,0022000674,2021-03-24T00:00:00Z,OKC vs. MEM,107,-9,1610612763,MEM,Memphis Grizzlies,MEM @ OKC,116,9,Regular Season
22020,1610612761,TOR,Toronto Raptors,0022000668,2021-03-24T00:00:00Z,TOR vs. DEN,135,24,1610612743,DEN,Denver Nuggets,DEN @ TOR,111,-24,Regular Season
22020,1610612741,CHI,Chicago Bulls,0022000671,2021-03-24T00:00:00Z,CHI vs. CLE,94,-9,1610612739,CLE,Cleveland Cavaliers,CLE @ CHI,103,9,Regular Season
22020,1610612762,UTA,Utah Jazz,0022000676,2021-03-24T00:00:00Z,UTA vs. BKN,118,30,1610612751,BKN,Brooklyn Nets,BKN @ UTA,88,-30,Regular Season
22020,1610612745,HOU,Houston Rockets,0022000672,2021-03-24T00:00:00Z,HOU vs. CHA,97,-25,1610612766,CHA,Charlotte Hornets,CHA @ HOU,122,25,Regular Season
22020,1610612758,SAC,Sacramento Kings,0022000682,2021-03-25T00:00:00Z,SAC vs. GSW,141,22,1610612744,GSW,Golden State Warriors,GSW @ SAC,119,-22,Regular Season
22020,1610612747,LAL,Los Angeles Lakers,0022000681,2021-03-25T00:00:00Z,LAL vs. PHI,101,-8,1610612755,PHI,Philadelphia 76ers,PHI @ LAL,109,8,Regular Season
22020,1610612752,NYK,New York Knicks,0022000679,2021-03-25T00:00:00Z,NYK vs. WAS,106,4,1610612764,WAS,Washington Wizards,WAS @ NYK,102,-4,Regular Season
22020,1610612759,SAS,San Antonio Spurs,0022000680,2021-03-25T00:00:00Z,SAS vs. LAC,85,-13,1610612746,LAC,LA Clippers,LAC @ SAS,98,13,Regular Season
22020,1610612748,MIA,Miami Heat,0022000678,2021-03-25T00:00:00Z,MIA vs. POR,122,-3,1610612757,POR,Portland Trail Blazers,POR @ MIA,125,3,Regular Season
22020,1610612740,NOP,New Orleans Pelicans,0022000689,2021-03-26T00:00:00Z,NOP vs. DEN,108,-5,1610612743,DEN,Denver Nuggets,DEN @ NOP,113,5,Regular Season
22020,1610612753,ORL,Orlando Magic,0022000687,2021-03-26T00:00:00Z,ORL vs. POR,105,-7,1610612757,POR,Portland Trail Blazers,POR @ ORL,112,7,Regular Season
22020,1610612766,CHA,Charlotte Hornets,0022000686,2021-03-26T00:00:00Z,CHA vs. MIA,110,5,1610612748,MIA,Miami Heat,MIA @ CHA,105,-5,Regular Season
22020,1610612750,MIN,Minnesota Timberwolves,0022000688,2021-03-26T00:00:00Z,MIN vs. HOU,107,6,1610612745,HOU,Houston Rockets,HOU @ MIN,101,-6,Regular Season
22020,1610612762,UTA,Utah Jazz,0022000691,2021-03-26T00:00:00Z,UTA vs. MEM,117,3,1610612763,MEM,Memphis Grizzlies,MEM @ UTA,114,-3,Regular Season
22020,1610612761,TOR,Toronto Raptors,0022000684,2021-03-26T00:00:00Z,TOR vs. PHX,100,-4,1610612756,PHX,Phoenix Suns,PHX @ TOR,104,4,Regular Season
22020,1610612742,DAL,Dallas Mavericks,0022000690,2021-03-26T00:00:00Z,DAL vs. IND,94,-15,1610612754,IND,Indiana Pacers,IND @ DAL,109,15,Regular Season
22020,1610612749,MIL,Milwaukee Bucks,0022000685,2021-03-26T00:00:00Z,MIL vs. BOS,114,-8,1610612738,BOS,Boston Celtics,BOS @ MIL,122,8,Regular Season
22020,1610612744,GSW,Golden State Warriors,0022000692,2021-03-26T00:00:00Z,GSW vs. ATL,108,-16,1610612737,ATL,Atlanta Hawks,ATL @ GSW,124,16,Regular Season
22020,1610612747,LAL,Los Angeles Lakers,0022000693,2021-03-26T00:00:00Z,LAL vs. CLE,100,14,1610612739,CLE,Cleveland Cavaliers,CLE @ LAL,86,-14,Regular Season
22020,1610612765,DET,Detroit Pistons,0022000683,2021-03-26T00:00:00Z,DET vs. BKN,111,-2,1610612751,BKN,Brooklyn Nets,BKN @ DET,113,2,Regular Season
22020,1610612764,WAS,Washington Wizards,0022000694,2021-03-27T00:00:00Z,WAS vs. DET,106,14,1610612765,DET,Detroit Pistons,DET @ WAS,92,-14,Regular Season
22020,1610612750,MIN,Minnesota Timberwolves,0022000696,2021-03-27T00:00:00Z,MIN vs. HOU,107,-22,1610612745,HOU,Houston Rockets,HOU @ MIN,129,22,Regular Season
22020,1610612740,NOP,New Orleans Pelicans,0022000698,2021-03-27T00:00:00Z,NOP vs. DAL,112,9,1610612742,DAL,Dallas Mavericks,DAL @ NOP,103,-9,Regular Season
22020,1610612758,SAC,Sacramento Kings,0022000702,2021-03-27T00:00:00Z,SAC vs. CLE,100,2,1610612739,CLE,Cleveland Cavaliers,CLE @ SAC,98,-2,Regular Season
22020,1610612746,LAC,LA Clippers,0022000701,2021-03-27T00:00:00Z,LAC vs. PHI,122,10,1610612755,PHI,Philadelphia 76ers,PHI @ LAC,112,-10,Regular Season
22020,1610612759,SAS,San Antonio Spurs,0022000697,2021-03-27T00:00:00Z,SAS vs. CHI,120,16,1610612741,CHI,Chicago Bulls,CHI @ SAS,104,-16,Regular Season
22020,1610612749,MIL,Milwaukee Bucks,0022000695,2021-03-27T00:00:00Z,MIL vs. NYK,96,-6,1610612752,NYK,New York Knicks,NYK @ MIL,102,6,Regular Season
22020,1610612762,UTA,Utah Jazz,0022000700,2021-03-27T00:00:00Z,UTA vs. MEM,126,16,1610612763,MEM,Memphis Grizzlies,MEM @ UTA,110,-16,Regular Season
22020,1610612760,OKC,Oklahoma City Thunder,0022000699,2021-03-27T00:00:00Z,OKC vs. BOS,94,-17,1610612738,BOS,Boston Celtics,BOS @ OKC,111,17,Regular Season
22020,1610612761,TOR,Toronto Raptors,0022000704,2021-03-28T00:00:00Z,TOR vs. POR,117,-5,1610612757,POR,Portland Trail Blazers,POR @ TOR,122,5,Regular Season
22020,1610612766,CHA,Charlotte Hornets,0022000703,2021-03-28T00:00:00Z,CHA vs. PHX,97,-4,1610612756,PHX,Phoenix Suns,PHX @ CHA,101,4,Regular Season
22020,1610612743,DEN,Denver Nuggets,0022000705,2021-03-28T00:00:00Z,DEN vs. ATL,126,24,1610612737,ATL,Atlanta Hawks,ATL @ DEN,102,-24,Regular Season
22020,1610612747,LAL,Los Angeles Lakers,0022000706,2021-03-28T00:00:00Z,LAL vs. ORL,96,3,1610612753,ORL,Orlando Magic,ORL @ LAL,93,-3,Regular Season
22020,1610612751,BKN,Brooklyn Nets,0022000709,2021-03-29T00:00:00Z,BKN vs. MIN,112,5,1610612750,MIN,Minnesota Timberwolves,MIN @ BKN,107,-5,Regular Season
22020,1610612744,GSW,Golden State Warriors,0022000716,2021-03-29T00:00:00Z,GSW vs. CHI,116,14,1610612741,CHI,Chicago Bulls,CHI @ GSW,102,-14,Regular Season
22020,1610612765,DET,Detroit Pistons,0022000711,2021-03-29T00:00:00Z,DET vs. TOR,118,14,1610612761,TOR,Toronto Raptors,TOR @ DET,104,-14,Regular Season
22020,1610612738,BOS,Boston Celtics,0022000708,2021-03-29T00:00:00Z,BOS vs. NOP,109,-6,1610612740,NOP,New Orleans Pelicans,NOP @ BOS,115,6,Regular Season
22020,1610612759,SAS,San Antonio Spurs,0022000714,2021-03-29T00:00:00Z,SAS vs. SAC,115,-17,1610612758,SAC,Sacramento Kings,SAC @ SAS,132,17,Regular Season
22020,1610612745,HOU,Houston Rockets,0022000712,2021-03-29T00:00:00Z,HOU vs. MEM,110,-10,1610612763,MEM,Memphis Grizzlies,MEM @ HOU,120,10,Regular Season
22020,1610612760,OKC,Oklahoma City Thunder,0022000713,2021-03-29T00:00:00Z,OKC vs. DAL,106,-21,1610612742,DAL,Dallas Mavericks,DAL @ OKC,127,21,Regular Season
22020,1610612752,NYK,New York Knicks,0022000710,2021-03-29T00:00:00Z,NYK vs. MIA,88,-10,1610612748,MIA,Miami Heat,MIA @ NYK,98,10,Regular Season
22020,1610612746,LAC,LA Clippers,0022000717,2021-03-29T00:00:00Z,LAC vs. MIL,129,24,1610612749,MIL,Milwaukee Bucks,MIL @ LAC,105,-24,Regular Season
22020,1610612762,UTA,Utah Jazz,0022000715,2021-03-29T00:00:00Z,UTA vs. CLE,114,39,1610612739,CLE,Cleveland Cavaliers,CLE @ UTA,75,-39,Regular Season
22020,1610612764,WAS,Washington Wizards,0022000707,2021-03-29T00:00:00Z,WAS vs. IND,132,8,1610612754,IND,Indiana Pacers,IND @ WAS,124,-8,Regular Season
22020,1610612756,PHX,Phoenix Suns,0022000171,2021-03-30T00:00:00Z,PHX vs. ATL,117,7,1610612737,ATL,Atlanta Hawks,ATL @ PHX,110,-7,Regular Season
22020,1610612743,DEN,Denver Nuggets,0022000719,2021-03-30T00:00:00Z,DEN vs. PHI,104,9,1610612755,PHI,Philadelphia 76ers,PHI @ DEN,95,-9,Regular Season
22020,1610612746,LAC,LA Clippers,0022000720,2021-03-30T00:00:00Z,LAC vs. ORL,96,-7,1610612753,ORL,Orlando Magic,ORL @ LAC,103,7,Regular Season
22020,1610612764,WAS,Washington Wizards,0022000718,2021-03-30T00:00:00Z,WAS vs. CHA,104,-10,1610612766,CHA,Charlotte Hornets,CHA @ WAS,114,10,Regular Season
22020,1610612763,MEM,Memphis Grizzlies,0022000725,2021-03-31T00:00:00Z,MEM vs. UTA,107,-4,1610612762,UTA,Utah Jazz,UTA @ MEM,111,4,Regular Season
22020,1610612756,PHX,Phoenix Suns,0022000730,2021-03-31T00:00:00Z,PHX vs. CHI,121,5,1610612741,CHI,Chicago Bulls,CHI @ PHX,116,-5,Regular Season
22020,1610612760,OKC,Oklahoma City Thunder,0022000727,2021-03-31T00:00:00Z,OKC vs. TOR,113,10,1610612761,TOR,Toronto Raptors,TOR @ OKC,103,-10,Regular Season
22020,1610612750,MIN,Minnesota Timberwolves,0022000726,2021-03-31T00:00:00Z,MIN vs. NYK,102,1,1610612752,NYK,New York Knicks,NYK @ MIN,101,-1,Regular Season
22020,1610612747,LAL,Los Angeles Lakers,0022000729,2021-03-31T00:00:00Z,LAL vs. MIL,97,-15,1610612749,MIL,Milwaukee Bucks,MIL @ LAL,112,15,Regular Season
22020,1610612765,DET,Detroit Pistons,0022000721,2021-03-31T00:00:00Z,DET vs. POR,101,-23,1610612757,POR,Portland Trail Blazers,POR @ DET,124,23,Regular Season
22020,1610612754,IND,Indiana Pacers,0022000722,2021-03-31T00:00:00Z,IND vs. MIA,87,-5,1610612748,MIA,Miami Heat,MIA @ IND,92,5,Regular Season
22020,1610612738,BOS,Boston Celtics,0022000723,2021-03-31T00:00:00Z,BOS vs. DAL,108,-5,1610612742,DAL,Dallas Mavericks,DAL @ BOS,113,5,Regular Season
22020,1610612759,SAS,San Antonio Spurs,0022000728,2021-03-31T00:00:00Z,SAS vs. SAC,120,14,1610612758,SAC,Sacramento Kings,SAC @ SAS,106,-14,Regular Season
22020,1610612751,BKN,Brooklyn Nets,0022000724,2021-03-31T00:00:00Z,BKN vs. HOU,120,12,1610612745,HOU,Houston Rockets,HOU @ BKN,108,-12,Regular Season
22020,1610612759,SAS,San Antonio Spurs,0022000735,2021-04-01T00:00:00Z,SAS vs. ATL,129,-5,1610612737,ATL,Atlanta Hawks,ATL @ SAS,134,5,Regular Season
22020,1610612765,DET,Detroit Pistons,0022000179,2021-04-01T00:00:00Z,DET vs. WAS,120,29,1610612764,WAS,Washington Wizards,WAS @ DET,91,-29,Regular Season
22020,1610612751,BKN,Brooklyn Nets,0022000732,2021-04-01T00:00:00Z,BKN vs. CHA,111,22,1610612766,CHA,Charlotte Hornets,CHA @ BKN,89,-22,Regular Season
22020,1610612748,MIA,Miami Heat,0022000733,2021-04-01T00:00:00Z,MIA vs. GSW,116,7,1610612744,GSW,Golden State Warriors,GSW @ MIA,109,-7,Regular Season
22020,1610612740,NOP,New Orleans Pelicans,0022000734,2021-04-01T00:00:00Z,NOP vs. ORL,110,-5,1610612753,ORL,Orlando Magic,ORL @ NOP,115,5,Regular Season
22020,1610612739,CLE,Cleveland Cavaliers,0022000731,2021-04-01T00:00:00Z,CLE vs. PHI,94,-20,1610612755,PHI,Philadelphia 76ers,PHI @ CLE,114,20,Regular Season
22020,1610612746,LAC,LA Clippers,0022000736,2021-04-01T00:00:00Z,LAC vs. DEN,94,-7,1610612743,DEN,Denver Nuggets,DEN @ LAC,101,7,Regular Season
22020,1610612740,NOP,New Orleans Pelicans,0022000742,2021-04-02T00:00:00Z,NOP vs. ATL,103,-23,1610612737,ATL,Atlanta Hawks,ATL @ NOP,126,23,Regular Season
22020,1610612761,TOR,Toronto Raptors,0022000737,2021-04-02T00:00:00Z,TOR vs. GSW,130,53,1610612744,GSW,Golden State Warriors,GSW @ TOR,77,-53,Regular Season
22020,1610612754,IND,Indiana Pacers,0022000740,2021-04-02T00:00:00Z,IND vs. CHA,97,-17,1610612766,CHA,Charlotte Hornets,CHA @ IND,114,17,Regular Season
22020,1610612756,PHX,Phoenix Suns,0022000744,2021-04-02T00:00:00Z,PHX vs. OKC,140,37,1610612760,OKC,Oklahoma City Thunder,OKC @ PHX,103,-37,Regular Season
22020,1610612763,MEM,Memphis Grizzlies,0022000741,2021-04-02T00:00:00Z,MEM vs. MIN,120,12,1610612750,MIN,Minnesota Timberwolves,MIN @ MEM,108,-12,Regular Season
22020,1610612758,SAC,Sacramento Kings,0022000746,2021-04-02T00:00:00Z,SAC vs. LAL,94,-21,1610612747,LAL,Los Angeles Lakers,LAL @ SAC,115,21,Regular Season
22020,1610612757,POR,Portland Trail Blazers,0022000745,2021-04-02T00:00:00Z,POR vs. MIL,109,-18,1610612749,MIL,Milwaukee Bucks,MIL @ POR,127,18,Regular Season
22020,1610612738,BOS,Boston Celtics,0022000738,2021-04-02T00:00:00Z,BOS vs. HOU,118,16,1610612745,HOU,Houston Rockets,HOU @ BOS,102,-16,Regular Season
22020,1610612762,UTA,Utah Jazz,0022000743,2021-04-02T00:00:00Z,UTA vs. CHI,113,7,1610612741,CHI,Chicago Bulls,CHI @ UTA,106,-7,Regular Season
22020,1610612752,NYK,New York Knicks,0022000739,2021-04-02T00:00:00Z,NYK vs. DAL,86,-13,1610612742,DAL,Dallas Mavericks,DAL @ NYK,99,13,Regular Season
22020,1610612765,DET,Detroit Pistons,0022000748,2021-04-03T00:00:00Z,DET vs. NYK,81,-44,1610612752,NYK,New York Knicks,NYK @ DET,125,44,Regular Season
22020,1610612764,WAS,Washington Wizards,0022000747,2021-04-03T00:00:00Z,WAS vs. DAL,87,-22,1610612742,DAL,Dallas Mavericks,DAL @ WAS,109,22,Regular Season
22020,1610612758,SAC,Sacramento Kings,0022000754,2021-04-03T00:00:00Z,SAC vs. MIL,128,-1,1610612749,MIL,Milwaukee Bucks,MIL @ SAC,129,1,Regular Season
22020,1610612757,POR,Portland Trail Blazers,0022000753,2021-04-03T00:00:00Z,POR vs. OKC,133,48,1610612760,OKC,Oklahoma City Thunder,OKC @ POR,85,-48,Regular Season
22020,1610612748,MIA,Miami Heat,0022000749,2021-04-03T00:00:00Z,MIA vs. CLE,115,14,1610612739,CLE,Cleveland Cavaliers,CLE @ MIA,101,-14,Regular Season
22020,1610612759,SAS,San Antonio Spurs,0022000751,2021-04-03T00:00:00Z,SAS vs. IND,133,-6,1610612754,IND,Indiana Pacers,IND @ SAS,139,6,Regular Season
22020,1610612762,UTA,Utah Jazz,0022000752,2021-04-03T00:00:00Z,UTA vs. ORL,137,46,1610612753,ORL,Orlando Magic,ORL @ UTA,91,-46,Regular Season
22020,1610612755,PHI,Philadelphia 76ers,0022000750,2021-04-03T00:00:00Z,PHI vs. MIN,122,9,1610612750,MIN,Minnesota Timberwolves,MIN @ PHI,113,-9,Regular Season
22020,1610612737,ATL,Atlanta Hawks,0022000759,2021-04-04T00:00:00Z,ATL vs. GSW,117,6,1610612744,GSW,Golden State Warriors,GSW @ ATL,111,-6,Regular Season
22020,1610612738,BOS,Boston Celtics,0022000757,2021-04-04T00:00:00Z,BOS vs. CHA,116,30,1610612766,CHA,Charlotte Hornets,CHA @ BOS,86,-30,Regular Season
22020,1610612741,CHI,Chicago Bulls,0022000755,2021-04-04T00:00:00Z,CHI vs. BKN,115,8,1610612751,BKN,Brooklyn Nets,BKN @ CHI,107,-8,Regular Season
22020,1610612745,HOU,Houston Rockets,0022000760,2021-04-04T00:00:00Z,HOU vs. NOP,115,-7,1610612740,NOP,New Orleans Pelicans,NOP @ HOU,122,7,Regular Season
22020,1610612755,PHI,Philadelphia 76ers,0022000758,2021-04-04T00:00:00Z,PHI vs. MEM,100,-16,1610612763,MEM,Memphis Grizzlies,MEM @ PHI,116,16,Regular Season
22020,1610612743,DEN,Denver Nuggets,0022000761,2021-04-04T00:00:00Z,DEN vs. ORL,119,10,1610612753,ORL,Orlando Magic,ORL @ DEN,109,-10,Regular Season
22020,1610612746,LAC,LA Clippers,0022000756,2021-04-04T00:00:00Z,LAC vs. LAL,104,18,1610612747,LAL,Los Angeles Lakers,LAL @ LAC,86,-18,Regular Season
22020,1610612761,TOR,Toronto Raptors,0022000763,2021-04-05T00:00:00Z,TOR vs. WAS,103,2,1610612764,WAS,Washington Wizards,WAS @ TOR,101,-2,Regular Season
22020,1610612760,OKC,Oklahoma City Thunder,0022000766,2021-04-05T00:00:00Z,OKC vs. DET,108,-24,1610612765,DET,Detroit Pistons,DET @ OKC,132,24,Regular Season
22020,1610612750,MIN,Minnesota Timberwolves,0022000765,2021-04-05T00:00:00Z,MIN vs. SAC,116,10,1610612758,SAC,Sacramento Kings,SAC @ MIN,106,-10,Regular Season
22020,1610612745,HOU,Houston Rockets,0022000768,2021-04-05T00:00:00Z,HOU vs. PHX,130,-3,1610612756,PHX,Phoenix Suns,PHX @ HOU,133,3,Regular Season
22020,1610612751,BKN,Brooklyn Nets,0022000762,2021-04-05T00:00:00Z,BKN vs. NYK,114,2,1610612752,NYK,New York Knicks,NYK @ BKN,112,-2,Regular Season
22020,1610612742,DAL,Dallas Mavericks,0022000764,2021-04-05T00:00:00Z,DAL vs. UTA,111,8,1610612762,UTA,Utah Jazz,UTA @ DAL,103,-8,Regular Season
22020,1610612759,SAS,San Antonio Spurs,0022000767,2021-04-05T00:00:00Z,SAS vs. CLE,101,-24,1610612739,CLE,Cleveland Cavaliers,CLE @ SAS,125,24,Regular Season
22020,1610612748,MIA,Miami Heat,0022000773,2021-04-06T00:00:00Z,MIA vs. MEM,112,-12,1610612763,MEM,Memphis Grizzlies,MEM @ MIA,124,12,Regular Season
22020,1610612754,IND,Indiana Pacers,0022000769,2021-04-06T00:00:00Z,IND vs. CHI,97,-16,1610612741,CHI,Chicago Bulls,CHI @ IND,113,16,Regular Season
22020,1610612746,LAC,LA Clippers,0022000775,2021-04-06T00:00:00Z,LAC vs. POR,133,17,1610612757,POR,Portland Trail Blazers,POR @ LAC,116,-17,Regular Season
22020,1610612761,TOR,Toronto Raptors,0022000772,2021-04-06T00:00:00Z,TOR vs. LAL,101,-9,1610612747,LAL,Los Angeles Lakers,LAL @ TOR,110,9,Regular Season
22020,1610612743,DEN,Denver Nuggets,0022000321,2021-04-06T00:00:00Z,DEN vs. DET,134,15,1610612765,DET,Detroit Pistons,DET @ DEN,119,-15,Regular Season
22020,1610612738,BOS,Boston Celtics,0022000771,2021-04-06T00:00:00Z,BOS vs. PHI,96,-10,1610612755,PHI,Philadelphia 76ers,PHI @ BOS,106,10,Regular Season
22020,1610612737,ATL,Atlanta Hawks,0022000770,2021-04-06T00:00:00Z,ATL vs. NOP,123,16,1610612740,NOP,New Orleans Pelicans,NOP @ ATL,107,-16,Regular Season
22020,1610612744,GSW,Golden State Warriors,0022000774,2021-04-06T00:00:00Z,GSW vs. MIL,122,1,1610612749,MIL,Milwaukee Bucks,MIL @ GSW,121,-1,Regular Season
22020,1610612738,BOS,Boston Celtics,0022000778,2021-04-07T00:00:00Z,BOS vs. NYK,101,2,1610612752,NYK,New York Knicks,NYK @ BOS,99,-2,Regular Season
22020,1610612737,ATL,Atlanta Hawks,0022000780,2021-04-07T00:00:00Z,ATL vs. MEM,113,-18,1610612763,MEM,Memphis Grizzlies,MEM @ ATL,131,18,Regular Season
22020,1610612745,HOU,Houston Rockets,0022000456,2021-04-07T00:00:00Z,HOU vs. DAL,102,9,1610612742,DAL,Dallas Mavericks,DAL @ HOU,93,-9,Regular Season
22020,1610612756,PHX,Phoenix Suns,0022000783,2021-04-07T00:00:00Z,PHX vs. UTA,117,4,1610612762,UTA,Utah Jazz,UTA @ PHX,113,-4,Regular Season
22020,1610612743,DEN,Denver Nuggets,0022000782,2021-04-07T00:00:00Z,DEN vs. SAS,106,10,1610612759,SAS,San Antonio Spurs,SAS @ DEN,96,-10,Regular Season
22020,1610612754,IND,Indiana Pacers,0022000776,2021-04-07T00:00:00Z,IND vs. MIN,141,4,1610612750,MIN,Minnesota Timberwolves,MIN @ IND,137,-4,Regular Season
22020,1610612760,OKC,Oklahoma City Thunder,0022000781,2021-04-07T00:00:00Z,OKC vs. CHA,102,-11,1610612766,CHA,Charlotte Hornets,CHA @ OKC,113,11,Regular Season
22020,1610612753,ORL,Orlando Magic,0022000777,2021-04-07T00:00:00Z,ORL vs. WAS,116,-15,1610612764,WAS,Washington Wizards,WAS @ ORL,131,15,Regular Season
22020,1610612751,BKN,Brooklyn Nets,0022000779,2021-04-07T00:00:00Z,BKN vs. NOP,139,28,1610612740,NOP,New Orleans Pelicans,NOP @ BKN,111,-28,Regular Season
22020,1610612748,MIA,Miami Heat,0022000784,2021-04-08T00:00:00Z,MIA vs. LAL,110,6,1610612747,LAL,Los Angeles Lakers,LAL @ MIA,104,-6,Regular Season
22020,1610612758,SAC,Sacramento Kings,0022000789,2021-04-08T00:00:00Z,SAC vs. DET,101,-12,1610612765,DET,Detroit Pistons,DET @ SAC,113,12,Regular Season
22020,1610612742,DAL,Dallas Mavericks,0022000786,2021-04-08T00:00:00Z,DAL vs. MIL,116,15,1610612749,MIL,Milwaukee Bucks,MIL @ DAL,101,-15,Regular Season
22020,1610612746,LAC,LA Clippers,0022000788,2021-04-08T00:00:00Z,LAC vs. PHX,113,10,1610612756,PHX,Phoenix Suns,PHX @ LAC,103,-10,Regular Season
22020,1610612762,UTA,Utah Jazz,0022000787,2021-04-08T00:00:00Z,UTA vs. POR,122,19,1610612757,POR,Portland Trail Blazers,POR @ UTA,103,-19,Regular Season
22020,1610612761,TOR,Toronto Raptors,0022000523,2021-04-08T00:00:00Z,TOR vs. CHI,113,-9,1610612741,CHI,Chicago Bulls,CHI @ TOR,122,9,Regular Season
22020,1610612760,OKC,Oklahoma City Thunder,0022000785,2021-04-08T00:00:00Z,OKC vs. CLE,102,-27,1610612739,CLE,Cleveland Cavaliers,CLE @ OKC,129,27,Regular Season
22020,1610612743,DEN,Denver Nuggets,0022000797,2021-04-09T00:00:00Z,DEN vs. SAS,121,2,1610612759,SAS,San Antonio Spurs,SAS @ DEN,119,-2,Regular Season
22020,1610612749,MIL,Milwaukee Bucks,0022000796,2021-04-09T00:00:00Z,MIL vs. CHA,119,-8,1610612766,CHA,Charlotte Hornets,CHA @ MIL,127,8,Regular Season
22020,1610612738,BOS,Boston Celtics,0022000792,2021-04-09T00:00:00Z,BOS vs. MIN,145,9,1610612750,MIN,Minnesota Timberwolves,MIN @ BOS,136,-9,Regular Season
22020,1610612740,NOP,New Orleans Pelicans,0022000795,2021-04-09T00:00:00Z,NOP vs. PHI,101,7,1610612755,PHI,Philadelphia 76ers,PHI @ NOP,94,-7,Regular Season
22020,1610612744,GSW,Golden State Warriors,0022000798,2021-04-09T00:00:00Z,GSW vs. WAS,107,-3,1610612764,WAS,Washington Wizards,WAS @ GSW,110,3,Regular Season
22020,1610612746,LAC,LA Clippers,0022000799,2021-04-09T00:00:00Z,LAC vs. HOU,126,17,1610612745,HOU,Houston Rockets,HOU @ LAC,109,-17,Regular Season
22020,1610612753,ORL,Orlando Magic,0022000790,2021-04-09T00:00:00Z,ORL vs. IND,106,-5,1610612754,IND,Indiana Pacers,IND @ ORL,111,5,Regular Season
22020,1610612752,NYK,New York Knicks,0022000793,2021-04-09T00:00:00Z,NYK vs. MEM,133,4,1610612763,MEM,Memphis Grizzlies,MEM @ NYK,129,-4,Regular Season
22020,1610612737,ATL,Atlanta Hawks,0022000791,2021-04-09T00:00:00Z,ATL vs. CHI,120,12,1610612741,CHI,Chicago Bulls,CHI @ ATL,108,-12,Regular Season
22020,1610612756,PHX,Phoenix Suns,0022000803,2021-04-10T00:00:00Z,PHX vs. WAS,134,28,1610612764,WAS,Washington Wizards,WAS @ PHX,106,-28,Regular Season
22020,1610612751,BKN,Brooklyn Nets,0022000800,2021-04-10T00:00:00Z,BKN vs. LAL,101,-25,1610612747,LAL,Los Angeles Lakers,LAL @ BKN,126,25,Regular Season
22020,1610612757,POR,Portland Trail Blazers,0022000804,2021-04-10T00:00:00Z,POR vs. DET,118,15,1610612765,DET,Detroit Pistons,DET @ POR,103,-15,Regular Season
22020,1610612760,OKC,Oklahoma City Thunder,0022000199,2021-04-10T00:00:00Z,OKC vs. PHI,93,-24,1610612755,PHI,Philadelphia 76ers,PHI @ OKC,117,24,Regular Season
22020,1610612744,GSW,Golden State Warriors,0022000802,2021-04-10T00:00:00Z,GSW vs. HOU,125,16,1610612745,HOU,Houston Rockets,HOU @ GSW,109,-16,Regular Season
22020,1610612762,UTA,Utah Jazz,0022000801,2021-04-10T00:00:00Z,UTA vs. SAC,128,16,1610612758,SAC,Sacramento Kings,SAC @ UTA,112,-16,Regular Season
22020,1610612739,CLE,Cleveland Cavaliers,0022000794,2021-04-10T00:00:00Z,CLE vs. TOR,115,-20,1610612761,TOR,Toronto Raptors,TOR @ CLE,135,20,Regular Season
22020,1610612757,POR,Portland Trail Blazers,0022000814,2021-04-11T00:00:00Z,POR vs. MIA,98,-9,1610612748,MIA,Miami Heat,MIA @ POR,107,9,Regular Season
22020,1610612750,MIN,Minnesota Timberwolves,0022000812,2021-04-11T00:00:00Z,MIN vs. CHI,121,4,1610612741,CHI,Chicago Bulls,CHI @ MIN,117,-4,Regular Season
22020,1610612763,MEM,Memphis Grizzlies,0022000811,2021-04-11T00:00:00Z,MEM vs. IND,125,-7,1610612754,IND,Indiana Pacers,IND @ MEM,132,7,Regular Season
22020,1610612753,ORL,Orlando Magic,0022000808,2021-04-11T00:00:00Z,ORL vs. MIL,87,-37,1610612749,MIL,Milwaukee Bucks,MIL @ ORL,124,37,Regular Season
22020,1610612746,LAC,LA Clippers,0022000813,2021-04-11T00:00:00Z,LAC vs. DET,131,7,1610612765,DET,Detroit Pistons,DET @ LAC,124,-7,Regular Season
22020,1610612766,CHA,Charlotte Hornets,0022000805,2021-04-11T00:00:00Z,CHA vs. ATL,101,-4,1610612737,ATL,Atlanta Hawks,ATL @ CHA,105,4,Regular Season
22020,1610612752,NYK,New York Knicks,0022000809,2021-04-11T00:00:00Z,NYK vs. TOR,102,6,1610612761,TOR,Toronto Raptors,TOR @ NYK,96,-6,Regular Season
22020,1610612743,DEN,Denver Nuggets,0022000806,2021-04-11T00:00:00Z,DEN vs. BOS,87,-18,1610612738,BOS,Boston Celtics,BOS @ DEN,105,18,Regular Season
22020,1610612742,DAL,Dallas Mavericks,0022000810,2021-04-11T00:00:00Z,DAL vs. SAS,117,-2,1610612759,SAS,San Antonio Spurs,SAS @ DAL,119,2,Regular Season
22020,1610612739,CLE,Cleveland Cavaliers,0022000807,2021-04-11T00:00:00Z,CLE vs. NOP,109,-7,1610612740,NOP,New Orleans Pelicans,NOP @ CLE,116,7,Regular Season
22020,1610612763,MEM,Memphis Grizzlies,0022000278,2021-04-12T00:00:00Z,MEM vs. CHI,101,11,1610612741,CHI,Chicago Bulls,CHI @ MEM,90,-11,Regular Season
22020,1610612740,NOP,New Orleans Pelicans,0022000819,2021-04-12T00:00:00Z,NOP vs. SAC,117,7,1610612758,SAC,Sacramento Kings,SAC @ NOP,110,-7,Regular Season
22020,1610612742,DAL,Dallas Mavericks,0022000818,2021-04-12T00:00:00Z,DAL vs. PHI,95,-18,1610612755,PHI,Philadelphia 76ers,PHI @ DAL,113,18,Regular Season
22020,1610612753,ORL,Orlando Magic,0022000816,2021-04-12T00:00:00Z,ORL vs. SAS,97,-23,1610612759,SAS,San Antonio Spurs,SAS @ ORL,120,23,Regular Season
22020,1610612756,PHX,Phoenix Suns,0022000822,2021-04-12T00:00:00Z,PHX vs. HOU,126,6,1610612745,HOU,Houston Rockets,HOU @ PHX,120,-6,Regular Season
22020,1610612762,UTA,Utah Jazz,0022000820,2021-04-12T00:00:00Z,UTA vs. WAS,121,-4,1610612764,WAS,Washington Wizards,WAS @ UTA,125,4,Regular Season
22020,1610612752,NYK,New York Knicks,0022000815,2021-04-12T00:00:00Z,NYK vs. LAL,111,15,1610612747,LAL,Los Angeles Lakers,LAL @ NYK,96,-15,Regular Season
22020,1610612744,GSW,Golden State Warriors,0022000821,2021-04-12T00:00:00Z,GSW vs. DEN,116,9,1610612743,DEN,Denver Nuggets,DEN @ GSW,107,-9,Regular Season
22020,1610612761,TOR,Toronto Raptors,0022000824,2021-04-13T00:00:00Z,TOR vs. ATL,103,-5,1610612737,ATL,Atlanta Hawks,ATL @ TOR,108,5,Regular Season
22020,1610612762,UTA,Utah Jazz,0022000826,2021-04-13T00:00:00Z,UTA vs. OKC,106,10,1610612760,OKC,Oklahoma City Thunder,OKC @ UTA,96,-10,Regular Season
22020,1610612757,POR,Portland Trail Blazers,0022000828,2021-04-13T00:00:00Z,POR vs. BOS,115,-1,1610612738,BOS,Boston Celtics,BOS @ POR,116,1,Regular Season
22020,1610612756,PHX,Phoenix Suns,0022000827,2021-04-13T00:00:00Z,PHX vs. MIA,106,20,1610612748,MIA,Miami Heat,MIA @ PHX,86,-20,Regular Season
22020,1610612750,MIN,Minnesota Timberwolves,0022000817,2021-04-13T00:00:00Z,MIN vs. BKN,97,-30,1610612751,BKN,Brooklyn Nets,BKN @ MIN,127,30,Regular Season
22020,1610612766,CHA,Charlotte Hornets,0022000825,2021-04-13T00:00:00Z,CHA vs. LAL,93,-8,1610612747,LAL,Los Angeles Lakers,LAL @ CHA,101,8,Regular Season
22020,1610612754,IND,Indiana Pacers,0022000823,2021-04-13T00:00:00Z,IND vs. LAC,115,-11,1610612746,LAC,LA Clippers,LAC @ IND,126,11,Regular Season
22020,1610612763,MEM,Memphis Grizzlies,0022000837,2021-04-14T00:00:00Z,MEM vs. DAL,113,-1,1610612742,DAL,Dallas Mavericks,DAL @ MEM,114,1,Regular Season
22020,1610612760,OKC,Oklahoma City Thunder,0022000836,2021-04-14T00:00:00Z,OKC vs. GSW,109,-38,1610612744,GSW,Golden State Warriors,GSW @ OKC,147,38,Regular Season
22020,1610612765,DET,Detroit Pistons,0022000832,2021-04-14T00:00:00Z,DET vs. LAC,98,-2,1610612746,LAC,LA Clippers,LAC @ DET,100,2,Regular Season
22020,1610612761,TOR,Toronto Raptors,0022000831,2021-04-14T00:00:00Z,TOR vs. SAS,117,5,1610612759,SAS,San Antonio Spurs,SAS @ TOR,112,-5,Regular Season
22020,1610612741,CHI,Chicago Bulls,0022000833,2021-04-14T00:00:00Z,CHI vs. ORL,106,-9,1610612753,ORL,Orlando Magic,ORL @ CHI,115,9,Regular Season
22020,1610612755,PHI,Philadelphia 76ers,0022000830,2021-04-14T00:00:00Z,PHI vs. BKN,123,6,1610612751,BKN,Brooklyn Nets,BKN @ PHI,117,-6,Regular Season
22020,1610612745,HOU,Houston Rockets,0022000461,2021-04-14T00:00:00Z,HOU vs. IND,124,-8,1610612754,IND,Indiana Pacers,IND @ HOU,132,8,Regular Season
22020,1610612750,MIN,Minnesota Timberwolves,0022000834,2021-04-14T00:00:00Z,MIN vs. MIL,105,-25,1610612749,MIL,Milwaukee Bucks,MIL @ MIN,130,25,Regular Season
22020,1610612758,SAC,Sacramento Kings,0022000839,2021-04-14T00:00:00Z,SAC vs. WAS,111,-12,1610612764,WAS,Washington Wizards,WAS @ SAC,123,12,Regular Season
22020,1610612766,CHA,Charlotte Hornets,0022000829,2021-04-14T00:00:00Z,CHA vs. CLE,90,-13,1610612739,CLE,Cleveland Cavaliers,CLE @ CHA,103,13,Regular Season
22020,1610612740,NOP,New Orleans Pelicans,0022000835,2021-04-14T00:00:00Z,NOP vs. NYK,106,-10,1610612752,NYK,New York Knicks,NYK @ NOP,116,10,Regular Season
22020,1610612743,DEN,Denver Nuggets,0022000838,2021-04-14T00:00:00Z,DEN vs. MIA,123,17,1610612748,MIA,Miami Heat,MIA @ DEN,106,-17,Regular Season
22020,1610612737,ATL,Atlanta Hawks,0022000840,2021-04-15T00:00:00Z,ATL vs. MIL,109,-11,1610612749,MIL,Milwaukee Bucks,MIL @ ATL,120,11,Regular Season
22020,1610612756,PHX,Phoenix Suns,0022000843,2021-04-15T00:00:00Z,PHX vs. SAC,122,8,1610612758,SAC,Sacramento Kings,SAC @ PHX,114,-8,Regular Season
22020,1610612739,CLE,Cleveland Cavaliers,0022000841,2021-04-15T00:00:00Z,CLE vs. GSW,101,-18,1610612744,GSW,Golden State Warriors,GSW @ CLE,119,18,Regular Season
22020,1610612747,LAL,Los Angeles Lakers,0022000842,2021-04-15T00:00:00Z,LAL vs. BOS,113,-8,1610612738,BOS,Boston Celtics,BOS @ LAL,121,8,Regular Season
22020,1610612742,DAL,Dallas Mavericks,0022000854,2021-04-16T00:00:00Z,DAL vs. NYK,109,-8,1610612752,NYK,New York Knicks,NYK @ DAL,117,8,Regular Season
22020,1610612745,HOU,Houston Rockets,0022000851,2021-04-16T00:00:00Z,HOU vs. DEN,99,-29,1610612743,DEN,Denver Nuggets,DEN @ HOU,128,29,Regular Season
22020,1610612755,PHI,Philadelphia 76ers,0022000846,2021-04-16T00:00:00Z,PHI vs. LAC,106,3,1610612746,LAC,LA Clippers,LAC @ PHI,103,-3,Regular Season
22020,1610612764,WAS,Washington Wizards,0022000847,2021-04-16T00:00:00Z,WAS vs. NOP,117,2,1610612740,NOP,New Orleans Pelicans,NOP @ WAS,115,-2,Regular Season
22020,1610612765,DET,Detroit Pistons,0022000845,2021-04-16T00:00:00Z,DET vs. OKC,110,6,1610612760,OKC,Oklahoma City Thunder,OKC @ DET,104,-6,Regular Season
22020,1610612750,MIN,Minnesota Timberwolves,0022000852,2021-04-16T00:00:00Z,MIN vs. MIA,119,8,1610612748,MIA,Miami Heat,MIA @ MIN,111,-8,Regular Season
22020,1610612751,BKN,Brooklyn Nets,0022000848,2021-04-16T00:00:00Z,BKN vs. CHA,130,15,1610612766,CHA,Charlotte Hornets,CHA @ BKN,115,-15,Regular Season
22020,1610612759,SAS,San Antonio Spurs,0022000853,2021-04-16T00:00:00Z,SAS vs. POR,106,-1,1610612757,POR,Portland Trail Blazers,POR @ SAS,107,1,Regular Season
22020,1610612741,CHI,Chicago Bulls,0022000850,2021-04-16T00:00:00Z,CHI vs. MEM,115,-11,1610612763,MEM,Memphis Grizzlies,MEM @ CHI,126,11,Regular Season
22020,1610612761,TOR,Toronto Raptors,0022000849,2021-04-16T00:00:00Z,TOR vs. ORL,113,11,1610612753,ORL,Orlando Magic,ORL @ TOR,102,-11,Regular Season
22020,1610612762,UTA,Utah Jazz,0022000844,2021-04-16T00:00:00Z,UTA vs. IND,119,8,1610612754,IND,Indiana Pacers,IND @ UTA,111,-8,Regular Season
22020,1610612738,BOS,Boston Celtics,0022000858,2021-04-17T00:00:00Z,BOS vs. GSW,119,5,1610612744,GSW,Golden State Warriors,GSW @ BOS,114,-5,Regular Season
22020,1610612749,MIL,Milwaukee Bucks,0022000859,2021-04-17T00:00:00Z,MIL vs. MEM,115,-13,1610612763,MEM,Memphis Grizzlies,MEM @ MIL,128,13,Regular Season
22020,1610612764,WAS,Washington Wizards,0022000856,2021-04-17T00:00:00Z,WAS vs. DET,121,21,1610612765,DET,Detroit Pistons,DET @ WAS,100,-21,Regular Season
22020,1610612747,LAL,Los Angeles Lakers,0022000855,2021-04-17T00:00:00Z,LAL vs. UTA,127,12,1610612762,UTA,Utah Jazz,UTA @ LAL,115,-12,Regular Season
22020,1610612756,PHX,Phoenix Suns,0022000860,2021-04-17T00:00:00Z,PHX vs. SAS,85,-26,1610612759,SAS,San Antonio Spurs,SAS @ PHX,111,26,Regular Season
22020,1610612741,CHI,Chicago Bulls,0022000857,2021-04-17T00:00:00Z,CHI vs. CLE,106,10,1610612739,CLE,Cleveland Cavaliers,CLE @ CHI,96,-10,Regular Season
22020,1610612752,NYK,New York Knicks,0022000862,2021-04-18T00:00:00Z,NYK vs. NOP,122,10,1610612740,NOP,New Orleans Pelicans,NOP @ NYK,112,-10,Regular Season
22020,1610612766,CHA,Charlotte Hornets,0022000362,2021-04-18T00:00:00Z,CHA vs. POR,109,8,1610612757,POR,Portland Trail Blazers,POR @ CHA,101,-8,Regular Season
22020,1610612748,MIA,Miami Heat,0022000863,2021-04-18T00:00:00Z,MIA vs. BKN,109,2,1610612751,BKN,Brooklyn Nets,BKN @ MIA,107,-2,Regular Season
22020,1610612753,ORL,Orlando Magic,0022000864,2021-04-18T00:00:00Z,ORL vs. HOU,110,-4,1610612745,HOU,Houston Rockets,HOU @ ORL,114,4,Regular Season
22020,1610612742,DAL,Dallas Mavericks,0022000866,2021-04-18T00:00:00Z,DAL vs. SAC,107,-14,1610612758,SAC,Sacramento Kings,SAC @ DAL,121,14,Regular Season
22020,1610612737,ATL,Atlanta Hawks,0022000861,2021-04-18T00:00:00Z,ATL vs. IND,129,12,1610612754,IND,Indiana Pacers,IND @ ATL,117,-12,Regular Season
22020,1610612746,LAC,LA Clippers,0022000867,2021-04-18T00:00:00Z,LAC vs. MIN,124,19,1610612750,MIN,Minnesota Timberwolves,MIN @ LAC,105,-19,Regular Season
22020,1610612761,TOR,Toronto Raptors,0022000865,2021-04-18T00:00:00Z,TOR vs. OKC,112,6,1610612760,OKC,Oklahoma City Thunder,OKC @ TOR,106,-6,Regular Season
22020,1610612755,PHI,Philadelphia 76ers,0022000870,2021-04-19T00:00:00Z,PHI vs. GSW,96,-11,1610612744,GSW,Golden State Warriors,GSW @ PHI,107,11,Regular Season
22020,1610612749,MIL,Milwaukee Bucks,0022000873,2021-04-19T00:00:00Z,MIL vs. PHX,127,-1,1610612756,PHX,Phoenix Suns,PHX @ MIL,128,1,Regular Season
22020,1610612754,IND,Indiana Pacers,0022000473,2021-04-19T00:00:00Z,IND vs. SAS,94,-15,1610612759,SAS,San Antonio Spurs,SAS @ IND,109,15,Regular Season
22020,1610612743,DEN,Denver Nuggets,0022000874,2021-04-19T00:00:00Z,DEN vs. MEM,139,2,1610612763,MEM,Memphis Grizzlies,MEM @ DEN,137,-2,Regular Season
22020,1610612764,WAS,Washington Wizards,0022000872,2021-04-19T00:00:00Z,WAS vs. OKC,119,12,1610612760,OKC,Oklahoma City Thunder,OKC @ WAS,107,-12,Regular Season
22020,1610612765,DET,Detroit Pistons,0022000868,2021-04-19T00:00:00Z,DET vs. CLE,109,4,1610612739,CLE,Cleveland Cavaliers,CLE @ DET,105,-4,Regular Season
22020,1610612748,MIA,Miami Heat,0022000871,2021-04-19T00:00:00Z,MIA vs. HOU,113,22,1610612745,HOU,Houston Rockets,HOU @ MIA,91,-22,Regular Season
22020,1610612747,LAL,Los Angeles Lakers,0022000875,2021-04-19T00:00:00Z,LAL vs. UTA,97,-14,1610612762,UTA,Utah Jazz,UTA @ LAL,111,14,Regular Season
22020,1610612738,BOS,Boston Celtics,0022000869,2021-04-19T00:00:00Z,BOS vs. CHI,96,-6,1610612741,CHI,Chicago Bulls,CHI @ BOS,102,6,Regular Season
22020,1610612758,SAC,Sacramento Kings,0022000880,2021-04-20T00:00:00Z,SAC vs. MIN,120,-14,1610612750,MIN,Minnesota Timberwolves,MIN @ SAC,134,14,Regular Season
22020,1610612757,POR,Portland Trail Blazers,0022000879,2021-04-20T00:00:00Z,POR vs. LAC,112,-1,1610612746,LAC,LA Clippers,LAC @ POR,113,1,Regular Season
22020,1610612752,NYK,New York Knicks,0022000877,2021-04-20T00:00:00Z,NYK vs. CHA,109,12,1610612766,CHA,Charlotte Hornets,CHA @ NYK,97,-12,Regular Season
22020,1610612740,NOP,New Orleans Pelicans,0022000878,2021-04-20T00:00:00Z,NOP vs. BKN,129,-5,1610612751,BKN,Brooklyn Nets,BKN @ NOP,134,5,Regular Season
22020,1610612737,ATL,Atlanta Hawks,0022000876,2021-04-20T00:00:00Z,ATL vs. ORL,112,16,1610612753,ORL,Orlando Magic,ORL @ ATL,96,-16,Regular Season
22020,1610612759,SAS,San Antonio Spurs,0022000888,2021-04-21T00:00:00Z,SAS vs. MIA,87,-20,1610612748,MIA,Miami Heat,MIA @ SAS,107,20,Regular Season
22020,1610612761,TOR,Toronto Raptors,0022000884,2021-04-21T00:00:00Z,TOR vs. BKN,114,11,1610612751,BKN,Brooklyn Nets,BKN @ TOR,103,-11,Regular Season
22020,1610612739,CLE,Cleveland Cavaliers,0022000881,2021-04-21T00:00:00Z,CLE vs. CHI,121,16,1610612741,CHI,Chicago Bulls,CHI @ CLE,105,-16,Regular Season
22020,1610612742,DAL,Dallas Mavericks,0022000442,2021-04-21T00:00:00Z,DAL vs. DET,127,10,1610612765,DET,Detroit Pistons,DET @ DAL,117,-10,Regular Season
22020,1610612745,HOU,Houston Rockets,0022000887,2021-04-21T00:00:00Z,HOU vs. UTA,89,-23,1610612762,UTA,Utah Jazz,UTA @ HOU,112,23,Regular Season
22020,1610612764,WAS,Washington Wizards,0022000885,2021-04-21T00:00:00Z,WAS vs. GSW,118,4,1610612744,GSW,Golden State Warriors,GSW @ WAS,114,-4,Regular Season
22020,1610612752,NYK,New York Knicks,0022000886,2021-04-21T00:00:00Z,NYK vs. ATL,137,10,1610612737,ATL,Atlanta Hawks,ATL @ NYK,127,-10,Regular Season
22020,1610612758,SAC,Sacramento Kings,0022000891,2021-04-21T00:00:00Z,SAC vs. MIN,128,3,1610612750,MIN,Minnesota Timberwolves,MIN @ SAC,125,-3,Regular Season
22020,1610612746,LAC,LA Clippers,0022000889,2021-04-21T00:00:00Z,LAC vs. MEM,117,12,1610612763,MEM,Memphis Grizzlies,MEM @ LAC,105,-12,Regular Season
22020,1610612757,POR,Portland Trail Blazers,0022000890,2021-04-21T00:00:00Z,POR vs. DEN,105,-1,1610612743,DEN,Denver Nuggets,DEN @ POR,106,1,Regular Season
22020,1610612755,PHI,Philadelphia 76ers,0022000883,2021-04-21T00:00:00Z,PHI vs. PHX,113,-3,1610612756,PHX,Phoenix Suns,PHX @ PHI,116,3,Regular Season
22020,1610612754,IND,Indiana Pacers,0022000882,2021-04-21T00:00:00Z,IND vs. OKC,122,6,1610612760,OKC,Oklahoma City Thunder,OKC @ IND,116,-6,Regular Season
22020,1610612742,DAL,Dallas Mavericks,0022000897,2021-04-22T00:00:00Z,DAL vs. LAL,115,5,1610612747,LAL,Los Angeles Lakers,LAL @ DAL,110,-5,Regular Season
22020,1610612741,CHI,Chicago Bulls,0022000896,2021-04-22T00:00:00Z,CHI vs. CHA,108,17,1610612766,CHA,Charlotte Hornets,CHA @ CHI,91,-17,Regular Season
22020,1610612738,BOS,Boston Celtics,0022000892,2021-04-22T00:00:00Z,BOS vs. PHX,99,13,1610612756,PHX,Phoenix Suns,PHX @ BOS,86,-13,Regular Season
22020,1610612759,SAS,San Antonio Spurs,0022000895,2021-04-22T00:00:00Z,SAS vs. DET,106,15,1610612765,DET,Detroit Pistons,DET @ SAS,91,-15,Regular Season
22020,1610612753,ORL,Orlando Magic,0022000893,2021-04-22T00:00:00Z,ORL vs. NOP,100,-35,1610612740,NOP,New Orleans Pelicans,NOP @ ORL,135,35,Regular Season
22020,1610612749,MIL,Milwaukee Bucks,0022000894,2021-04-22T00:00:00Z,MIL vs. PHI,124,7,1610612755,PHI,Philadelphia 76ers,PHI @ MIL,117,-7,Regular Season
22020,1610612737,ATL,Atlanta Hawks,0022000898,2021-04-23T00:00:00Z,ATL vs. MIA,118,15,1610612748,MIA,Miami Heat,MIA @ ATL,103,-15,Regular Season
22020,1610612745,HOU,Houston Rockets,0022000901,2021-04-23T00:00:00Z,HOU vs. LAC,104,-5,1610612746,LAC,LA Clippers,LAC @ HOU,109,5,Regular Season
22020,1610612757,POR,Portland Trail Blazers,0022000225,2021-04-23T00:00:00Z,POR vs. MEM,128,-2,1610612763,MEM,Memphis Grizzlies,MEM @ POR,130,2,Regular Season
22020,1610612760,OKC,Oklahoma City Thunder,0022000902,2021-04-23T00:00:00Z,OKC vs. WAS,109,-20,1610612764,WAS,Washington Wizards,WAS @ OKC,129,20,Regular Season
22020,1610612751,BKN,Brooklyn Nets,0022000899,2021-04-23T00:00:00Z,BKN vs. BOS,109,5,1610612738,BOS,Boston Celtics,BOS @ BKN,104,-5,Regular Season
22020,1610612744,GSW,Golden State Warriors,0022000903,2021-04-23T00:00:00Z,GSW vs. DEN,118,21,1610612743,DEN,Denver Nuggets,DEN @ GSW,97,-21,Regular Season
22020,1610612766,CHA,Charlotte Hornets,0022000900,2021-04-23T00:00:00Z,CHA vs. CLE,108,6,1610612739,CLE,Cleveland Cavaliers,CLE @ CHA,102,-6,Regular Season
22020,1610612754,IND,Indiana Pacers,0022000906,2021-04-24T00:00:00Z,IND vs. DET,115,6,1610612765,DET,Detroit Pistons,DET @ IND,109,-6,Regular Season
22020,1610612749,MIL,Milwaukee Bucks,0022000905,2021-04-24T00:00:00Z,MIL vs. PHI,132,38,1610612755,PHI,Philadelphia 76ers,PHI @ MIL,94,-38,Regular Season
22020,1610612743,DEN,Denver Nuggets,0022000910,2021-04-24T00:00:00Z,DEN vs. HOU,129,13,1610612745,HOU,Houston Rockets,HOU @ DEN,116,-13,Regular Season
22020,1610612748,MIA,Miami Heat,0022000907,2021-04-24T00:00:00Z,MIA vs. CHI,106,5,1610612741,CHI,Chicago Bulls,CHI @ MIA,101,-5,Regular Season
22020,1610612762,UTA,Utah Jazz,0022000909,2021-04-24T00:00:00Z,UTA vs. MIN,96,-5,1610612750,MIN,Minnesota Timberwolves,MIN @ UTA,101,5,Regular Season
22020,1610612752,NYK,New York Knicks,0022000904,2021-04-24T00:00:00Z,NYK vs. TOR,120,17,1610612761,TOR,Toronto Raptors,TOR @ NYK,103,-17,Regular Season
22020,1610612742,DAL,Dallas Mavericks,0022000908,2021-04-24T00:00:00Z,DAL vs. LAL,108,15,1610612747,LAL,Los Angeles Lakers,LAL @ DAL,93,-15,Regular Season
22020,1610612740,NOP,New Orleans Pelicans,0022000264,2021-04-24T00:00:00Z,NOP vs. SAS,108,-2,1610612759,SAS,San Antonio Spurs,SAS @ NOP,110,2,Regular Season
22020,1610612751,BKN,Brooklyn Nets,0022000912,2021-04-25T00:00:00Z,BKN vs. PHX,128,9,1610612756,PHX,Phoenix Suns,PHX @ BKN,119,-9,Regular Season
22020,1610612744,GSW,Golden State Warriors,0022000915,2021-04-25T00:00:00Z,GSW vs. SAC,117,4,1610612758,SAC,Sacramento Kings,SAC @ GSW,113,-4,Regular Season
22020,1610612753,ORL,Orlando Magic,0022000914,2021-04-25T00:00:00Z,ORL vs. IND,112,-19,1610612754,IND,Indiana Pacers,IND @ ORL,131,19,Regular Season
22020,1610612737,ATL,Atlanta Hawks,0022000913,2021-04-25T00:00:00Z,ATL vs. MIL,111,7,1610612749,MIL,Milwaukee Bucks,MIL @ ATL,104,-7,Regular Season
22020,1610612757,POR,Portland Trail Blazers,0022000240,2021-04-25T00:00:00Z,POR vs. MEM,113,-7,1610612763,MEM,Memphis Grizzlies,MEM @ POR,120,7,Regular Season
22020,1610612766,CHA,Charlotte Hornets,0022000911,2021-04-25T00:00:00Z,CHA vs. BOS,125,21,1610612738,BOS,Boston Celtics,BOS @ CHA,104,-21,Regular Season
22020,1610612764,WAS,Washington Wizards,0022000197,2021-04-25T00:00:00Z,WAS vs. CLE,119,9,1610612739,CLE,Cleveland Cavaliers,CLE @ WAS,110,-9,Regular Season
22020,1610612755,PHI,Philadelphia 76ers,0022000918,2021-04-26T00:00:00Z,PHI vs. OKC,121,31,1610612760,OKC,Oklahoma City Thunder,OKC @ PHI,90,-31,Regular Season
22020,1610612748,MIA,Miami Heat,0022000922,2021-04-26T00:00:00Z,MIA vs. CHI,102,-8,1610612741,CHI,Chicago Bulls,CHI @ MIA,110,8,Regular Season
22020,1610612743,DEN,Denver Nuggets,0022000925,2021-04-26T00:00:00Z,DEN vs. MEM,120,24,1610612763,MEM,Memphis Grizzlies,MEM @ DEN,96,-24,Regular Season
22020,1610612753,ORL,Orlando Magic,0022000917,2021-04-26T00:00:00Z,ORL vs. LAL,103,-11,1610612747,LAL,Los Angeles Lakers,LAL @ ORL,114,11,Regular Season
22020,1610612752,NYK,New York Knicks,0022000920,2021-04-26T00:00:00Z,NYK vs. PHX,110,-8,1610612756,PHX,Phoenix Suns,PHX @ NYK,118,8,Regular Season
22020,1610612750,MIN,Minnesota Timberwolves,0022000923,2021-04-26T00:00:00Z,MIN vs. UTA,105,1,1610612762,UTA,Utah Jazz,UTA @ MIN,104,-1,Regular Season
22020,1610612758,SAC,Sacramento Kings,0022000926,2021-04-26T00:00:00Z,SAC vs. DAL,113,7,1610612742,DAL,Dallas Mavericks,DAL @ SAC,106,-7,Regular Season
22020,1610612764,WAS,Washington Wizards,0022000919,2021-04-26T00:00:00Z,WAS vs. SAS,143,-3,1610612759,SAS,San Antonio Spurs,SAS @ WAS,146,3,Regular Season
22020,1610612765,DET,Detroit Pistons,0022000916,2021-04-26T00:00:00Z,DET vs. ATL,100,14,1610612737,ATL,Atlanta Hawks,ATL @ DET,86,-14,Regular Season
22020,1610612761,TOR,Toronto Raptors,0022000921,2021-04-26T00:00:00Z,TOR vs. CLE,112,16,1610612739,CLE,Cleveland Cavaliers,CLE @ TOR,96,-16,Regular Season
22020,1610612740,NOP,New Orleans Pelicans,0022000924,2021-04-26T00:00:00Z,NOP vs. LAC,120,17,1610612746,LAC,LA Clippers,LAC @ NOP,103,-17,Regular Season
22020,1610612744,GSW,Golden State Warriors,0022000932,2021-04-27T00:00:00Z,GSW vs. DAL,103,-30,1610612742,DAL,Dallas Mavericks,DAL @ GSW,133,30,Regular Season
22020,1610612761,TOR,Toronto Raptors,0022000930,2021-04-27T00:00:00Z,TOR vs. BKN,103,-13,1610612751,BKN,Brooklyn Nets,BKN @ TOR,116,13,Regular Season
22020,1610612745,HOU,Houston Rockets,0022000931,2021-04-27T00:00:00Z,HOU vs. MIN,107,-7,1610612750,MIN,Minnesota Timberwolves,MIN @ HOU,114,7,Regular Season
22020,1610612766,CHA,Charlotte Hornets,0022000928,2021-04-27T00:00:00Z,CHA vs. MIL,104,-10,1610612749,MIL,Milwaukee Bucks,MIL @ CHA,114,10,Regular Season
22020,1610612754,IND,Indiana Pacers,0022000929,2021-04-27T00:00:00Z,IND vs. POR,112,-21,1610612757,POR,Portland Trail Blazers,POR @ IND,133,21,Regular Season
22020,1610612738,BOS,Boston Celtics,0022000927,2021-04-27T00:00:00Z,BOS vs. OKC,115,-4,1610612760,OKC,Oklahoma City Thunder,OKC @ BOS,119,4,Regular Season
22020,1610612748,MIA,Miami Heat,0022000938,2021-04-28T00:00:00Z,MIA vs. SAS,116,5,1610612759,SAS,San Antonio Spurs,SAS @ MIA,111,-5,Regular Season
22020,1610612755,PHI,Philadelphia 76ers,0022000934,2021-04-28T00:00:00Z,PHI vs. ATL,127,44,1610612737,ATL,Atlanta Hawks,ATL @ PHI,83,-44,Regular Season
22020,1610612756,PHX,Phoenix Suns,0022000941,2021-04-28T00:00:00Z,PHX vs. LAC,109,8,1610612746,LAC,LA Clippers,LAC @ PHX,101,-8,Regular Season
22020,1610612764,WAS,Washington Wizards,0022000935,2021-04-28T00:00:00Z,WAS vs. LAL,116,9,1610612747,LAL,Los Angeles Lakers,LAL @ WAS,107,-9,Regular Season
22020,1610612738,BOS,Boston Celtics,0022000936,2021-04-28T00:00:00Z,BOS vs. CHA,120,9,1610612766,CHA,Charlotte Hornets,CHA @ BOS,111,-9,Regular Season
22020,1610612739,CLE,Cleveland Cavaliers,0022000933,2021-04-28T00:00:00Z,CLE vs. ORL,104,-5,1610612753,ORL,Orlando Magic,ORL @ CLE,109,5,Regular Season
22020,1610612763,MEM,Memphis Grizzlies,0022000939,2021-04-28T00:00:00Z,MEM vs. POR,109,-21,1610612757,POR,Portland Trail Blazers,POR @ MEM,130,21,Regular Season
22020,1610612743,DEN,Denver Nuggets,0022000940,2021-04-28T00:00:00Z,DEN vs. NOP,114,2,1610612740,NOP,New Orleans Pelicans,NOP @ DEN,112,-2,Regular Season
22020,1610612752,NYK,New York Knicks,0022000937,2021-04-28T00:00:00Z,NYK vs. CHI,113,19,1610612741,CHI,Chicago Bulls,CHI @ NYK,94,-19,Regular Season
22020,1610612758,SAC,Sacramento Kings,0022000942,2021-04-28T00:00:00Z,SAC vs. UTA,105,-49,1610612762,UTA,Utah Jazz,UTA @ SAC,154,49,Regular Season
22020,1610612743,DEN,Denver Nuggets,0022000948,2021-04-29T00:00:00Z,DEN vs. TOR,121,10,1610612761,TOR,Toronto Raptors,TOR @ DEN,111,-10,Regular Season
22020,1610612760,OKC,Oklahoma City Thunder,0022000947,2021-04-29T00:00:00Z,OKC vs. NOP,95,-14,1610612740,NOP,New Orleans Pelicans,NOP @ OKC,109,14,Regular Season
22020,1610612750,MIN,Minnesota Timberwolves,0022000946,2021-04-29T00:00:00Z,MIN vs. GSW,126,12,1610612744,GSW,Golden State Warriors,GSW @ MIN,114,-12,Regular Season
22020,1610612765,DET,Detroit Pistons,0022000943,2021-04-29T00:00:00Z,DET vs. DAL,105,-10,1610612742,DAL,Dallas Mavericks,DAL @ DET,115,10,Regular Season
22020,1610612754,IND,Indiana Pacers,0022000944,2021-04-29T00:00:00Z,IND vs. BKN,113,-17,1610612751,BKN,Brooklyn Nets,BKN @ IND,130,17,Regular Season
22020,1610612745,HOU,Houston Rockets,0022000945,2021-04-29T00:00:00Z,HOU vs. MIL,143,7,1610612749,MIL,Milwaukee Bucks,MIL @ HOU,136,-7,Regular Season
22020,1610612751,BKN,Brooklyn Nets,0022000952,2021-04-30T00:00:00Z,BKN vs. POR,109,-19,1610612757,POR,Portland Trail Blazers,POR @ BKN,128,19,Regular Season
22020,1610612741,CHI,Chicago Bulls,0022000954,2021-04-30T00:00:00Z,CHI vs. MIL,98,-10,1610612749,MIL,Milwaukee Bucks,MIL @ CHI,108,10,Regular Season
22020,1610612755,PHI,Philadelphia 76ers,0022000949,2021-04-30T00:00:00Z,PHI vs. ATL,126,22,1610612737,ATL,Atlanta Hawks,ATL @ PHI,104,-22,Regular Season
22020,1610612763,MEM,Memphis Grizzlies,0022000953,2021-04-30T00:00:00Z,MEM vs. ORL,92,17,1610612753,ORL,Orlando Magic,ORL @ MEM,75,-17,Regular Season
22020,1610612738,BOS,Boston Celtics,0022000950,2021-04-30T00:00:00Z,BOS vs. SAS,143,3,1610612759,SAS,San Antonio Spurs,SAS @ BOS,140,-3,Regular Season
22020,1610612747,LAL,Los Angeles Lakers,0022000956,2021-04-30T00:00:00Z,LAL vs. SAC,106,-4,1610612758,SAC,Sacramento Kings,SAC @ LAL,110,4,Regular Season
22020,1610612756,PHX,Phoenix Suns,0022000955,2021-04-30T00:00:00Z,PHX vs. UTA,121,21,1610612762,UTA,Utah Jazz,UTA @ PHX,100,-21,Regular Season
22020,1610612739,CLE,Cleveland Cavaliers,0022000951,2021-04-30T00:00:00Z,CLE vs. WAS,93,-29,1610612764,WAS,Washington Wizards,WAS @ CLE,122,29,Regular Season
22020,1610612745,HOU,Houston Rockets,0022000958,2021-05-01T00:00:00Z,HOU vs. GSW,87,-26,1610612744,GSW,Golden State Warriors,GSW @ HOU,113,26,Regular Season
22020,1610612742,DAL,Dallas Mavericks,0022000964,2021-05-01T00:00:00Z,DAL vs. WAS,125,1,1610612764,WAS,Washington Wizards,WAS @ DAL,124,-1,Regular Season
22020,1610612739,CLE,Cleveland Cavaliers,0022000960,2021-05-01T00:00:00Z,CLE vs. MIA,107,-17,1610612748,MIA,Miami Heat,MIA @ CLE,124,17,Regular Season
22020,1610612746,LAC,LA Clippers,0022000966,2021-05-01T00:00:00Z,LAC vs. DEN,104,-6,1610612743,DEN,Denver Nuggets,DEN @ LAC,110,6,Regular Season
22020,1610612753,ORL,Orlando Magic,0022000961,2021-05-01T00:00:00Z,ORL vs. MEM,112,1,1610612763,MEM,Memphis Grizzlies,MEM @ ORL,111,-1,Regular Season
22020,1610612750,MIN,Minnesota Timberwolves,0022000962,2021-05-01T00:00:00Z,MIN vs. NOP,136,-4,1610612740,NOP,New Orleans Pelicans,NOP @ MIN,140,4,Regular Season
22020,1610612737,ATL,Atlanta Hawks,0022000959,2021-05-01T00:00:00Z,ATL vs. CHI,108,11,1610612741,CHI,Chicago Bulls,CHI @ ATL,97,-11,Regular Season
22020,1610612766,CHA,Charlotte Hornets,0022000957,2021-05-01T00:00:00Z,CHA vs. DET,107,13,1610612765,DET,Detroit Pistons,DET @ CHA,94,-13,Regular Season
22020,1610612762,UTA,Utah Jazz,0022000965,2021-05-01T00:00:00Z,UTA vs. TOR,106,4,1610612761,TOR,Toronto Raptors,TOR @ UTA,102,-4,Regular Season
22020,1610612760,OKC,Oklahoma City Thunder,0022000963,2021-05-01T00:00:00Z,OKC vs. IND,95,-57,1610612754,IND,Indiana Pacers,IND @ OKC,152,57,Regular Season
22020,1610612747,LAL,Los Angeles Lakers,0022000974,2021-05-02T00:00:00Z,LAL vs. TOR,114,-7,1610612761,TOR,Toronto Raptors,TOR @ LAL,121,7,Regular Season
22020,1610612742,DAL,Dallas Mavericks,0022000970,2021-05-02T00:00:00Z,DAL vs. SAC,99,-12,1610612758,SAC,Sacramento Kings,SAC @ DAL,111,12,Regular Season
22020,1610612759,SAS,San Antonio Spurs,0022000973,2021-05-02T00:00:00Z,SAS vs. PHI,111,-2,1610612755,PHI,Philadelphia 76ers,PHI @ SAS,113,2,Regular Season
22020,1610612766,CHA,Charlotte Hornets,0022000969,2021-05-02T00:00:00Z,CHA vs. MIA,111,-10,1610612748,MIA,Miami Heat,MIA @ CHA,121,10,Regular Season
22020,1610612760,OKC,Oklahoma City Thunder,0022000972,2021-05-02T00:00:00Z,OKC vs. PHX,120,-3,1610612756,PHX,Phoenix Suns,PHX @ OKC,123,3,Regular Season
22020,1610612745,HOU,Houston Rockets,0022000971,2021-05-02T00:00:00Z,HOU vs. NYK,97,-25,1610612752,NYK,New York Knicks,NYK @ HOU,122,25,Regular Season
22020,1610612749,MIL,Milwaukee Bucks,0022000967,2021-05-02T00:00:00Z,MIL vs. BKN,117,3,1610612751,BKN,Brooklyn Nets,BKN @ MIL,114,-3,Regular Season
22020,1610612738,BOS,Boston Celtics,0022000968,2021-05-02T00:00:00Z,BOS vs. POR,119,-10,1610612757,POR,Portland Trail Blazers,POR @ BOS,129,10,Regular Season
22020,1610612765,DET,Detroit Pistons,0022000975,2021-05-03T00:00:00Z,DET vs. ORL,112,-7,1610612753,ORL,Orlando Magic,ORL @ DET,119,7,Regular Season
22020,1610612741,CHI,Chicago Bulls,0022000979,2021-05-03T00:00:00Z,CHI vs. PHI,94,-12,1610612755,PHI,Philadelphia 76ers,PHI @ CHI,106,12,Regular Season
22020,1610612740,NOP,New Orleans Pelicans,0022000977,2021-05-03T00:00:00Z,NOP vs. GSW,108,-15,1610612744,GSW,Golden State Warriors,GSW @ NOP,123,15,Regular Season
22020,1610612764,WAS,Washington Wizards,0022000976,2021-05-03T00:00:00Z,WAS vs. IND,154,13,1610612754,IND,Indiana Pacers,IND @ WAS,141,-13,Regular Season
22020,1610612737,ATL,Atlanta Hawks,0022000978,2021-05-03T00:00:00Z,ATL vs. POR,123,9,1610612757,POR,Portland Trail Blazers,POR @ ATL,114,-9,Regular Season
22020,1610612747,LAL,Los Angeles Lakers,0022000982,2021-05-03T00:00:00Z,LAL vs. DEN,93,4,1610612743,DEN,Denver Nuggets,DEN @ LAL,89,-4,Regular Season
22020,1610612762,UTA,Utah Jazz,0022000981,2021-05-03T00:00:00Z,UTA vs. SAS,110,11,1610612759,SAS,San Antonio Spurs,SAS @ UTA,99,-11,Regular Season
22020,1610612763,MEM,Memphis Grizzlies,0022000980,2021-05-03T00:00:00Z,MEM vs. NYK,104,-14,1610612752,NYK,New York Knicks,NYK @ MEM,118,14,Regular Season
22020,1610612760,OKC,Oklahoma City Thunder,0022000988,2021-05-04T00:00:00Z,OKC vs. SAC,99,-4,1610612758,SAC,Sacramento Kings,SAC @ OKC,103,4,Regular Season
22020,1610612765,DET,Detroit Pistons,0022000984,2021-05-04T00:00:00Z,DET vs. CHA,99,-3,1610612766,CHA,Charlotte Hornets,CHA @ DET,102,3,Regular Season
22020,1610612748,MIA,Miami Heat,0022000986,2021-05-04T00:00:00Z,MIA vs. DAL,113,-14,1610612742,DAL,Dallas Mavericks,DAL @ MIA,127,14,Regular Season
22020,1610612739,CLE,Cleveland Cavaliers,0022000983,2021-05-04T00:00:00Z,CLE vs. PHX,118,-16,1610612756,PHX,Phoenix Suns,PHX @ CLE,134,16,Regular Season
22020,1610612746,LAC,LA Clippers,0022000989,2021-05-04T00:00:00Z,LAC vs. TOR,105,5,1610612761,TOR,Toronto Raptors,TOR @ LAC,100,-5,Regular Season
22020,1610612740,NOP,New Orleans Pelicans,0022000987,2021-05-04T00:00:00Z,NOP vs. GSW,108,5,1610612744,GSW,Golden State Warriors,GSW @ NOP,103,-5,Regular Season
22020,1610612749,MIL,Milwaukee Bucks,0022000985,2021-05-04T00:00:00Z,MIL vs. BKN,124,6,1610612751,BKN,Brooklyn Nets,BKN @ MIL,118,-6,Regular Season
22020,1610612743,DEN,Denver Nuggets,0022000995,2021-05-05T00:00:00Z,DEN vs. NYK,113,16,1610612752,NYK,New York Knicks,NYK @ DEN,97,-16,Regular Season
22020,1610612749,MIL,Milwaukee Bucks,0022000235,2021-05-05T00:00:00Z,MIL vs. WAS,135,1,1610612764,WAS,Washington Wizards,WAS @ MIL,134,-1,Regular Season
22020,1610612750,MIN,Minnesota Timberwolves,0022000183,2021-05-05T00:00:00Z,MIN vs. MEM,135,-4,1610612763,MEM,Memphis Grizzlies,MEM @ MIN,139,4,Regular Season
22020,1610612745,HOU,Houston Rockets,0022000994,2021-05-05T00:00:00Z,HOU vs. PHI,115,-20,1610612755,PHI,Philadelphia 76ers,PHI @ HOU,135,20,Regular Season
22020,1610612762,UTA,Utah Jazz,0022000996,2021-05-05T00:00:00Z,UTA vs. SAS,126,32,1610612759,SAS,San Antonio Spurs,SAS @ UTA,94,-32,Regular Season
22020,1610612739,CLE,Cleveland Cavaliers,0022000991,2021-05-05T00:00:00Z,CLE vs. POR,105,-36,1610612757,POR,Portland Trail Blazers,POR @ CLE,141,36,Regular Season
22020,1610612754,IND,Indiana Pacers,0022000993,2021-05-05T00:00:00Z,IND vs. SAC,93,-11,1610612758,SAC,Sacramento Kings,SAC @ IND,104,11,Regular Season
22020,1610612737,ATL,Atlanta Hawks,0022000992,2021-05-05T00:00:00Z,ATL vs. PHX,135,32,1610612756,PHX,Phoenix Suns,PHX @ ATL,103,-32,Regular Season
22020,1610612753,ORL,Orlando Magic,0022000990,2021-05-05T00:00:00Z,ORL vs. BOS,96,-36,1610612738,BOS,Boston Celtics,BOS @ ORL,132,36,Regular Season
22020,1610612754,IND,Indiana Pacers,0022001000,2021-05-06T00:00:00Z,IND vs. ATL,133,7,1610612737,ATL,Atlanta Hawks,ATL @ IND,126,-7,Regular Season
22020,1610612765,DET,Detroit Pistons,0022000999,2021-05-06T00:00:00Z,DET vs. MEM,111,14,1610612763,MEM,Memphis Grizzlies,MEM @ DET,97,-14,Regular Season
22020,1610612766,CHA,Charlotte Hornets,0022000434,2021-05-06T00:00:00Z,CHA vs. CHI,99,-21,1610612741,CHI,Chicago Bulls,CHI @ CHA,120,21,Regular Season
22020,1610612744,GSW,Golden State Warriors,0022001001,2021-05-06T00:00:00Z,GSW vs. OKC,118,21,1610612760,OKC,Oklahoma City Thunder,OKC @ GSW,97,-21,Regular Season
22020,1610612742,DAL,Dallas Mavericks,0022000998,2021-05-06T00:00:00Z,DAL vs. BKN,113,4,1610612751,BKN,Brooklyn Nets,BKN @ DAL,109,-4,Regular Season
22020,1610612746,LAC,LA Clippers,0022001002,2021-05-06T00:00:00Z,LAC vs. LAL,118,24,1610612747,LAL,Los Angeles Lakers,LAL @ LAC,94,-24,Regular Season
22020,1610612761,TOR,Toronto Raptors,0022000997,2021-05-06T00:00:00Z,TOR vs. WAS,129,-2,1610612764,WAS,Washington Wizards,WAS @ TOR,131,2,Regular Season
22020,1610612757,POR,Portland Trail Blazers,0022001010,2021-05-07T00:00:00Z,POR vs. LAL,106,5,1610612747,LAL,Los Angeles Lakers,LAL @ POR,101,-5,Regular Season
22020,1610612742,DAL,Dallas Mavericks,0022001007,2021-05-07T00:00:00Z,DAL vs. CLE,110,20,1610612739,CLE,Cleveland Cavaliers,CLE @ DAL,90,-20,Regular Season
22020,1610612748,MIA,Miami Heat,0022001005,2021-05-07T00:00:00Z,MIA vs. MIN,121,9,1610612750,MIN,Minnesota Timberwolves,MIN @ MIA,112,-9,Regular Season
22020,1610612762,UTA,Utah Jazz,0022001008,2021-05-07T00:00:00Z,UTA vs. DEN,127,7,1610612743,DEN,Denver Nuggets,DEN @ UTA,120,-7,Regular Season
22020,1610612741,CHI,Chicago Bulls,0022000160,2021-05-07T00:00:00Z,CHI vs. BOS,121,22,1610612738,BOS,Boston Celtics,BOS @ CHI,99,-22,Regular Season
22020,1610612749,MIL,Milwaukee Bucks,0022001006,2021-05-07T00:00:00Z,MIL vs. HOU,141,8,1610612745,HOU,Houston Rockets,HOU @ MIL,133,-8,Regular Season
22020,1610612755,PHI,Philadelphia 76ers,0022001003,2021-05-07T00:00:00Z,PHI vs. NOP,109,2,1610612740,NOP,New Orleans Pelicans,NOP @ PHI,107,-2,Regular Season
22020,1610612758,SAC,Sacramento Kings,0022001011,2021-05-07T00:00:00Z,SAC vs. SAS,104,-9,1610612759,SAS,San Antonio Spurs,SAS @ SAC,113,9,Regular Season
22020,1610612766,CHA,Charlotte Hornets,0022001004,2021-05-07T00:00:00Z,CHA vs. ORL,122,10,1610612753,ORL,Orlando Magic,ORL @ CHA,112,-10,Regular Season
22020,1610612756,PHX,Phoenix Suns,0022001009,2021-05-07T00:00:00Z,PHX vs. NYK,128,23,1610612752,NYK,New York Knicks,NYK @ PHX,105,-23,Regular Season
22020,1610612757,POR,Portland Trail Blazers,0022001018,2021-05-08T00:00:00Z,POR vs. SAS,124,22,1610612759,SAS,San Antonio Spurs,SAS @ POR,102,-22,Regular Season
22020,1610612743,DEN,Denver Nuggets,0022001015,2021-05-08T00:00:00Z,DEN vs. BKN,119,-6,1610612751,BKN,Brooklyn Nets,BKN @ DEN,125,6,Regular Season
22020,1610612754,IND,Indiana Pacers,0022001012,2021-05-08T00:00:00Z,IND vs. WAS,132,-1,1610612764,WAS,Washington Wizards,WAS @ IND,133,1,Regular Season
22020,1610612762,UTA,Utah Jazz,0022001016,2021-05-08T00:00:00Z,UTA vs. HOU,124,8,1610612745,HOU,Houston Rockets,HOU @ UTA,116,-8,Regular Season
22020,1610612744,GSW,Golden State Warriors,0022001017,2021-05-08T00:00:00Z,GSW vs. OKC,136,39,1610612760,OKC,Oklahoma City Thunder,OKC @ GSW,97,-39,Regular Season
22020,1610612755,PHI,Philadelphia 76ers,0022001013,2021-05-08T00:00:00Z,PHI vs. DET,118,14,1610612765,DET,Detroit Pistons,DET @ PHI,104,-14,Regular Season
22020,1610612761,TOR,Toronto Raptors,0022001014,2021-05-08T00:00:00Z,TOR vs. MEM,99,-10,1610612763,MEM,Memphis Grizzlies,MEM @ TOR,109,10,Regular Season
22020,1610612747,LAL,Los Angeles Lakers,0022001024,2021-05-09T00:00:00Z,LAL vs. PHX,123,13,1610612756,PHX,Phoenix Suns,PHX @ LAL,110,-13,Regular Season
22020,1610612758,SAC,Sacramento Kings,0022001025,2021-05-09T00:00:00Z,SAC vs. OKC,126,28,1610612760,OKC,Oklahoma City Thunder,OKC @ SAC,98,-28,Regular Season
22020,1610612753,ORL,Orlando Magic,0022001022,2021-05-09T00:00:00Z,ORL vs. MIN,96,-32,1610612750,MIN,Minnesota Timberwolves,MIN @ ORL,128,32,Regular Season
22020,1610612738,BOS,Boston Celtics,0022000145,2021-05-09T00:00:00Z,BOS vs. MIA,124,-6,1610612748,MIA,Miami Heat,MIA @ BOS,130,6,Regular Season
22020,1610612766,CHA,Charlotte Hornets,0022001020,2021-05-09T00:00:00Z,CHA vs. NOP,110,-2,1610612740,NOP,New Orleans Pelicans,NOP @ CHA,112,2,Regular Season
22020,1610612765,DET,Detroit Pistons,0022001023,2021-05-09T00:00:00Z,DET vs. CHI,96,-12,1610612741,CHI,Chicago Bulls,CHI @ DET,108,12,Regular Season
22020,1610612739,CLE,Cleveland Cavaliers,0022001021,2021-05-09T00:00:00Z,CLE vs. DAL,97,-27,1610612742,DAL,Dallas Mavericks,DAL @ CLE,124,27,Regular Season
22020,1610612746,LAC,LA Clippers,0022001019,2021-05-09T00:00:00Z,LAC vs. NYK,100,-6,1610612752,NYK,New York Knicks,NYK @ LAC,106,6,Regular Season
22020,1610612744,GSW,Golden State Warriors,0022001030,2021-05-10T00:00:00Z,GSW vs. UTA,119,3,1610612762,UTA,Utah Jazz,UTA @ GSW,116,-3,Regular Season
22020,1610612737,ATL,Atlanta Hawks,0022001026,2021-05-10T00:00:00Z,ATL vs. WAS,125,1,1610612764,WAS,Washington Wizards,WAS @ ATL,124,-1,Regular Season
22020,1610612757,POR,Portland Trail Blazers,0022001031,2021-05-10T00:00:00Z,POR vs. HOU,140,11,1610612745,HOU,Houston Rockets,HOU @ POR,129,-11,Regular Season
22020,1610612759,SAS,San Antonio Spurs,0022001029,2021-05-10T00:00:00Z,SAS vs. MIL,146,21,1610612749,MIL,Milwaukee Bucks,MIL @ SAS,125,-21,Regular Season
22020,1610612739,CLE,Cleveland Cavaliers,0022001027,2021-05-10T00:00:00Z,CLE vs. IND,102,-9,1610612754,IND,Indiana Pacers,IND @ CLE,111,9,Regular Season
22020,1610612763,MEM,Memphis Grizzlies,0022001028,2021-05-10T00:00:00Z,MEM vs. NOP,115,5,1610612740,NOP,New Orleans Pelicans,NOP @ MEM,110,-5,Regular Season
22020,1610612749,MIL,Milwaukee Bucks,0022001038,2021-05-11T00:00:00Z,MIL vs. ORL,114,12,1610612753,ORL,Orlando Magic,ORL @ MIL,102,-12,Regular Season
22020,1610612763,MEM,Memphis Grizzlies,0022001037,2021-05-11T00:00:00Z,MEM vs. DAL,133,29,1610612742,DAL,Dallas Mavericks,DAL @ MEM,104,-29,Regular Season
22020,1610612765,DET,Detroit Pistons,0022001033,2021-05-11T00:00:00Z,DET vs. MIN,100,-19,1610612750,MIN,Minnesota Timberwolves,MIN @ DET,119,19,Regular Season
22020,1610612738,BOS,Boston Celtics,0022001032,2021-05-11T00:00:00Z,BOS vs. MIA,121,-8,1610612748,MIA,Miami Heat,MIA @ BOS,129,8,Regular Season
22020,1610612758,SAC,Sacramento Kings,0022001040,2021-05-11T00:00:00Z,SAC vs. OKC,122,16,1610612760,OKC,Oklahoma City Thunder,OKC @ SAC,106,-16,Regular Season
22020,1610612747,LAL,Los Angeles Lakers,0022001041,2021-05-11T00:00:00Z,LAL vs. NYK,101,2,1610612752,NYK,New York Knicks,NYK @ LAL,99,-2,Regular Season
22020,1610612766,CHA,Charlotte Hornets,0022000448,2021-05-11T00:00:00Z,CHA vs. DEN,112,-5,1610612743,DEN,Denver Nuggets,DEN @ CHA,117,5,Regular Season
22020,1610612761,TOR,Toronto Raptors,0022001034,2021-05-11T00:00:00Z,TOR vs. LAC,96,-19,1610612746,LAC,LA Clippers,LAC @ TOR,115,19,Regular Season
22020,1610612744,GSW,Golden State Warriors,0022001039,2021-05-11T00:00:00Z,GSW vs. PHX,122,6,1610612756,PHX,Phoenix Suns,PHX @ GSW,116,-6,Regular Season
22020,1610612741,CHI,Chicago Bulls,0022001036,2021-05-11T00:00:00Z,CHI vs. BKN,107,-8,1610612751,BKN,Brooklyn Nets,BKN @ CHI,115,8,Regular Season
22020,1610612754,IND,Indiana Pacers,0022001035,2021-05-11T00:00:00Z,IND vs. PHI,103,9,1610612755,PHI,Philadelphia 76ers,PHI @ IND,94,-9,Regular Season
22020,1610612739,CLE,Cleveland Cavaliers,0022001044,2021-05-12T00:00:00Z,CLE vs. BOS,102,8,1610612738,BOS,Boston Celtics,BOS @ CLE,94,-8,Regular Season
22020,1610612737,ATL,Atlanta Hawks,0022001042,2021-05-12T00:00:00Z,ATL vs. WAS,120,4,1610612764,WAS,Washington Wizards,WAS @ ATL,116,-4,Regular Season
22020,1610612751,BKN,Brooklyn Nets,0022001043,2021-05-12T00:00:00Z,BKN vs. SAS,128,12,1610612759,SAS,San Antonio Spurs,SAS @ BKN,116,-12,Regular Season
22020,1610612762,UTA,Utah Jazz,0022001045,2021-05-12T00:00:00Z,UTA vs. POR,98,-7,1610612757,POR,Portland Trail Blazers,POR @ UTA,105,7,Regular Season
22020,1610612747,LAL,Los Angeles Lakers,0022001046,2021-05-12T00:00:00Z,LAL vs. HOU,124,2,1610612745,HOU,Houston Rockets,HOU @ LAL,122,-2,Regular Season
22020,1610612742,DAL,Dallas Mavericks,0022000154,2021-05-12T00:00:00Z,DAL vs. NOP,125,18,1610612740,NOP,New Orleans Pelicans,NOP @ DAL,107,-18,Regular Season
22020,1610612741,CHI,Chicago Bulls,0022001051,2021-05-13T00:00:00Z,CHI vs. TOR,114,12,1610612761,TOR,Toronto Raptors,TOR @ CHI,102,-12,Regular Season
22020,1610612752,NYK,New York Knicks,0022000458,2021-05-13T00:00:00Z,NYK vs. SAS,102,4,1610612759,SAS,San Antonio Spurs,SAS @ NYK,98,-4,Regular Season
22020,1610612766,CHA,Charlotte Hornets,0022001047,2021-05-13T00:00:00Z,CHA vs. LAC,90,-23,1610612746,LAC,LA Clippers,LAC @ CHA,113,23,Regular Season
22020,1610612754,IND,Indiana Pacers,0022001048,2021-05-13T00:00:00Z,IND vs. MIL,133,-9,1610612749,MIL,Milwaukee Bucks,MIL @ IND,142,9,Regular Season
22020,1610612748,MIA,Miami Heat,0022001050,2021-05-13T00:00:00Z,MIA vs. PHI,106,12,1610612755,PHI,Philadelphia 76ers,PHI @ MIA,94,-12,Regular Season
22020,1610612737,ATL,Atlanta Hawks,0022001049,2021-05-13T00:00:00Z,ATL vs. ORL,116,23,1610612753,ORL,Orlando Magic,ORL @ ATL,93,-23,Regular Season
22020,1610612763,MEM,Memphis Grizzlies,0022000255,2021-05-13T00:00:00Z,MEM vs. SAC,116,6,1610612758,SAC,Sacramento Kings,SAC @ MEM,110,-6,Regular Season
22020,1610612756,PHX,Phoenix Suns,0022001053,2021-05-13T00:00:00Z,PHX vs. POR,118,1,1610612757,POR,Portland Trail Blazers,POR @ PHX,117,-1,Regular Season
22020,1610612750,MIN,Minnesota Timberwolves,0022001052,2021-05-13T00:00:00Z,MIN vs. DEN,103,-11,1610612743,DEN,Denver Nuggets,DEN @ MIN,114,11,Regular Season
22020,1610612745,HOU,Houston Rockets,0022001058,2021-05-14T00:00:00Z,HOU vs. LAC,122,7,1610612746,LAC,LA Clippers,LAC @ HOU,115,-7,Regular Season
22020,1610612765,DET,Detroit Pistons,0022001054,2021-05-14T00:00:00Z,DET vs. DEN,91,-13,1610612743,DEN,Denver Nuggets,DEN @ DET,104,13,Regular Season
22020,1610612742,DAL,Dallas Mavericks,0022001057,2021-05-14T00:00:00Z,DAL vs. TOR,114,4,1610612761,TOR,Toronto Raptors,TOR @ DAL,110,-4,Regular Season
22020,1610612744,GSW,Golden State Warriors,0022001059,2021-05-14T00:00:00Z,GSW vs. NOP,125,3,1610612740,NOP,New Orleans Pelicans,NOP @ GSW,122,-3,Regular Season
22020,1610612763,MEM,Memphis Grizzlies,0022000263,2021-05-14T00:00:00Z,MEM vs. SAC,107,1,1610612758,SAC,Sacramento Kings,SAC @ MEM,106,-1,Regular Season
22020,1610612755,PHI,Philadelphia 76ers,0022001055,2021-05-14T00:00:00Z,PHI vs. ORL,122,25,1610612753,ORL,Orlando Magic,ORL @ PHI,97,-25,Regular Season
22020,1610612764,WAS,Washington Wizards,0022000204,2021-05-14T00:00:00Z,WAS vs. CLE,120,15,1610612739,CLE,Cleveland Cavaliers,CLE @ WAS,105,-15,Regular Season
22020,1610612760,OKC,Oklahoma City Thunder,0022001056,2021-05-14T00:00:00Z,OKC vs. UTA,93,-16,1610612762,UTA,Utah Jazz,UTA @ OKC,109,16,Regular Season
22020,1610612752,NYK,New York Knicks,0022001064,2021-05-15T00:00:00Z,NYK vs. CHA,118,9,1610612766,CHA,Charlotte Hornets,CHA @ NYK,109,-9,Regular Season
22020,1610612759,SAS,San Antonio Spurs,0022001065,2021-05-15T00:00:00Z,SAS vs. PHX,103,-37,1610612756,PHX,Phoenix Suns,PHX @ SAS,140,37,Regular Season
22020,1610612751,BKN,Brooklyn Nets,0022001060,2021-05-15T00:00:00Z,BKN vs. CHI,105,14,1610612741,CHI,Chicago Bulls,CHI @ BKN,91,-14,Regular Season
22020,1610612750,MIN,Minnesota Timberwolves,0022001063,2021-05-15T00:00:00Z,MIN vs. BOS,108,-16,1610612738,BOS,Boston Celtics,BOS @ MIN,124,16,Regular Season
22020,1610612749,MIL,Milwaukee Bucks,0022001062,2021-05-15T00:00:00Z,MIL vs. MIA,122,14,1610612748,MIA,Miami Heat,MIA @ MIL,108,-14,Regular Season
22020,1610612754,IND,Indiana Pacers,0022001061,2021-05-15T00:00:00Z,IND vs. LAL,115,-7,1610612747,LAL,Los Angeles Lakers,LAL @ IND,122,7,Regular Season
22020,1610612744,GSW,Golden State Warriors,0022001070,2021-05-16T00:00:00Z,GSW vs. MEM,113,12,1610612763,MEM,Memphis Grizzlies,MEM @ GSW,101,-12,Regular Season
22020,1610612755,PHI,Philadelphia 76ers,0022001075,2021-05-16T00:00:00Z,PHI vs. ORL,128,11,1610612753,ORL,Orlando Magic,ORL @ PHI,117,-11,Regular Season
22020,1610612758,SAC,Sacramento Kings,0022001077,2021-05-16T00:00:00Z,SAC vs. UTA,99,-22,1610612762,UTA,Utah Jazz,UTA @ SAC,121,22,Regular Season
22020,1610612740,NOP,New Orleans Pelicans,0022001072,2021-05-16T00:00:00Z,NOP vs. LAL,98,-12,1610612747,LAL,Los Angeles Lakers,LAL @ NOP,110,12,Regular Season
22020,1610612751,BKN,Brooklyn Nets,0022001067,2021-05-16T00:00:00Z,BKN vs. CLE,123,14,1610612739,CLE,Cleveland Cavaliers,CLE @ BKN,109,-14,Regular Season
22020,1610612757,POR,Portland Trail Blazers,0022001076,2021-05-16T00:00:00Z,POR vs. DEN,132,16,1610612743,DEN,Denver Nuggets,DEN @ POR,116,-16,Regular Season
22020,1610612750,MIN,Minnesota Timberwolves,0022001071,2021-05-16T00:00:00Z,MIN vs. DAL,136,15,1610612742,DAL,Dallas Mavericks,DAL @ MIN,121,-15,Regular Season
22020,1610612752,NYK,New York Knicks,0022001073,2021-05-16T00:00:00Z,NYK vs. BOS,96,4,1610612738,BOS,Boston Celtics,BOS @ NYK,92,-4,Regular Season
22020,1610612765,DET,Detroit Pistons,0022001069,2021-05-16T00:00:00Z,DET vs. MIA,107,-13,1610612748,MIA,Miami Heat,MIA @ DET,120,13,Regular Season
22020,1610612760,OKC,Oklahoma City Thunder,0022001074,2021-05-16T00:00:00Z,OKC vs. LAC,117,5,1610612746,LAC,LA Clippers,LAC @ OKC,112,-5,Regular Season
22020,1610612761,TOR,Toronto Raptors,0022001079,2021-05-16T00:00:00Z,TOR vs. IND,113,-12,1610612754,IND,Indiana Pacers,IND @ TOR,125,12,Regular Season
22020,1610612764,WAS,Washington Wizards,0022001080,2021-05-16T00:00:00Z,WAS vs. CHA,115,5,1610612766,CHA,Charlotte Hornets,CHA @ WAS,110,-5,Regular Season
22020,1610612741,CHI,Chicago Bulls,0022001068,2021-05-16T00:00:00Z,CHI vs. MIL,118,6,1610612749,MIL,Milwaukee Bucks,MIL @ CHI,112,-6,Regular Season
22020,1610612759,SAS,San Antonio Spurs,0022001078,2021-05-16T00:00:00Z,SAS vs. PHX,121,-2,1610612756,PHX,Phoenix Suns,PHX @ SAS,123,2,Regular Season
22020,1610612737,ATL,Atlanta Hawks,0022001066,2021-05-16T00:00:00Z,ATL vs. HOU,124,29,1610612745,HOU,Houston Rockets,HOU @ ATL,95,-29,Regular Season
12020,1610612747,LAL,Los Angeles Lakers,0012000004,2020-12-11T00:00:00Z,LAL vs. LAC,87,6,1610612746,LAC,LA Clippers,LAC @ LAL,81,-6,Pre Season
12020,1610612765,DET,Detroit Pistons,0012000002,2020-12-11T00:00:00Z,DET vs. NYK,84,-6,1610612752,NYK,New York Knicks,NYK @ DET,90,6,Pre Season
12020,1610612737,ATL,Atlanta Hawks,0012000001,2020-12-11T00:00:00Z,ATL vs. ORL,112,-4,1610612753,ORL,Orlando Magic,ORL @ ATL,116,4,Pre Season
12020,1610612741,CHI,Chicago Bulls,0012000003,2020-12-11T00:00:00Z,CHI vs. HOU,104,-21,1610612745,HOU,Houston Rockets,HOU @ CHI,125,21,Pre Season
12020,1610612757,POR,Portland Trail Blazers,0012000005,2020-12-11T00:00:00Z,POR vs. SAC,127,25,1610612758,SAC,Sacramento Kings,SAC @ POR,102,-25,Pre Season
12020,1610612766,CHA,Charlotte Hornets,0012000006,2020-12-12T00:00:00Z,CHA vs. TOR,100,-11,1610612761,TOR,Toronto Raptors,TOR @ CHA,111,11,Pre Season
12020,1610612759,SAS,San Antonio Spurs,0012000008,2020-12-12T00:00:00Z,SAS vs. OKC,108,-13,1610612760,OKC,Oklahoma City Thunder,OKC @ SAS,121,13,Pre Season
12020,1610612750,MIN,Minnesota Timberwolves,0012000010,2020-12-12T00:00:00Z,MIN vs. MEM,105,-2,1610612763,MEM,Memphis Grizzlies,MEM @ MIN,107,2,Pre Season
12020,1610612739,CLE,Cleveland Cavaliers,0012000007,2020-12-12T00:00:00Z,CLE vs. IND,107,3,1610612754,IND,Indiana Pacers,IND @ CLE,104,-3,Pre Season
12020,1610612762,UTA,Utah Jazz,0012000012,2020-12-12T00:00:00Z,UTA vs. PHX,119,14,1610612756,PHX,Phoenix Suns,PHX @ UTA,105,-14,Pre Season
12020,1610612744,GSW,Golden State Warriors,0012000011,2020-12-12T00:00:00Z,GSW vs. DEN,107,2,1610612743,DEN,Denver Nuggets,DEN @ GSW,105,-2,Pre Season
12020,1610612749,MIL,Milwaukee Bucks,0012000009,2020-12-12T00:00:00Z,MIL vs. DAL,102,-10,1610612742,DAL,Dallas Mavericks,DAL @ MIL,112,10,Pre Season
12020,1610612765,DET,Detroit Pistons,0012000015,2020-12-13T00:00:00Z,DET vs. NYK,99,8,1610612752,NYK,New York Knicks,NYK @ DET,91,-8,Pre Season
12020,1610612757,POR,Portland Trail Blazers,0012000017,2020-12-13T00:00:00Z,POR vs. SAC,106,-15,1610612758,SAC,Sacramento Kings,SAC @ POR,121,15,Pre Season
12020,1610612741,CHI,Chicago Bulls,0012000016,2020-12-13T00:00:00Z,CHI vs. HOU,104,13,1610612745,HOU,Houston Rockets,HOU @ CHI,91,-13,Pre Season
12020,1610612747,LAL,Los Angeles Lakers,0012000018,2020-12-13T00:00:00Z,LAL vs. LAC,131,25,1610612746,LAC,LA Clippers,LAC @ LAL,106,-25,Pre Season
12020,1610612737,ATL,Atlanta Hawks,0012000013,2020-12-13T00:00:00Z,ATL vs. ORL,116,9,1610612753,ORL,Orlando Magic,ORL @ ATL,107,-9,Pre Season
12020,1610612751,BKN,Brooklyn Nets,0012000014,2020-12-13T00:00:00Z,BKN vs. WAS,119,5,1610612764,WAS,Washington Wizards,WAS @ BKN,114,-5,Pre Season
12020,1610612766,CHA,Charlotte Hornets,0012000020,2020-12-14T00:00:00Z,CHA vs. TOR,109,-3,1610612761,TOR,Toronto Raptors,TOR @ CHA,112,3,Pre Season
12020,1610612762,UTA,Utah Jazz,0012000024,2020-12-14T00:00:00Z,UTA vs. PHX,111,19,1610612756,PHX,Phoenix Suns,PHX @ UTA,92,-19,Pre Season
12020,1610612748,MIA,Miami Heat,0012000021,2020-12-14T00:00:00Z,MIA vs. NOP,92,-22,1610612740,NOP,New Orleans Pelicans,NOP @ MIA,114,22,Pre Season
12020,1610612750,MIN,Minnesota Timberwolves,0012000023,2020-12-14T00:00:00Z,MIN vs. MEM,104,-19,1610612763,MEM,Memphis Grizzlies,MEM @ MIN,123,19,Pre Season
12020,1610612739,CLE,Cleveland Cavaliers,0012000019,2020-12-14T00:00:00Z,CLE vs. IND,116,10,1610612754,IND,Indiana Pacers,IND @ CLE,106,-10,Pre Season
12020,1610612749,MIL,Milwaukee Bucks,0012000022,2020-12-14T00:00:00Z,MIL vs. DAL,112,-16,1610612742,DAL,Dallas Mavericks,DAL @ MIL,128,16,Pre Season
12020,1610612758,SAC,Sacramento Kings,0012000027,2020-12-15T00:00:00Z,SAC vs. GSW,114,1,1610612744,GSW,Golden State Warriors,GSW @ SAC,113,-1,Pre Season
12020,1610612745,HOU,Houston Rockets,0012000026,2020-12-15T00:00:00Z,HOU vs. SAS,112,14,1610612759,SAS,San Antonio Spurs,SAS @ HOU,98,-14,Pre Season
12020,1610612755,PHI,Philadelphia 76ers,0012000025,2020-12-15T00:00:00Z,PHI vs. BOS,108,9,1610612738,BOS,Boston Celtics,BOS @ PHI,99,-9,Pre Season
12020,1610612760,OKC,Oklahoma City Thunder,0012000029,2020-12-16T00:00:00Z,OKC vs. CHI,103,-21,1610612741,CHI,Chicago Bulls,CHI @ OKC,124,21,Pre Season
12020,1610612756,PHX,Phoenix Suns,0012000031,2020-12-16T00:00:00Z,PHX vs. LAL,107,-5,1610612747,LAL,Los Angeles Lakers,LAL @ PHX,112,5,Pre Season
12020,1610612752,NYK,New York Knicks,0012000028,2020-12-16T00:00:00Z,NYK vs. CLE,100,7,1610612739,CLE,Cleveland Cavaliers,CLE @ NYK,93,-7,Pre Season
12020,1610612743,DEN,Denver Nuggets,0012000030,2020-12-16T00:00:00Z,DEN vs. POR,126,31,1610612757,POR,Portland Trail Blazers,POR @ DEN,95,-31,Pre Season
12020,1610612742,DAL,Dallas Mavericks,0012000036,2020-12-17T00:00:00Z,DAL vs. MIN,127,-2,1610612750,MIN,Minnesota Timberwolves,MIN @ DAL,129,2,Pre Season
12020,1610612758,SAC,Sacramento Kings,0012000038,2020-12-17T00:00:00Z,SAC vs. GSW,105,-8,1610612744,GSW,Golden State Warriors,GSW @ SAC,113,8,Pre Season
12020,1610612746,LAC,LA Clippers,0012000037,2020-12-17T00:00:00Z,LAC vs. UTA,105,-20,1610612762,UTA,Utah Jazz,UTA @ LAC,125,20,Pre Season
12020,1610612745,HOU,Houston Rockets,0012000034,2020-12-17T00:00:00Z,HOU vs. SAS,128,22,1610612759,SAS,San Antonio Spurs,SAS @ HOU,106,-22,Pre Season
12020,1610612763,MEM,Memphis Grizzlies,0012000035,2020-12-17T00:00:00Z,MEM vs. ATL,128,22,1610612737,ATL,Atlanta Hawks,ATL @ MEM,106,-22,Pre Season
12020,1610612753,ORL,Orlando Magic,0012000032,2020-12-17T00:00:00Z,ORL vs. CHA,115,-8,1610612766,CHA,Charlotte Hornets,CHA @ ORL,123,8,Pre Season
12020,1610612764,WAS,Washington Wizards,0012000033,2020-12-17T00:00:00Z,WAS vs. DET,86,-11,1610612765,DET,Detroit Pistons,DET @ WAS,97,11,Pre Season
12020,1610612740,NOP,New Orleans Pelicans,0012000043,2020-12-18T00:00:00Z,NOP vs. MIL,127,14,1610612749,MIL,Milwaukee Bucks,MIL @ NOP,113,-14,Pre Season
12020,1610612760,OKC,Oklahoma City Thunder,0012000044,2020-12-18T00:00:00Z,OKC vs. CHI,103,-2,1610612741,CHI,Chicago Bulls,CHI @ OKC,105,2,Pre Season
12020,1610612756,PHX,Phoenix Suns,0012000046,2020-12-18T00:00:00Z,PHX vs. LAL,113,-1,1610612747,LAL,Los Angeles Lakers,LAL @ PHX,114,1,Pre Season
12020,1610612761,TOR,Toronto Raptors,0012000040,2020-12-18T00:00:00Z,TOR vs. MIA,105,-12,1610612748,MIA,Miami Heat,MIA @ TOR,117,12,Pre Season
12020,1610612754,IND,Indiana Pacers,0012000039,2020-12-18T00:00:00Z,IND vs. PHI,107,-6,1610612755,PHI,Philadelphia 76ers,PHI @ IND,113,6,Pre Season
12020,1610612738,BOS,Boston Celtics,0012000041,2020-12-18T00:00:00Z,BOS vs. BKN,89,-24,1610612751,BKN,Brooklyn Nets,BKN @ BOS,113,24,Pre Season
12020,1610612752,NYK,New York Knicks,0012000042,2020-12-18T00:00:00Z,NYK vs. CLE,119,36,1610612739,CLE,Cleveland Cavaliers,CLE @ NYK,83,-36,Pre Season
12020,1610612743,DEN,Denver Nuggets,0012000045,2020-12-18T00:00:00Z,DEN vs. POR,129,33,1610612757,POR,Portland Trail Blazers,POR @ DEN,96,-33,Pre Season
12020,1610612764,WAS,Washington Wizards,0012000048,2020-12-19T00:00:00Z,WAS vs. DET,99,3,1610612765,DET,Detroit Pistons,DET @ WAS,96,-3,Pre Season
12020,1610612753,ORL,Orlando Magic,0012000047,2020-12-19T00:00:00Z,ORL vs. CHA,120,3,1610612766,CHA,Charlotte Hornets,CHA @ ORL,117,-3,Pre Season
12020,1610612763,MEM,Memphis Grizzlies,0012000049,2020-12-19T00:00:00Z,MEM vs. ATL,116,-1,1610612737,ATL,Atlanta Hawks,ATL @ MEM,117,1,Pre Season
42020,1610612746,LAC,LA Clippers,0042000171,2021-05-22T00:00:00Z,LAC vs. DAL,103,-10,1610612742,DAL,Dallas Mavericks,DAL @ LAC,113,10,Playoffs
42020,1610612749,MIL,Milwaukee Bucks,0042000121,2021-05-22T00:00:00Z,MIL vs. MIA,109,2,1610612748,MIA,Miami Heat,MIA @ MIL,107,-2,Playoffs
42020,1610612743,DEN,Denver Nuggets,0042000161,2021-05-22T00:00:00Z,DEN vs. POR,109,-14,1610612757,POR,Portland Trail Blazers,POR @ DEN,123,14,Playoffs
42020,1610612751,BKN,Brooklyn Nets,0042000111,2021-05-22T00:00:00Z,BKN vs. BOS,104,11,1610612738,BOS,Boston Celtics,BOS @ BKN,93,-11,Playoffs
42020,1610612762,UTA,Utah Jazz,0042000141,2021-05-23T00:00:00Z,UTA vs. MEM,109,-3,1610612763,MEM,Memphis Grizzlies,MEM @ UTA,112,3,Playoffs
42020,1610612752,NYK,New York Knicks,0042000131,2021-05-23T00:00:00Z,NYK vs. ATL,105,-2,1610612737,ATL,Atlanta Hawks,ATL @ NYK,107,2,Playoffs
42020,1610612756,PHX,Phoenix Suns,0042000151,2021-05-23T00:00:00Z,PHX vs. LAL,99,9,1610612747,LAL,Los Angeles Lakers,LAL @ PHX,90,-9,Playoffs
42020,1610612755,PHI,Philadelphia 76ers,0042000101,2021-05-23T00:00:00Z,PHI vs. WAS,125,7,1610612764,WAS,Washington Wizards,WAS @ PHI,118,-7,Playoffs
42020,1610612743,DEN,Denver Nuggets,0042000162,2021-05-24T00:00:00Z,DEN vs. POR,128,19,1610612757,POR,Portland Trail Blazers,POR @ DEN,109,-19,Playoffs
42020,1610612749,MIL,Milwaukee Bucks,0042000122,2021-05-24T00:00:00Z,MIL vs. MIA,132,34,1610612748,MIA,Miami Heat,MIA @ MIL,98,-34,Playoffs
42020,1610612751,BKN,Brooklyn Nets,0042000112,2021-05-25T00:00:00Z,BKN vs. BOS,130,22,1610612738,BOS,Boston Celtics,BOS @ BKN,108,-22,Playoffs
42020,1610612756,PHX,Phoenix Suns,0042000152,2021-05-25T00:00:00Z,PHX vs. LAL,102,-7,1610612747,LAL,Los Angeles Lakers,LAL @ PHX,109,7,Playoffs
42020,1610612746,LAC,LA Clippers,0042000172,2021-05-25T00:00:00Z,LAC vs. DAL,121,-6,1610612742,DAL,Dallas Mavericks,DAL @ LAC,127,6,Playoffs
42020,1610612755,PHI,Philadelphia 76ers,0042000102,2021-05-26T00:00:00Z,PHI vs. WAS,120,25,1610612764,WAS,Washington Wizards,WAS @ PHI,95,-25,Playoffs
42020,1610612762,UTA,Utah Jazz,0042000142,2021-05-26T00:00:00Z,UTA vs. MEM,141,12,1610612763,MEM,Memphis Grizzlies,MEM @ UTA,129,-12,Playoffs
42020,1610612752,NYK,New York Knicks,0042000132,2021-05-26T00:00:00Z,NYK vs. ATL,101,9,1610612737,ATL,Atlanta Hawks,ATL @ NYK,92,-9,Playoffs
42020,1610612748,MIA,Miami Heat,0042000123,2021-05-27T00:00:00Z,MIA vs. MIL,84,-29,1610612749,MIL,Milwaukee Bucks,MIL @ MIA,113,29,Playoffs
42020,1610612747,LAL,Los Angeles Lakers,0042000153,2021-05-27T00:00:00Z,LAL vs. PHX,109,14,1610612756,PHX,Phoenix Suns,PHX @ LAL,95,-14,Playoffs
42020,1610612757,POR,Portland Trail Blazers,0042000163,2021-05-27T00:00:00Z,POR vs. DEN,115,-5,1610612743,DEN,Denver Nuggets,DEN @ POR,120,5,Playoffs
42020,1610612738,BOS,Boston Celtics,0042000113,2021-05-28T00:00:00Z,BOS vs. BKN,125,6,1610612751,BKN,Brooklyn Nets,BKN @ BOS,119,-6,Playoffs
42020,1610612742,DAL,Dallas Mavericks,0042000173,2021-05-28T00:00:00Z,DAL vs. LAC,108,-10,1610612746,LAC,LA Clippers,LAC @ DAL,118,10,Playoffs
42020,1610612737,ATL,Atlanta Hawks,0042000133,2021-05-28T00:00:00Z,ATL vs. NYK,105,11,1610612752,NYK,New York Knicks,NYK @ ATL,94,-11,Playoffs
42020,1610612763,MEM,Memphis Grizzlies,0042000143,2021-05-29T00:00:00Z,MEM vs. UTA,111,-10,1610612762,UTA,Utah Jazz,UTA @ MEM,121,10,Playoffs
42020,1610612757,POR,Portland Trail Blazers,0042000164,2021-05-29T00:00:00Z,POR vs. DEN,115,20,1610612743,DEN,Denver Nuggets,DEN @ POR,95,-20,Playoffs
42020,1610612764,WAS,Washington Wizards,0042000103,2021-05-29T00:00:00Z,WAS vs. PHI,103,-29,1610612755,PHI,Philadelphia 76ers,PHI @ WAS,132,29,Playoffs
42020,1610612748,MIA,Miami Heat,0042000124,2021-05-29T00:00:00Z,MIA vs. MIL,103,-17,1610612749,MIL,Milwaukee Bucks,MIL @ MIA,120,17,Playoffs
42020,1610612737,ATL,Atlanta Hawks,0042000134,2021-05-30T00:00:00Z,ATL vs. NYK,113,17,1610612752,NYK,New York Knicks,NYK @ ATL,96,-17,Playoffs
42020,1610612742,DAL,Dallas Mavericks,0042000174,2021-05-30T00:00:00Z,DAL vs. LAC,81,-25,1610612746,LAC,LA Clippers,LAC @ DAL,106,25,Playoffs
42020,1610612738,BOS,Boston Celtics,0042000114,2021-05-30T00:00:00Z,BOS vs. BKN,126,-15,1610612751,BKN,Brooklyn Nets,BKN @ BOS,141,15,Playoffs
42020,1610612747,LAL,Los Angeles Lakers,0042000154,2021-05-30T00:00:00Z,LAL vs. PHX,92,-8,1610612756,PHX,Phoenix Suns,PHX @ LAL,100,8,Playoffs
42020,1610612764,WAS,Washington Wizards,0042000104,2021-05-31T00:00:00Z,WAS vs. PHI,122,8,1610612755,PHI,Philadelphia 76ers,PHI @ WAS,114,-8,Playoffs
42020,1610612763,MEM,Memphis Grizzlies,0042000144,2021-05-31T00:00:00Z,MEM vs. UTA,113,-7,1610612762,UTA,Utah Jazz,UTA @ MEM,120,7,Playoffs
42020,1610612756,PHX,Phoenix Suns,0042000155,2021-06-01T00:00:00Z,PHX vs. LAL,115,30,1610612747,LAL,Los Angeles Lakers,LAL @ PHX,85,-30,Playoffs
42020,1610612743,DEN,Denver Nuggets,0042000165,2021-06-01T00:00:00Z,DEN vs. POR,147,7,1610612757,POR,Portland Trail Blazers,POR @ DEN,140,-7,Playoffs
42020,1610612751,BKN,Brooklyn Nets,0042000115,2021-06-01T00:00:00Z,BKN vs. BOS,123,14,1610612738,BOS,Boston Celtics,BOS @ BKN,109,-14,Playoffs
42020,1610612755,PHI,Philadelphia 76ers,0042000105,2021-06-02T00:00:00Z,PHI vs. WAS,129,17,1610612764,WAS,Washington Wizards,WAS @ PHI,112,-17,Playoffs
42020,1610612762,UTA,Utah Jazz,0042000145,2021-06-02T00:00:00Z,UTA vs. MEM,126,16,1610612763,MEM,Memphis Grizzlies,MEM @ UTA,110,-16,Playoffs
42020,1610612746,LAC,LA Clippers,0042000175,2021-06-02T00:00:00Z,LAC vs. DAL,100,-5,1610612742,DAL,Dallas Mavericks,DAL @ LAC,105,5,Playoffs
42020,1610612752,NYK,New York Knicks,0042000135,2021-06-02T00:00:00Z,NYK vs. ATL,89,-14,1610612737,ATL,Atlanta Hawks,ATL @ NYK,103,14,Playoffs
42020,1610612757,POR,Portland Trail Blazers,0042000166,2021-06-03T00:00:00Z,POR vs. DEN,115,-11,1610612743,DEN,Denver Nuggets,DEN @ POR,126,11,Playoffs
42020,1610612747,LAL,Los Angeles Lakers,0042000156,2021-06-03T00:00:00Z,LAL vs. PHX,100,-13,1610612756,PHX,Phoenix Suns,PHX @ LAL,113,13,Playoffs
42020,1610612742,DAL,Dallas Mavericks,0042000176,2021-06-04T00:00:00Z,DAL vs. LAC,97,-7,1610612746,LAC,LA Clippers,LAC @ DAL,104,7,Playoffs
42020,1610612751,BKN,Brooklyn Nets,0042000211,2021-06-05T00:00:00Z,BKN vs. MIL,115,8,1610612749,MIL,Milwaukee Bucks,MIL @ BKN,107,-8,Playoffs
42020,1610612746,LAC,LA Clippers,0042000177,2021-06-06T00:00:00Z,LAC vs. DAL,126,15,1610612742,DAL,Dallas Mavericks,DAL @ LAC,111,-15,Playoffs
42020,1610612755,PHI,Philadelphia 76ers,0042000201,2021-06-06T00:00:00Z,PHI vs. ATL,124,-4,1610612737,ATL,Atlanta Hawks,ATL @ PHI,128,4,Playoffs
42020,1610612756,PHX,Phoenix Suns,0042000231,2021-06-07T00:00:00Z,PHX vs. DEN,122,17,1610612743,DEN,Denver Nuggets,DEN @ PHX,105,-17,Playoffs
42020,1610612751,BKN,Brooklyn Nets,0042000212,2021-06-07T00:00:00Z,BKN vs. MIL,125,39,1610612749,MIL,Milwaukee Bucks,MIL @ BKN,86,-39,Playoffs
42020,1610612755,PHI,Philadelphia 76ers,0042000202,2021-06-08T00:00:00Z,PHI vs. ATL,118,16,1610612737,ATL,Atlanta Hawks,ATL @ PHI,102,-16,Playoffs
42020,1610612762,UTA,Utah Jazz,0042000221,2021-06-08T00:00:00Z,UTA vs. LAC,112,3,1610612746,LAC,LA Clippers,LAC @ UTA,109,-3,Playoffs
42020,1610612756,PHX,Phoenix Suns,0042000232,2021-06-09T00:00:00Z,PHX vs. DEN,123,25,1610612743,DEN,Denver Nuggets,DEN @ PHX,98,-25,Playoffs
42020,1610612749,MIL,Milwaukee Bucks,0042000213,2021-06-10T00:00:00Z,MIL vs. BKN,86,3,1610612751,BKN,Brooklyn Nets,BKN @ MIL,83,-3,Playoffs
42020,1610612762,UTA,Utah Jazz,0042000222,2021-06-10T00:00:00Z,UTA vs. LAC,117,6,1610612746,LAC,LA Clippers,LAC @ UTA,111,-6,Playoffs
42020,1610612737,ATL,Atlanta Hawks,0042000203,2021-06-11T00:00:00Z,ATL vs. PHI,111,-16,1610612755,PHI,Philadelphia 76ers,PHI @ ATL,127,16,Playoffs
42020,1610612743,DEN,Denver Nuggets,0042000233,2021-06-11T00:00:00Z,DEN vs. PHX,102,-14,1610612756,PHX,Phoenix Suns,PHX @ DEN,116,14,Playoffs
42020,1610612746,LAC,LA Clippers,0042000223,2021-06-12T00:00:00Z,LAC vs. UTA,132,26,1610612762,UTA,Utah Jazz,UTA @ LAC,106,-26,Playoffs
42020,1610612749,MIL,Milwaukee Bucks,0042000214,2021-06-13T00:00:00Z,MIL vs. BKN,107,11,1610612751,BKN,Brooklyn Nets,BKN @ MIL,96,-11,Playoffs
42020,1610612743,DEN,Denver Nuggets,0042000234,2021-06-13T00:00:00Z,DEN vs. PHX,118,-7,1610612756,PHX,Phoenix Suns,PHX @ DEN,125,7,Playoffs
42020,1610612746,LAC,LA Clippers,0042000224,2021-06-14T00:00:00Z,LAC vs. UTA,118,14,1610612762,UTA,Utah Jazz,UTA @ LAC,104,-14,Playoffs
42020,1610612737,ATL,Atlanta Hawks,0042000204,2021-06-14T00:00:00Z,ATL vs. PHI,103,3,1610612755,PHI,Philadelphia 76ers,PHI @ ATL,100,-3,Playoffs
42020,1610612751,BKN,Brooklyn Nets,0042000215,2021-06-15T00:00:00Z,BKN vs. MIL,114,6,1610612749,MIL,Milwaukee Bucks,MIL @ BKN,108,-6,Playoffs
42020,1610612762,UTA,Utah Jazz,0042000225,2021-06-16T00:00:00Z,UTA vs. LAC,111,-8,1610612746,LAC,LA Clippers,LAC @ UTA,119,8,Playoffs
42020,1610612755,PHI,Philadelphia 76ers,0042000205,2021-06-16T00:00:00Z,PHI vs. ATL,106,-3,1610612737,ATL,Atlanta Hawks,ATL @ PHI,109,3,Playoffs
42020,1610612749,MIL,Milwaukee Bucks,0042000216,2021-06-17T00:00:00Z,MIL vs. BKN,104,15,1610612751,BKN,Brooklyn Nets,BKN @ MIL,89,-15,Playoffs
42020,1610612746,LAC,LA Clippers,0042000226,2021-06-18T00:00:00Z,LAC vs. UTA,131,12,1610612762,UTA,Utah Jazz,UTA @ LAC,119,-12,Playoffs
42020,1610612737,ATL,Atlanta Hawks,0042000206,2021-06-18T00:00:00Z,ATL vs. PHI,99,-5,1610612755,PHI,Philadelphia 76ers,PHI @ ATL,104,5,Playoffs
42020,1610612751,BKN,Brooklyn Nets,0042000217,2021-06-19T00:00:00Z,BKN vs. MIL,111,-4,1610612749,MIL,Milwaukee Bucks,MIL @ BKN,115,4,Playoffs
42020,1610612755,PHI,Philadelphia 76ers,0042000207,2021-06-20T00:00:00Z,PHI vs. ATL,96,-7,1610612737,ATL,Atlanta Hawks,ATL @ PHI,103,7,Playoffs
42020,1610612756,PHX,Phoenix Suns,0042000311,2021-06-20T00:00:00Z,PHX vs. LAC,120,6,1610612746,LAC,LA Clippers,LAC @ PHX,114,-6,Playoffs
42020,1610612756,PHX,Phoenix Suns,0042000312,2021-06-22T00:00:00Z,PHX vs. LAC,104,1,1610612746,LAC,LA Clippers,LAC @ PHX,103,-1,Playoffs
42020,1610612749,MIL,Milwaukee Bucks,0042000301,2021-06-23T00:00:00Z,MIL vs. ATL,113,-3,1610612737,ATL,Atlanta Hawks,ATL @ MIL,116,3,Playoffs
42020,1610612746,LAC,LA Clippers,0042000313,2021-06-24T00:00:00Z,LAC vs. PHX,106,14,1610612756,PHX,Phoenix Suns,PHX @ LAC,92,-14,Playoffs
42020,1610612749,MIL,Milwaukee Bucks,0042000302,2021-06-25T00:00:00Z,MIL vs. ATL,125,34,1610612737,ATL,Atlanta Hawks,ATL @ MIL,91,-34,Playoffs
42020,1610612746,LAC,LA Clippers,0042000314,2021-06-26T00:00:00Z,LAC vs. PHX,80,-4,1610612756,PHX,Phoenix Suns,PHX @ LAC,84,4,Playoffs
42020,1610612737,ATL,Atlanta Hawks,0042000303,2021-06-27T00:00:00Z,ATL vs. MIL,102,-11,1610612749,MIL,Milwaukee Bucks,MIL @ ATL,113,11,Playoffs
42020,1610612756,PHX,Phoenix Suns,0042000315,2021-06-28T00:00:00Z,PHX vs. LAC,102,-14,1610612746,LAC,LA Clippers,LAC @ PHX,116,14,Playoffs
42020,1610612737,ATL,Atlanta Hawks,0042000304,2021-06-29T00:00:00Z,ATL vs. MIL,110,22,1610612749,MIL,Milwaukee Bucks,MIL @ ATL,88,-22,Playoffs
42020,1610612746,LAC,LA Clippers,0042000316,2021-06-30T00:00:00Z,LAC vs. PHX,103,-27,1610612756,PHX,Phoenix Suns,PHX @ LAC,130,27,Playoffs
42020,1610612749,MIL,Milwaukee Bucks,0042000305,2021-07-01T00:00:00Z,MIL vs. ATL,123,11,1610612737,ATL,Atlanta Hawks,ATL @ MIL,112,-11,Playoffs
42020,1610612737,ATL,Atlanta Hawks,0042000306,2021-07-03T00:00:00Z,ATL vs. MIL,107,-11,1610612749,MIL,Milwaukee Bucks,MIL @ ATL,118,11,Playoffs
42020,1610612756,PHX,Phoenix Suns,0042000401,2021-07-06T00:00:00Z,PHX vs. MIL,118,13,1610612749,MIL,Milwaukee Bucks,MIL @ PHX,105,-13,Playoffs
42020,1610612756,PHX,Phoenix Suns,0042000402,2021-07-08T00:00:00Z,PHX vs. MIL,118,10,1610612749,MIL,Milwaukee Bucks,MIL @ PHX,108,-10,Playoffs
42020,1610612749,MIL,Milwaukee Bucks,0042000403,2021-07-11T00:00:00Z,MIL vs. PHX,120,20,1610612756,PHX,Phoenix Suns,PHX @ MIL,100,-20,Playoffs
42020,1610612749,MIL,Milwaukee Bucks,0042000404,2021-07-14T00:00:00Z,MIL vs. PHX,109,6,1610612756,PHX,Phoenix Suns,PHX @ MIL,103,-6,Playoffs
42020,1610612756,PHX,Phoenix Suns,0042000405,2021-07-17T00:00:00Z,PHX vs. MIL,119,-4,1610612749,MIL,Milwaukee Bucks,MIL @ PHX,123,4,Playoffs
42020,1610612749,MIL,Milwaukee Bucks,0042000406,2021-07-20T00:00:00Z,MIL vs. PHX,105,7,1610612756,PHX,Phoenix Suns,PHX @ MIL,98,-7,Playoffs
32020,1610616833,DRT,Team Durant,0032000001,2021-03-07T00:00:00Z,DRT vs. LBN,150,-20,1610616834,LBN,Team LeBron,LBN @ DRT,170,20,All-Star
32020,1610616833,DRT,Team Durant,0032000001,2021-03-07T00:00:00Z,DRT vs. LBN,150,-20,1610616834,LBN,Team LeBron,LBN @ DRT,170,20,All Star
22021,1610612749,MIL,Milwaukee Bucks,0022100001,2021-10-19T00:00:00Z,MIL vs. BKN,127,23,1610612751,BKN,Brooklyn Nets,BKN @ MIL,104,-23,Regular Season
22021,1610612747,LAL,Los Angeles Lakers,0022100002,2021-10-19T00:00:00Z,LAL vs. GSW,114,-7,1610612744,GSW,Golden State Warriors,GSW @ LAL,121,7,Regular Season
22021,1610612757,POR,Portland Trail Blazers,0022100013,2021-10-20T00:00:00Z,POR vs. SAC,121,-3,1610612758,SAC,Sacramento Kings,SAC @ POR,124,3,Regular Season
22021,1610612756,PHX,Phoenix Suns,0022100012,2021-10-20T00:00:00Z,PHX vs. DEN,98,-12,1610612743,DEN,Denver Nuggets,DEN @ PHX,110,12,Regular Season
22021,1610612750,MIN,Minnesota Timberwolves,0022100008,2021-10-20T00:00:00Z,MIN vs. HOU,124,18,1610612745,HOU,Houston Rockets,HOU @ MIN,106,-18,Regular Season
22021,1610612766,CHA,Charlotte Hornets,0022100003,2021-10-20T00:00:00Z,CHA vs. IND,123,1,1610612754,IND,Indiana Pacers,IND @ CHA,122,-1,Regular Season
22021,1610612763,MEM,Memphis Grizzlies,0022100007,2021-10-20T00:00:00Z,MEM vs. CLE,132,11,1610612739,CLE,Cleveland Cavaliers,CLE @ MEM,121,-11,Regular Season
22021,1610612762,UTA,Utah Jazz,0022100011,2021-10-20T00:00:00Z,UTA vs. OKC,107,21,1610612760,OKC,Oklahoma City Thunder,OKC @ UTA,86,-21,Regular Season
22021,1610612759,SAS,San Antonio Spurs,0022100010,2021-10-20T00:00:00Z,SAS vs. ORL,123,26,1610612753,ORL,Orlando Magic,ORL @ SAS,97,-26,Regular Season
22021,1610612752,NYK,New York Knicks,0022100005,2021-10-20T00:00:00Z,NYK vs. BOS,138,4,1610612738,BOS,Boston Celtics,BOS @ NYK,134,-4,Regular Season
22021,1610612740,NOP,New Orleans Pelicans,0022100009,2021-10-20T00:00:00Z,NOP vs. PHI,97,-20,1610612755,PHI,Philadelphia 76ers,PHI @ NOP,117,20,Regular Season
22021,1610612765,DET,Detroit Pistons,0022100004,2021-10-20T00:00:00Z,DET vs. CHI,88,-6,1610612741,CHI,Chicago Bulls,CHI @ DET,94,6,Regular Season
22021,1610612761,TOR,Toronto Raptors,0022100006,2021-10-20T00:00:00Z,TOR vs. WAS,83,-15,1610612764,WAS,Washington Wizards,WAS @ TOR,98,15,Regular Season
22021,1610612737,ATL,Atlanta Hawks,0022100014,2021-10-21T00:00:00Z,ATL vs. DAL,113,26,1610612742,DAL,Dallas Mavericks,DAL @ ATL,87,-26,Regular Season
22021,1610612744,GSW,Golden State Warriors,0022100016,2021-10-21T00:00:00Z,GSW vs. LAC,115,2,1610612746,LAC,LA Clippers,LAC @ GSW,113,-2,Regular Season
22021,1610612748,MIA,Miami Heat,0022100015,2021-10-21T00:00:00Z,MIA vs. MIL,137,42,1610612749,MIL,Milwaukee Bucks,MIL @ MIA,95,-42,Regular Season
22021,1610612758,SAC,Sacramento Kings,0022100026,2021-10-22T00:00:00Z,SAC vs. UTA,101,-9,1610612762,UTA,Utah Jazz,UTA @ SAC,110,9,Regular Season
22021,1610612755,PHI,Philadelphia 76ers,0022100021,2021-10-22T00:00:00Z,PHI vs. BKN,109,-5,1610612751,BKN,Brooklyn Nets,BKN @ PHI,114,5,Regular Season
22021,1610612738,BOS,Boston Celtics,0022100020,2021-10-22T00:00:00Z,BOS vs. TOR,83,-32,1610612761,TOR,Toronto Raptors,TOR @ BOS,115,32,Regular Season
22021,1610612747,LAL,Los Angeles Lakers,0022100025,2021-10-22T00:00:00Z,LAL vs. PHX,105,-10,1610612756,PHX,Phoenix Suns,PHX @ LAL,115,10,Regular Season
22021,1610612743,DEN,Denver Nuggets,0022100024,2021-10-22T00:00:00Z,DEN vs. SAS,102,6,1610612759,SAS,San Antonio Spurs,SAS @ DEN,96,-6,Regular Season
22021,1610612741,CHI,Chicago Bulls,0022100022,2021-10-22T00:00:00Z,CHI vs. NOP,128,16,1610612740,NOP,New Orleans Pelicans,NOP @ CHI,112,-16,Regular Season
22021,1610612745,HOU,Houston Rockets,0022100023,2021-10-22T00:00:00Z,HOU vs. OKC,124,33,1610612760,OKC,Oklahoma City Thunder,OKC @ HOU,91,-33,Regular Season
22021,1610612753,ORL,Orlando Magic,0022100018,2021-10-22T00:00:00Z,ORL vs. NYK,96,-25,1610612752,NYK,New York Knicks,NYK @ ORL,121,25,Regular Season
22021,1610612739,CLE,Cleveland Cavaliers,0022100017,2021-10-22T00:00:00Z,CLE vs. CHA,112,-11,1610612766,CHA,Charlotte Hornets,CHA @ CLE,123,11,Regular Season
22021,1610612764,WAS,Washington Wizards,0022100019,2021-10-22T00:00:00Z,WAS vs. IND,135,1,1610612754,IND,Indiana Pacers,IND @ WAS,134,-1,Regular Season
22021,1610612757,POR,Portland Trail Blazers,0022100033,2021-10-23T00:00:00Z,POR vs. PHX,134,29,1610612756,PHX,Phoenix Suns,PHX @ POR,105,-29,Regular Season
22021,1610612759,SAS,San Antonio Spurs,0022100032,2021-10-23T00:00:00Z,SAS vs. MIL,111,-10,1610612749,MIL,Milwaukee Bucks,MIL @ SAS,121,10,Regular Season
22021,1610612746,LAC,LA Clippers,0022100034,2021-10-23T00:00:00Z,LAC vs. MEM,114,-6,1610612763,MEM,Memphis Grizzlies,MEM @ LAC,120,6,Regular Season
22021,1610612754,IND,Indiana Pacers,0022100028,2021-10-23T00:00:00Z,IND vs. MIA,102,11,1610612748,MIA,Miami Heat,MIA @ IND,91,-11,Regular Season
22021,1610612741,CHI,Chicago Bulls,0022100030,2021-10-23T00:00:00Z,CHI vs. DET,97,15,1610612765,DET,Detroit Pistons,DET @ CHI,82,-15,Regular Season
22021,1610612761,TOR,Toronto Raptors,0022100029,2021-10-23T00:00:00Z,TOR vs. DAL,95,-8,1610612742,DAL,Dallas Mavericks,DAL @ TOR,103,8,Regular Season
22021,1610612739,CLE,Cleveland Cavaliers,0022100027,2021-10-23T00:00:00Z,CLE vs. ATL,101,6,1610612737,ATL,Atlanta Hawks,ATL @ CLE,95,-6,Regular Season
22021,1610612750,MIN,Minnesota Timberwolves,0022100031,2021-10-23T00:00:00Z,MIN vs. NOP,96,7,1610612740,NOP,New Orleans Pelicans,NOP @ MIN,89,-7,Regular Season
22021,1610612752,NYK,New York Knicks,0022100036,2021-10-24T00:00:00Z,NYK vs. ORL,104,-6,1610612753,ORL,Orlando Magic,ORL @ NYK,110,6,Regular Season
22021,1610612758,SAC,Sacramento Kings,0022100039,2021-10-24T00:00:00Z,SAC vs. GSW,107,-12,1610612744,GSW,Golden State Warriors,GSW @ SAC,119,12,Regular Season
22021,1610612747,LAL,Los Angeles Lakers,0022100040,2021-10-24T00:00:00Z,LAL vs. MEM,121,3,1610612763,MEM,Memphis Grizzlies,MEM @ LAL,118,-3,Regular Season
22021,1610612760,OKC,Oklahoma City Thunder,0022100038,2021-10-24T00:00:00Z,OKC vs. PHI,103,-12,1610612755,PHI,Philadelphia 76ers,PHI @ OKC,115,12,Regular Season
22021,1610612745,HOU,Houston Rockets,0022100037,2021-10-24T00:00:00Z,HOU vs. BOS,97,-10,1610612738,BOS,Boston Celtics,BOS @ HOU,107,10,Regular Season
22021,1610612751,BKN,Brooklyn Nets,0022100035,2021-10-24T00:00:00Z,BKN vs. CHA,95,-16,1610612766,CHA,Charlotte Hornets,CHA @ BKN,111,16,Regular Season
22021,1610612737,ATL,Atlanta Hawks,0022100043,2021-10-25T00:00:00Z,ATL vs. DET,122,18,1610612765,DET,Detroit Pistons,DET @ ATL,104,-18,Regular Season
22021,1610612761,TOR,Toronto Raptors,0022100046,2021-10-25T00:00:00Z,TOR vs. CHI,108,-3,1610612741,CHI,Chicago Bulls,CHI @ TOR,111,3,Regular Season
22021,1610612746,LAC,LA Clippers,0022100049,2021-10-25T00:00:00Z,LAC vs. POR,116,30,1610612757,POR,Portland Trail Blazers,POR @ LAC,86,-30,Regular Season
22021,1610612743,DEN,Denver Nuggets,0022100048,2021-10-25T00:00:00Z,DEN vs. CLE,87,-12,1610612739,CLE,Cleveland Cavaliers,CLE @ DEN,99,12,Regular Season
22021,1610612750,MIN,Minnesota Timberwolves,0022100047,2021-10-25T00:00:00Z,MIN vs. NOP,98,-9,1610612740,NOP,New Orleans Pelicans,NOP @ MIN,107,9,Regular Season
22021,1610612751,BKN,Brooklyn Nets,0022100044,2021-10-25T00:00:00Z,BKN vs. WAS,104,14,1610612764,WAS,Washington Wizards,WAS @ BKN,90,-14,Regular Season
22021,1610612748,MIA,Miami Heat,0022100045,2021-10-25T00:00:00Z,MIA vs. ORL,107,17,1610612753,ORL,Orlando Magic,ORL @ MIA,90,-17,Regular Season
22021,1610612766,CHA,Charlotte Hornets,0022100041,2021-10-25T00:00:00Z,CHA vs. BOS,129,-11,1610612738,BOS,Boston Celtics,BOS @ CHA,140,11,Regular Season
22021,1610612754,IND,Indiana Pacers,0022100042,2021-10-25T00:00:00Z,IND vs. MIL,109,-10,1610612749,MIL,Milwaukee Bucks,MIL @ IND,119,10,Regular Season
22021,1610612742,DAL,Dallas Mavericks,0022100052,2021-10-26T00:00:00Z,DAL vs. HOU,116,10,1610612745,HOU,Houston Rockets,HOU @ DAL,106,-10,Regular Season
22021,1610612752,NYK,New York Knicks,0022100050,2021-10-26T00:00:00Z,NYK vs. PHI,112,13,1610612755,PHI,Philadelphia 76ers,PHI @ NYK,99,-13,Regular Season
22021,1610612759,SAS,San Antonio Spurs,0022100053,2021-10-26T00:00:00Z,SAS vs. LAL,121,-4,1610612747,LAL,Los Angeles Lakers,LAL @ SAS,125,4,Regular Season
22021,1610612762,UTA,Utah Jazz,0022100054,2021-10-26T00:00:00Z,UTA vs. DEN,122,12,1610612743,DEN,Denver Nuggets,DEN @ UTA,110,-12,Regular Season
22021,1610612760,OKC,Oklahoma City Thunder,0022100051,2021-10-26T00:00:00Z,OKC vs. GSW,98,-8,1610612744,GSW,Golden State Warriors,GSW @ OKC,106,8,Regular Season
22021,1610612761,TOR,Toronto Raptors,0022100058,2021-10-27T00:00:00Z,TOR vs. IND,118,18,1610612754,IND,Indiana Pacers,IND @ TOR,100,-18,Regular Season
22021,1610612738,BOS,Boston Celtics,0022100056,2021-10-27T00:00:00Z,BOS vs. WAS,107,-9,1610612764,WAS,Washington Wizards,WAS @ BOS,116,9,Regular Season
22021,1610612756,PHX,Phoenix Suns,0022100062,2021-10-27T00:00:00Z,PHX vs. SAC,107,-3,1610612758,SAC,Sacramento Kings,SAC @ PHX,110,3,Regular Season
22021,1610612746,LAC,LA Clippers,0022100064,2021-10-27T00:00:00Z,LAC vs. CLE,79,-13,1610612739,CLE,Cleveland Cavaliers,CLE @ LAC,92,13,Regular Season
22021,1610612757,POR,Portland Trail Blazers,0022100063,2021-10-27T00:00:00Z,POR vs. MEM,116,20,1610612763,MEM,Memphis Grizzlies,MEM @ POR,96,-20,Regular Season
22021,1610612760,OKC,Oklahoma City Thunder,0022100061,2021-10-27T00:00:00Z,OKC vs. LAL,123,8,1610612747,LAL,Los Angeles Lakers,LAL @ OKC,115,-8,Regular Season
22021,1610612749,MIL,Milwaukee Bucks,0022100060,2021-10-27T00:00:00Z,MIL vs. MIN,108,-5,1610612750,MIN,Minnesota Timberwolves,MIN @ MIL,113,5,Regular Season
22021,1610612740,NOP,New Orleans Pelicans,0022100059,2021-10-27T00:00:00Z,NOP vs. ATL,99,-3,1610612737,ATL,Atlanta Hawks,ATL @ NOP,102,3,Regular Season
22021,1610612751,BKN,Brooklyn Nets,0022100057,2021-10-27T00:00:00Z,BKN vs. MIA,93,-13,1610612748,MIA,Miami Heat,MIA @ BKN,106,13,Regular Season
22021,1610612753,ORL,Orlando Magic,0022100055,2021-10-27T00:00:00Z,ORL vs. CHA,111,-9,1610612766,CHA,Charlotte Hornets,CHA @ ORL,120,9,Regular Season
22021,1610612741,CHI,Chicago Bulls,0022100067,2021-10-28T00:00:00Z,CHI vs. NYK,103,-1,1610612752,NYK,New York Knicks,NYK @ CHI,104,1,Regular Season
22021,1610612742,DAL,Dallas Mavericks,0022100069,2021-10-28T00:00:00Z,DAL vs. SAS,104,5,1610612759,SAS,San Antonio Spurs,SAS @ DAL,99,-5,Regular Season
22021,1610612744,GSW,Golden State Warriors,0022100070,2021-10-28T00:00:00Z,GSW vs. MEM,101,-3,1610612763,MEM,Memphis Grizzlies,MEM @ GSW,104,3,Regular Season
22021,1610612745,HOU,Houston Rockets,0022100068,2021-10-28T00:00:00Z,HOU vs. UTA,91,-31,1610612762,UTA,Utah Jazz,UTA @ HOU,122,31,Regular Season
22021,1610612764,WAS,Washington Wizards,0022100066,2021-10-28T00:00:00Z,WAS vs. ATL,122,11,1610612737,ATL,Atlanta Hawks,ATL @ WAS,111,-11,Regular Season
22021,1610612755,PHI,Philadelphia 76ers,0022100065,2021-10-28T00:00:00Z,PHI vs. DET,110,8,1610612765,DET,Detroit Pistons,DET @ PHI,102,-8,Regular Season
22021,1610612757,POR,Portland Trail Blazers,0022100076,2021-10-29T00:00:00Z,POR vs. LAC,111,19,1610612746,LAC,LA Clippers,LAC @ POR,92,-19,Regular Season
22021,1610612748,MIA,Miami Heat,0022100073,2021-10-29T00:00:00Z,MIA vs. CHA,114,15,1610612766,CHA,Charlotte Hornets,CHA @ MIA,99,-15,Regular Season
22021,1610612743,DEN,Denver Nuggets,0022100075,2021-10-29T00:00:00Z,DEN vs. DAL,106,31,1610612742,DAL,Dallas Mavericks,DAL @ DEN,75,-31,Regular Season
22021,1610612751,BKN,Brooklyn Nets,0022100072,2021-10-29T00:00:00Z,BKN vs. IND,105,7,1610612754,IND,Indiana Pacers,IND @ BKN,98,-7,Regular Season
22021,1610612747,LAL,Los Angeles Lakers,0022100077,2021-10-29T00:00:00Z,LAL vs. CLE,113,12,1610612739,CLE,Cleveland Cavaliers,CLE @ LAL,101,-12,Regular Season
22021,1610612740,NOP,New Orleans Pelicans,0022100074,2021-10-29T00:00:00Z,NOP vs. SAC,109,-4,1610612758,SAC,Sacramento Kings,SAC @ NOP,113,4,Regular Season
22021,1610612761,TOR,Toronto Raptors,0022100071,2021-10-29T00:00:00Z,TOR vs. ORL,110,1,1610612753,ORL,Orlando Magic,ORL @ TOR,109,-1,Regular Season
22021,1610612754,IND,Indiana Pacers,0022100081,2021-10-30T00:00:00Z,IND vs. TOR,94,-3,1610612761,TOR,Toronto Raptors,TOR @ IND,97,3,Regular Season
22021,1610612744,GSW,Golden State Warriors,0022100086,2021-10-30T00:00:00Z,GSW vs. OKC,103,21,1610612760,OKC,Oklahoma City Thunder,OKC @ GSW,82,-21,Regular Season
22021,1610612750,MIN,Minnesota Timberwolves,0022100087,2021-10-30T00:00:00Z,MIN vs. DEN,91,-2,1610612743,DEN,Denver Nuggets,DEN @ MIN,93,2,Regular Season
22021,1610612756,PHX,Phoenix Suns,0022100088,2021-10-30T00:00:00Z,PHX vs. CLE,101,9,1610612739,CLE,Cleveland Cavaliers,CLE @ PHX,92,-9,Regular Season
22021,1610612741,CHI,Chicago Bulls,0022100083,2021-10-30T00:00:00Z,CHI vs. UTA,107,8,1610612762,UTA,Utah Jazz,UTA @ CHI,99,-8,Regular Season
22021,1610612749,MIL,Milwaukee Bucks,0022100085,2021-10-30T00:00:00Z,MIL vs. SAS,93,-9,1610612759,SAS,San Antonio Spurs,SAS @ MIL,102,9,Regular Season
22021,1610612763,MEM,Memphis Grizzlies,0022100084,2021-10-30T00:00:00Z,MEM vs. MIA,103,-26,1610612748,MIA,Miami Heat,MIA @ MEM,129,26,Regular Season
22021,1610612755,PHI,Philadelphia 76ers,0022100082,2021-10-30T00:00:00Z,PHI vs. ATL,122,28,1610612737,ATL,Atlanta Hawks,ATL @ PHI,94,-28,Regular Season
22021,1610612765,DET,Detroit Pistons,0022100079,2021-10-30T00:00:00Z,DET vs. ORL,110,7,1610612753,ORL,Orlando Magic,ORL @ DET,103,-7,Regular Season
22021,1610612740,NOP,New Orleans Pelicans,0022100080,2021-10-30T00:00:00Z,NOP vs. NYK,117,-6,1610612752,NYK,New York Knicks,NYK @ NOP,123,6,Regular Season
22021,1610612764,WAS,Washington Wizards,0022100078,2021-10-30T00:00:00Z,WAS vs. BOS,115,3,1610612738,BOS,Boston Celtics,BOS @ WAS,112,-3,Regular Season
22021,1610612749,MIL,Milwaukee Bucks,0022100091,2021-10-31T00:00:00Z,MIL vs. UTA,95,-12,1610612762,UTA,Utah Jazz,UTA @ MIL,107,12,Regular Season
22021,1610612742,DAL,Dallas Mavericks,0022100089,2021-10-31T00:00:00Z,DAL vs. SAC,105,6,1610612758,SAC,Sacramento Kings,SAC @ DAL,99,-6,Regular Season
22021,1610612766,CHA,Charlotte Hornets,0022100090,2021-10-31T00:00:00Z,CHA vs. POR,125,12,1610612757,POR,Portland Trail Blazers,POR @ CHA,113,-12,Regular Season
22021,1610612751,BKN,Brooklyn Nets,0022100092,2021-10-31T00:00:00Z,BKN vs. DET,117,26,1610612765,DET,Detroit Pistons,DET @ BKN,91,-26,Regular Season
22021,1610612747,LAL,Los Angeles Lakers,0022100093,2021-10-31T00:00:00Z,LAL vs. HOU,95,10,1610612745,HOU,Houston Rockets,HOU @ LAL,85,-10,Regular Season
22021,1610612755,PHI,Philadelphia 76ers,0022100096,2021-11-01T00:00:00Z,PHI vs. POR,113,10,1610612757,POR,Portland Trail Blazers,POR @ PHI,103,-10,Regular Season
22021,1610612738,BOS,Boston Celtics,0022100098,2021-11-01T00:00:00Z,BOS vs. CHI,114,-14,1610612741,CHI,Chicago Bulls,CHI @ BOS,128,14,Regular Season
22021,1610612766,CHA,Charlotte Hornets,0022100094,2021-11-01T00:00:00Z,CHA vs. CLE,110,-3,1610612739,CLE,Cleveland Cavaliers,CLE @ CHA,113,3,Regular Season
22021,1610612754,IND,Indiana Pacers,0022100095,2021-11-01T00:00:00Z,IND vs. SAS,131,13,1610612759,SAS,San Antonio Spurs,SAS @ IND,118,-13,Regular Season
22021,1610612752,NYK,New York Knicks,0022100099,2021-11-01T00:00:00Z,NYK vs. TOR,104,-9,1610612761,TOR,Toronto Raptors,TOR @ NYK,113,9,Regular Season
22021,1610612746,LAC,LA Clippers,0022100102,2021-11-01T00:00:00Z,LAC vs. OKC,99,5,1610612760,OKC,Oklahoma City Thunder,OKC @ LAC,94,-5,Regular Season
22021,1610612750,MIN,Minnesota Timberwolves,0022100101,2021-11-01T00:00:00Z,MIN vs. ORL,97,-18,1610612753,ORL,Orlando Magic,ORL @ MIN,115,18,Regular Season
22021,1610612763,MEM,Memphis Grizzlies,0022100100,2021-11-01T00:00:00Z,MEM vs. DEN,106,9,1610612743,DEN,Denver Nuggets,DEN @ MEM,97,-9,Regular Season
22021,1610612737,ATL,Atlanta Hawks,0022100097,2021-11-01T00:00:00Z,ATL vs. WAS,118,7,1610612764,WAS,Washington Wizards,WAS @ ATL,111,-7,Regular Season
22021,1610612742,DAL,Dallas Mavericks,0022100104,2021-11-02T00:00:00Z,DAL vs. MIA,110,-15,1610612748,MIA,Miami Heat,MIA @ DAL,125,15,Regular Season
22021,1610612756,PHX,Phoenix Suns,0022100106,2021-11-02T00:00:00Z,PHX vs. NOP,112,12,1610612740,NOP,New Orleans Pelicans,NOP @ PHX,100,-12,Regular Season
22021,1610612762,UTA,Utah Jazz,0022100105,2021-11-02T00:00:00Z,UTA vs. SAC,119,6,1610612758,SAC,Sacramento Kings,SAC @ UTA,113,-6,Regular Season
22021,1610612747,LAL,Los Angeles Lakers,0022100107,2021-11-02T00:00:00Z,LAL vs. HOU,119,2,1610612745,HOU,Houston Rockets,HOU @ LAL,117,-2,Regular Season
22021,1610612765,DET,Detroit Pistons,0022100103,2021-11-02T00:00:00Z,DET vs. MIL,89,-28,1610612749,MIL,Milwaukee Bucks,MIL @ DET,117,28,Regular Season
22021,1610612763,MEM,Memphis Grizzlies,0022100114,2021-11-03T00:00:00Z,MEM vs. DEN,108,2,1610612743,DEN,Denver Nuggets,DEN @ MEM,106,-2,Regular Season
22021,1610612751,BKN,Brooklyn Nets,0022100113,2021-11-03T00:00:00Z,BKN vs. ATL,117,9,1610612737,ATL,Atlanta Hawks,ATL @ BKN,108,-9,Regular Season
22021,1610612759,SAS,San Antonio Spurs,0022100116,2021-11-03T00:00:00Z,SAS vs. DAL,108,-1,1610612742,DAL,Dallas Mavericks,DAL @ SAS,109,1,Regular Season
22021,1610612753,ORL,Orlando Magic,0022100110,2021-11-03T00:00:00Z,ORL vs. BOS,79,-13,1610612738,BOS,Boston Celtics,BOS @ ORL,92,13,Regular Season
22021,1610612750,MIN,Minnesota Timberwolves,0022100115,2021-11-03T00:00:00Z,MIN vs. LAC,115,-11,1610612746,LAC,LA Clippers,LAC @ MIN,126,11,Regular Season
22021,1610612744,GSW,Golden State Warriors,0022100117,2021-11-03T00:00:00Z,GSW vs. CHA,114,22,1610612766,CHA,Charlotte Hornets,CHA @ GSW,92,-22,Regular Season
22021,1610612758,SAC,Sacramento Kings,0022100118,2021-11-03T00:00:00Z,SAC vs. NOP,112,13,1610612740,NOP,New Orleans Pelicans,NOP @ SAC,99,-13,Regular Season
22021,1610612755,PHI,Philadelphia 76ers,0022100111,2021-11-03T00:00:00Z,PHI vs. CHI,103,5,1610612741,CHI,Chicago Bulls,CHI @ PHI,98,-5,Regular Season
22021,1610612764,WAS,Washington Wizards,0022100112,2021-11-03T00:00:00Z,WAS vs. TOR,100,-9,1610612761,TOR,Toronto Raptors,TOR @ WAS,109,9,Regular Season
22021,1610612739,CLE,Cleveland Cavaliers,0022100108,2021-11-03T00:00:00Z,CLE vs. POR,107,3,1610612757,POR,Portland Trail Blazers,POR @ CLE,104,-3,Regular Season
22021,1610612754,IND,Indiana Pacers,0022100109,2021-11-03T00:00:00Z,IND vs. NYK,111,13,1610612752,NYK,New York Knicks,NYK @ IND,98,-13,Regular Season
22021,1610612747,LAL,Los Angeles Lakers,0022100123,2021-11-04T00:00:00Z,LAL vs. OKC,104,-3,1610612760,OKC,Oklahoma City Thunder,OKC @ LAL,107,3,Regular Season
22021,1610612756,PHX,Phoenix Suns,0022100122,2021-11-04T00:00:00Z,PHX vs. HOU,123,12,1610612745,HOU,Houston Rockets,HOU @ PHX,111,-12,Regular Season
22021,1610612737,ATL,Atlanta Hawks,0022100120,2021-11-04T00:00:00Z,ATL vs. UTA,98,-18,1610612762,UTA,Utah Jazz,UTA @ ATL,116,18,Regular Season
22021,1610612748,MIA,Miami Heat,0022100121,2021-11-04T00:00:00Z,MIA vs. BOS,78,-17,1610612738,BOS,Boston Celtics,BOS @ MIA,95,17,Regular Season
22021,1610612765,DET,Detroit Pistons,0022100119,2021-11-04T00:00:00Z,DET vs. PHI,98,-11,1610612755,PHI,Philadelphia 76ers,PHI @ DET,109,11,Regular Season
22021,1610612753,ORL,Orlando Magic,0022100125,2021-11-05T00:00:00Z,ORL vs. SAS,89,-13,1610612759,SAS,San Antonio Spurs,SAS @ ORL,102,13,Regular Season
22021,1610612758,SAC,Sacramento Kings,0022100132,2021-11-05T00:00:00Z,SAC vs. CHA,140,30,1610612766,CHA,Charlotte Hornets,CHA @ SAC,110,-30,Regular Season
22021,1610612764,WAS,Washington Wizards,0022100126,2021-11-05T00:00:00Z,WAS vs. MEM,115,28,1610612763,MEM,Memphis Grizzlies,MEM @ WAS,87,-28,Regular Season
22021,1610612750,MIN,Minnesota Timberwolves,0022100129,2021-11-05T00:00:00Z,MIN vs. LAC,84,-20,1610612746,LAC,LA Clippers,LAC @ MIN,104,20,Regular Season
22021,1610612749,MIL,Milwaukee Bucks,0022100128,2021-11-05T00:00:00Z,MIL vs. NYK,98,-15,1610612752,NYK,New York Knicks,NYK @ MIL,113,15,Regular Season
22021,1610612765,DET,Detroit Pistons,0022100124,2021-11-05T00:00:00Z,DET vs. BKN,90,-6,1610612751,BKN,Brooklyn Nets,BKN @ DET,96,6,Regular Season
22021,1610612744,GSW,Golden State Warriors,0022100130,2021-11-05T00:00:00Z,GSW vs. NOP,126,41,1610612740,NOP,New Orleans Pelicans,NOP @ GSW,85,-41,Regular Season
22021,1610612757,POR,Portland Trail Blazers,0022100131,2021-11-05T00:00:00Z,POR vs. IND,110,4,1610612754,IND,Indiana Pacers,IND @ POR,106,-4,Regular Season
22021,1610612761,TOR,Toronto Raptors,0022100127,2021-11-05T00:00:00Z,TOR vs. CLE,101,-1,1610612739,CLE,Cleveland Cavaliers,CLE @ TOR,102,1,Regular Season
22021,1610612756,PHX,Phoenix Suns,0022100137,2021-11-06T00:00:00Z,PHX vs. ATL,121,4,1610612737,ATL,Atlanta Hawks,ATL @ PHX,117,-4,Regular Season
22021,1610612741,CHI,Chicago Bulls,0022100135,2021-11-06T00:00:00Z,CHI vs. PHI,105,-9,1610612755,PHI,Philadelphia 76ers,PHI @ CHI,114,9,Regular Season
22021,1610612757,POR,Portland Trail Blazers,0022100138,2021-11-06T00:00:00Z,POR vs. LAL,105,15,1610612747,LAL,Los Angeles Lakers,LAL @ POR,90,-15,Regular Season
22021,1610612742,DAL,Dallas Mavericks,0022100136,2021-11-06T00:00:00Z,DAL vs. BOS,107,3,1610612738,BOS,Boston Celtics,BOS @ DAL,104,-3,Regular Season
22021,1610612748,MIA,Miami Heat,0022100134,2021-11-06T00:00:00Z,MIA vs. UTA,118,3,1610612762,UTA,Utah Jazz,UTA @ MIA,115,-3,Regular Season
22021,1610612743,DEN,Denver Nuggets,0022100133,2021-11-06T00:00:00Z,DEN vs. HOU,95,1,1610612745,HOU,Houston Rockets,HOU @ DEN,94,-1,Regular Season
22021,1610612753,ORL,Orlando Magic,0022100141,2021-11-07T00:00:00Z,ORL vs. UTA,107,7,1610612762,UTA,Utah Jazz,UTA @ ORL,100,-7,Regular Season
22021,1610612761,TOR,Toronto Raptors,0022100139,2021-11-07T00:00:00Z,TOR vs. BKN,103,-13,1610612751,BKN,Brooklyn Nets,BKN @ TOR,116,13,Regular Season
22021,1610612764,WAS,Washington Wizards,0022100142,2021-11-07T00:00:00Z,WAS vs. MIL,101,7,1610612749,MIL,Milwaukee Bucks,MIL @ WAS,94,-7,Regular Season
22021,1610612746,LAC,LA Clippers,0022100146,2021-11-07T00:00:00Z,LAC vs. CHA,120,14,1610612766,CHA,Charlotte Hornets,CHA @ LAC,106,-14,Regular Season
22021,1610612744,GSW,Golden State Warriors,0022100145,2021-11-07T00:00:00Z,GSW vs. HOU,120,13,1610612745,HOU,Houston Rockets,HOU @ GSW,107,-13,Regular Season
22021,1610612752,NYK,New York Knicks,0022100140,2021-11-07T00:00:00Z,NYK vs. CLE,109,-17,1610612739,CLE,Cleveland Cavaliers,CLE @ NYK,126,17,Regular Season
22021,1610612760,OKC,Oklahoma City Thunder,0022100144,2021-11-07T00:00:00Z,OKC vs. SAS,99,5,1610612759,SAS,San Antonio Spurs,SAS @ OKC,94,-5,Regular Season
22021,1610612758,SAC,Sacramento Kings,0022100143,2021-11-07T00:00:00Z,SAC vs. IND,91,-3,1610612754,IND,Indiana Pacers,IND @ SAC,94,3,Regular Season
22021,1610612755,PHI,Philadelphia 76ers,0022100147,2021-11-08T00:00:00Z,PHI vs. NYK,96,-7,1610612752,NYK,New York Knicks,NYK @ PHI,103,7,Regular Season
22021,1610612744,GSW,Golden State Warriors,0022100152,2021-11-08T00:00:00Z,GSW vs. ATL,127,14,1610612737,ATL,Atlanta Hawks,ATL @ GSW,113,-14,Regular Season
22021,1610612758,SAC,Sacramento Kings,0022100153,2021-11-08T00:00:00Z,SAC vs. PHX,104,-5,1610612756,PHX,Phoenix Suns,PHX @ SAC,109,5,Regular Season
22021,1610612741,CHI,Chicago Bulls,0022100148,2021-11-08T00:00:00Z,CHI vs. BKN,118,23,1610612751,BKN,Brooklyn Nets,BKN @ CHI,95,-23,Regular Season
22021,1610612747,LAL,Los Angeles Lakers,0022100154,2021-11-08T00:00:00Z,LAL vs. CHA,126,3,1610612766,CHA,Charlotte Hornets,CHA @ LAL,123,-3,Regular Season
22021,1610612743,DEN,Denver Nuggets,0022100151,2021-11-08T00:00:00Z,DEN vs. MIA,113,17,1610612748,MIA,Miami Heat,MIA @ DEN,96,-17,Regular Season
22021,1610612742,DAL,Dallas Mavericks,0022100150,2021-11-08T00:00:00Z,DAL vs. NOP,108,16,1610612740,NOP,New Orleans Pelicans,NOP @ DAL,92,-16,Regular Season
22021,1610612763,MEM,Memphis Grizzlies,0022100149,2021-11-08T00:00:00Z,MEM vs. MIN,125,7,1610612750,MIN,Minnesota Timberwolves,MIN @ MEM,118,-7,Regular Season
22021,1610612746,LAC,LA Clippers,0022100157,2021-11-09T00:00:00Z,LAC vs. POR,117,8,1610612757,POR,Portland Trail Blazers,POR @ LAC,109,-8,Regular Season
22021,1610612755,PHI,Philadelphia 76ers,0022100155,2021-11-09T00:00:00Z,PHI vs. MIL,109,-9,1610612749,MIL,Milwaukee Bucks,MIL @ PHI,118,9,Regular Season
22021,1610612762,UTA,Utah Jazz,0022100156,2021-11-09T00:00:00Z,UTA vs. ATL,110,12,1610612737,ATL,Atlanta Hawks,ATL @ UTA,98,-12,Regular Season
22021,1610612743,DEN,Denver Nuggets,0022100167,2021-11-10T00:00:00Z,DEN vs. IND,101,3,1610612754,IND,Indiana Pacers,IND @ DEN,98,-3,Regular Season
22021,1610612763,MEM,Memphis Grizzlies,0022100164,2021-11-10T00:00:00Z,MEM vs. CHA,108,-10,1610612766,CHA,Charlotte Hornets,CHA @ MEM,118,10,Regular Season
22021,1610612759,SAS,San Antonio Spurs,0022100166,2021-11-10T00:00:00Z,SAS vs. SAC,136,19,1610612758,SAC,Sacramento Kings,SAC @ SAS,117,-19,Regular Season
22021,1610612738,BOS,Boston Celtics,0022100160,2021-11-10T00:00:00Z,BOS vs. TOR,104,16,1610612761,TOR,Toronto Raptors,TOR @ BOS,88,-16,Regular Season
22021,1610612753,ORL,Orlando Magic,0022100159,2021-11-10T00:00:00Z,ORL vs. BKN,90,-33,1610612751,BKN,Brooklyn Nets,BKN @ ORL,123,33,Regular Season
22021,1610612739,CLE,Cleveland Cavaliers,0022100158,2021-11-10T00:00:00Z,CLE vs. WAS,94,-3,1610612764,WAS,Washington Wizards,WAS @ CLE,97,3,Regular Season
22021,1610612744,GSW,Golden State Warriors,0022100169,2021-11-10T00:00:00Z,GSW vs. MIN,123,13,1610612750,MIN,Minnesota Timberwolves,MIN @ GSW,110,-13,Regular Season
22021,1610612747,LAL,Los Angeles Lakers,0022100170,2021-11-10T00:00:00Z,LAL vs. MIA,120,3,1610612748,MIA,Miami Heat,MIA @ LAL,117,-3,Regular Season
22021,1610612741,CHI,Chicago Bulls,0022100163,2021-11-10T00:00:00Z,CHI vs. DAL,117,10,1610612742,DAL,Dallas Mavericks,DAL @ CHI,107,-10,Regular Season
22021,1610612745,HOU,Houston Rockets,0022100162,2021-11-10T00:00:00Z,HOU vs. DET,104,-8,1610612765,DET,Detroit Pistons,DET @ HOU,112,8,Regular Season
22021,1610612752,NYK,New York Knicks,0022100161,2021-11-10T00:00:00Z,NYK vs. MIL,100,-12,1610612749,MIL,Milwaukee Bucks,MIL @ NYK,112,12,Regular Season
22021,1610612756,PHX,Phoenix Suns,0022100168,2021-11-10T00:00:00Z,PHX vs. POR,119,10,1610612757,POR,Portland Trail Blazers,POR @ PHX,109,-10,Regular Season
22021,1610612740,NOP,New Orleans Pelicans,0022100165,2021-11-10T00:00:00Z,NOP vs. OKC,100,-8,1610612760,OKC,Oklahoma City Thunder,OKC @ NOP,108,8,Regular Season
22021,1610612762,UTA,Utah Jazz,0022100172,2021-11-11T00:00:00Z,UTA vs. IND,100,-11,1610612754,IND,Indiana Pacers,IND @ UTA,111,11,Regular Season
22021,1610612746,LAC,LA Clippers,0022100173,2021-11-11T00:00:00Z,LAC vs. MIA,112,3,1610612748,MIA,Miami Heat,MIA @ LAC,109,-3,Regular Season
22021,1610612755,PHI,Philadelphia 76ers,0022100171,2021-11-11T00:00:00Z,PHI vs. TOR,109,-6,1610612761,TOR,Toronto Raptors,TOR @ PHI,115,6,Regular Season
22021,1610612760,OKC,Oklahoma City Thunder,0022100180,2021-11-12T00:00:00Z,OKC vs. SAC,105,2,1610612758,SAC,Sacramento Kings,SAC @ OKC,103,-2,Regular Season
22021,1610612738,BOS,Boston Celtics,0022100175,2021-11-12T00:00:00Z,BOS vs. MIL,122,9,1610612749,MIL,Milwaukee Bucks,MIL @ BOS,113,-9,Regular Season
22021,1610612763,MEM,Memphis Grizzlies,0022100178,2021-11-12T00:00:00Z,MEM vs. PHX,94,-25,1610612756,PHX,Phoenix Suns,PHX @ MEM,119,25,Regular Season
22021,1610612745,HOU,Houston Rockets,0022100177,2021-11-12T00:00:00Z,HOU vs. POR,92,-12,1610612757,POR,Portland Trail Blazers,POR @ HOU,104,12,Regular Season
22021,1610612739,CLE,Cleveland Cavaliers,0022100176,2021-11-12T00:00:00Z,CLE vs. DET,98,20,1610612765,DET,Detroit Pistons,DET @ CLE,78,-20,Regular Season
22021,1610612743,DEN,Denver Nuggets,0022100182,2021-11-12T00:00:00Z,DEN vs. ATL,105,9,1610612737,ATL,Atlanta Hawks,ATL @ DEN,96,-9,Regular Season
22021,1610612759,SAS,San Antonio Spurs,0022100181,2021-11-12T00:00:00Z,SAS vs. DAL,109,-14,1610612742,DAL,Dallas Mavericks,DAL @ SAS,123,14,Regular Season
22021,1610612747,LAL,Los Angeles Lakers,0022100184,2021-11-12T00:00:00Z,LAL vs. MIN,83,-24,1610612750,MIN,Minnesota Timberwolves,MIN @ LAL,107,24,Regular Season
22021,1610612766,CHA,Charlotte Hornets,0022100174,2021-11-12T00:00:00Z,CHA vs. NYK,104,8,1610612752,NYK,New York Knicks,NYK @ CHA,96,-8,Regular Season
22021,1610612744,GSW,Golden State Warriors,0022100183,2021-11-12T00:00:00Z,GSW vs. CHI,119,26,1610612741,CHI,Chicago Bulls,CHI @ GSW,93,-26,Regular Season
22021,1610612740,NOP,New Orleans Pelicans,0022100179,2021-11-12T00:00:00Z,NOP vs. BKN,112,-8,1610612751,BKN,Brooklyn Nets,BKN @ NOP,120,8,Regular Season
22021,1610612762,UTA,Utah Jazz,0022100185,2021-11-13T00:00:00Z,UTA vs. MIA,105,-6,1610612748,MIA,Miami Heat,MIA @ UTA,111,6,Regular Season
22021,1610612761,TOR,Toronto Raptors,0022100189,2021-11-13T00:00:00Z,TOR vs. DET,121,-6,1610612765,DET,Detroit Pistons,DET @ TOR,127,6,Regular Season
22021,1610612753,ORL,Orlando Magic,0022100187,2021-11-13T00:00:00Z,ORL vs. WAS,92,-12,1610612764,WAS,Washington Wizards,WAS @ ORL,104,12,Regular Season
22021,1610612740,NOP,New Orleans Pelicans,0022100188,2021-11-13T00:00:00Z,NOP vs. MEM,112,11,1610612763,MEM,Memphis Grizzlies,MEM @ NOP,101,-11,Regular Season
22021,1610612754,IND,Indiana Pacers,0022100186,2021-11-13T00:00:00Z,IND vs. PHI,118,5,1610612755,PHI,Philadelphia 76ers,PHI @ IND,113,-5,Regular Season
22021,1610612739,CLE,Cleveland Cavaliers,0022100190,2021-11-13T00:00:00Z,CLE vs. BOS,91,2,1610612738,BOS,Boston Celtics,BOS @ CLE,89,-2,Regular Season
22021,1610612746,LAC,LA Clippers,0022100191,2021-11-13T00:00:00Z,LAC vs. MIN,129,27,1610612750,MIN,Minnesota Timberwolves,MIN @ LAC,102,-27,Regular Season
22021,1610612737,ATL,Atlanta Hawks,0022100193,2021-11-14T00:00:00Z,ATL vs. MIL,120,20,1610612749,MIL,Milwaukee Bucks,MIL @ ATL,100,-20,Regular Season
22021,1610612746,LAC,LA Clippers,0022100198,2021-11-14T00:00:00Z,LAC vs. CHI,90,-10,1610612741,CHI,Chicago Bulls,CHI @ LAC,100,10,Regular Season
22021,1610612747,LAL,Los Angeles Lakers,0022100192,2021-11-14T00:00:00Z,LAL vs. SAS,114,8,1610612759,SAS,San Antonio Spurs,SAS @ LAL,106,-8,Regular Season
22021,1610612760,OKC,Oklahoma City Thunder,0022100196,2021-11-14T00:00:00Z,OKC vs. BKN,96,-24,1610612751,BKN,Brooklyn Nets,BKN @ OKC,120,24,Regular Season
22021,1610612766,CHA,Charlotte Hornets,0022100194,2021-11-14T00:00:00Z,CHA vs. GSW,106,4,1610612744,GSW,Golden State Warriors,GSW @ CHA,102,-4,Regular Season
22021,1610612745,HOU,Houston Rockets,0022100195,2021-11-14T00:00:00Z,HOU vs. PHX,89,-26,1610612756,PHX,Phoenix Suns,PHX @ HOU,115,26,Regular Season
22021,1610612743,DEN,Denver Nuggets,0022100197,2021-11-14T00:00:00Z,DEN vs. POR,124,29,1610612757,POR,Portland Trail Blazers,POR @ DEN,95,-29,Regular Season
22021,1610612763,MEM,Memphis Grizzlies,0022100205,2021-11-15T00:00:00Z,MEM vs. HOU,136,34,1610612745,HOU,Houston Rockets,HOU @ MEM,102,-34,Regular Season
22021,1610612752,NYK,New York Knicks,0022100203,2021-11-15T00:00:00Z,NYK vs. IND,92,8,1610612754,IND,Indiana Pacers,IND @ NYK,84,-8,Regular Season
22021,1610612764,WAS,Washington Wizards,0022100201,2021-11-15T00:00:00Z,WAS vs. NOP,105,5,1610612740,NOP,New Orleans Pelicans,NOP @ WAS,100,-5,Regular Season
22021,1610612765,DET,Detroit Pistons,0022100200,2021-11-15T00:00:00Z,DET vs. SAC,107,-22,1610612758,SAC,Sacramento Kings,SAC @ DET,129,22,Regular Season
22021,1610612760,OKC,Oklahoma City Thunder,0022100207,2021-11-15T00:00:00Z,OKC vs. MIA,90,-13,1610612748,MIA,Miami Heat,MIA @ OKC,103,13,Regular Season
22021,1610612742,DAL,Dallas Mavericks,0022100204,2021-11-15T00:00:00Z,DAL vs. DEN,111,10,1610612743,DEN,Denver Nuggets,DEN @ DAL,101,-10,Regular Season
22021,1610612739,CLE,Cleveland Cavaliers,0022100199,2021-11-15T00:00:00Z,CLE vs. BOS,92,-6,1610612738,BOS,Boston Celtics,BOS @ CLE,98,6,Regular Season
22021,1610612750,MIN,Minnesota Timberwolves,0022100206,2021-11-15T00:00:00Z,MIN vs. PHX,96,-3,1610612756,PHX,Phoenix Suns,PHX @ MIN,99,3,Regular Season
22021,1610612757,POR,Portland Trail Blazers,0022100208,2021-11-15T00:00:00Z,POR vs. TOR,118,5,1610612761,TOR,Toronto Raptors,TOR @ POR,113,-5,Regular Season
22021,1610612737,ATL,Atlanta Hawks,0022100202,2021-11-15T00:00:00Z,ATL vs. ORL,129,18,1610612753,ORL,Orlando Magic,ORL @ ATL,111,-18,Regular Season
22021,1610612747,LAL,Los Angeles Lakers,0022100209,2021-11-15T00:00:00Z,LAL vs. CHI,103,-18,1610612741,CHI,Chicago Bulls,CHI @ LAL,121,18,Regular Season
22021,1610612746,LAC,LA Clippers,0022100212,2021-11-16T00:00:00Z,LAC vs. SAS,106,14,1610612759,SAS,San Antonio Spurs,SAS @ LAC,92,-14,Regular Season
22021,1610612751,BKN,Brooklyn Nets,0022100210,2021-11-16T00:00:00Z,BKN vs. GSW,99,-18,1610612744,GSW,Golden State Warriors,GSW @ BKN,117,18,Regular Season
22021,1610612762,UTA,Utah Jazz,0022100211,2021-11-16T00:00:00Z,UTA vs. PHI,120,35,1610612755,PHI,Philadelphia 76ers,PHI @ UTA,85,-35,Regular Season
22021,1610612749,MIL,Milwaukee Bucks,0022100219,2021-11-17T00:00:00Z,MIL vs. LAL,109,7,1610612747,LAL,Los Angeles Lakers,LAL @ MIL,102,-7,Regular Season
22021,1610612752,NYK,New York Knicks,0022100218,2021-11-17T00:00:00Z,NYK vs. ORL,98,-6,1610612753,ORL,Orlando Magic,ORL @ NYK,104,6,Regular Season
22021,1610612766,CHA,Charlotte Hornets,0022100213,2021-11-17T00:00:00Z,CHA vs. WAS,97,10,1610612764,WAS,Washington Wizards,WAS @ CHA,87,-10,Regular Season
22021,1610612756,PHX,Phoenix Suns,0022100222,2021-11-17T00:00:00Z,PHX vs. DAL,105,7,1610612742,DAL,Dallas Mavericks,DAL @ PHX,98,-7,Regular Season
22021,1610612765,DET,Detroit Pistons,0022100214,2021-11-17T00:00:00Z,DET vs. IND,97,8,1610612754,IND,Indiana Pacers,IND @ DET,89,-8,Regular Season
22021,1610612757,POR,Portland Trail Blazers,0022100223,2021-11-17T00:00:00Z,POR vs. CHI,112,5,1610612741,CHI,Chicago Bulls,CHI @ POR,107,-5,Regular Season
22021,1610612751,BKN,Brooklyn Nets,0022100216,2021-11-17T00:00:00Z,BKN vs. CLE,109,10,1610612739,CLE,Cleveland Cavaliers,CLE @ BKN,99,-10,Regular Season
22021,1610612750,MIN,Minnesota Timberwolves,0022100220,2021-11-17T00:00:00Z,MIN vs. SAC,107,10,1610612758,SAC,Sacramento Kings,SAC @ MIN,97,-10,Regular Season
22021,1610612760,OKC,Oklahoma City Thunder,0022100221,2021-11-17T00:00:00Z,OKC vs. HOU,101,12,1610612745,HOU,Houston Rockets,HOU @ OKC,89,-12,Regular Season
22021,1610612737,ATL,Atlanta Hawks,0022100215,2021-11-17T00:00:00Z,ATL vs. BOS,110,11,1610612738,BOS,Boston Celtics,BOS @ ATL,99,-11,Regular Season
22021,1610612748,MIA,Miami Heat,0022100217,2021-11-17T00:00:00Z,MIA vs. NOP,113,15,1610612740,NOP,New Orleans Pelicans,NOP @ MIA,98,-15,Regular Season
22021,1610612750,MIN,Minnesota Timberwolves,0022100227,2021-11-18T00:00:00Z,MIN vs. SAS,115,25,1610612759,SAS,San Antonio Spurs,SAS @ MIN,90,-25,Regular Season
22021,1610612739,CLE,Cleveland Cavaliers,0022100224,2021-11-18T00:00:00Z,CLE vs. GSW,89,-15,1610612744,GSW,Golden State Warriors,GSW @ CLE,104,15,Regular Season
22021,1610612748,MIA,Miami Heat,0022100225,2021-11-18T00:00:00Z,MIA vs. WAS,112,15,1610612764,WAS,Washington Wizards,WAS @ MIA,97,-15,Regular Season
22021,1610612763,MEM,Memphis Grizzlies,0022100226,2021-11-18T00:00:00Z,MEM vs. LAC,120,12,1610612746,LAC,LA Clippers,LAC @ MEM,108,-12,Regular Season
22021,1610612743,DEN,Denver Nuggets,0022100228,2021-11-18T00:00:00Z,DEN vs. PHI,89,-14,1610612755,PHI,Philadelphia 76ers,PHI @ DEN,103,14,Regular Season
22021,1610612762,UTA,Utah Jazz,0022100229,2021-11-18T00:00:00Z,UTA vs. TOR,119,16,1610612761,TOR,Toronto Raptors,TOR @ UTA,103,-16,Regular Season
22021,1610612749,MIL,Milwaukee Bucks,0022100234,2021-11-19T00:00:00Z,MIL vs. OKC,96,7,1610612760,OKC,Oklahoma City Thunder,OKC @ MIL,89,-7,Regular Season
22021,1610612765,DET,Detroit Pistons,0022100231,2021-11-19T00:00:00Z,DET vs. GSW,102,-3,1610612744,GSW,Golden State Warriors,GSW @ DET,105,3,Regular Season
22021,1610612758,SAC,Sacramento Kings,0022100238,2021-11-19T00:00:00Z,SAC vs. TOR,89,-19,1610612761,TOR,Toronto Raptors,TOR @ SAC,108,19,Regular Season
22021,1610612766,CHA,Charlotte Hornets,0022100230,2021-11-19T00:00:00Z,CHA vs. IND,121,3,1610612754,IND,Indiana Pacers,IND @ CHA,118,-3,Regular Season
22021,1610612751,BKN,Brooklyn Nets,0022100233,2021-11-19T00:00:00Z,BKN vs. ORL,115,2,1610612753,ORL,Orlando Magic,ORL @ BKN,113,-2,Regular Season
22021,1610612740,NOP,New Orleans Pelicans,0022100235,2021-11-19T00:00:00Z,NOP vs. LAC,94,13,1610612746,LAC,LA Clippers,LAC @ NOP,81,-13,Regular Season
22021,1610612738,BOS,Boston Celtics,0022100232,2021-11-19T00:00:00Z,BOS vs. LAL,130,22,1610612747,LAL,Los Angeles Lakers,LAL @ BOS,108,-22,Regular Season
22021,1610612743,DEN,Denver Nuggets,0022100236,2021-11-19T00:00:00Z,DEN vs. CHI,108,-6,1610612741,CHI,Chicago Bulls,CHI @ DEN,114,6,Regular Season
22021,1610612756,PHX,Phoenix Suns,0022100237,2021-11-19T00:00:00Z,PHX vs. DAL,112,8,1610612742,DAL,Dallas Mavericks,DAL @ PHX,104,-8,Regular Season
22021,1610612738,BOS,Boston Celtics,0022100243,2021-11-20T00:00:00Z,BOS vs. OKC,111,6,1610612760,OKC,Oklahoma City Thunder,OKC @ BOS,105,-6,Regular Season
22021,1610612764,WAS,Washington Wizards,0022100241,2021-11-20T00:00:00Z,WAS vs. MIA,103,3,1610612748,MIA,Miami Heat,MIA @ WAS,100,-3,Regular Season
22021,1610612754,IND,Indiana Pacers,0022100240,2021-11-20T00:00:00Z,IND vs. NOP,111,17,1610612740,NOP,New Orleans Pelicans,NOP @ IND,94,-17,Regular Season
22021,1610612752,NYK,New York Knicks,0022100239,2021-11-20T00:00:00Z,NYK vs. HOU,106,7,1610612745,HOU,Houston Rockets,HOU @ NYK,99,-7,Regular Season
22021,1610612750,MIN,Minnesota Timberwolves,0022100245,2021-11-20T00:00:00Z,MIN vs. MEM,138,43,1610612763,MEM,Memphis Grizzlies,MEM @ MIN,95,-43,Regular Season
22021,1610612749,MIL,Milwaukee Bucks,0022100244,2021-11-20T00:00:00Z,MIL vs. ORL,117,9,1610612753,ORL,Orlando Magic,ORL @ MIL,108,-9,Regular Season
22021,1610612757,POR,Portland Trail Blazers,0022100246,2021-11-20T00:00:00Z,POR vs. PHI,118,7,1610612755,PHI,Philadelphia 76ers,PHI @ POR,111,-7,Regular Season
22021,1610612737,ATL,Atlanta Hawks,0022100242,2021-11-20T00:00:00Z,ATL vs. CHA,115,10,1610612766,CHA,Charlotte Hornets,CHA @ ATL,105,-10,Regular Season
22021,1610612758,SAC,Sacramento Kings,0022100247,2021-11-20T00:00:00Z,SAC vs. UTA,105,-18,1610612762,UTA,Utah Jazz,UTA @ SAC,123,18,Regular Season
22021,1610612765,DET,Detroit Pistons,0022100249,2021-11-21T00:00:00Z,DET vs. LAL,116,-5,1610612747,LAL,Los Angeles Lakers,LAL @ DET,121,5,Regular Season
22021,1610612741,CHI,Chicago Bulls,0022100250,2021-11-21T00:00:00Z,CHI vs. NYK,109,6,1610612752,NYK,New York Knicks,NYK @ CHI,103,-6,Regular Season
22021,1610612744,GSW,Golden State Warriors,0022100252,2021-11-21T00:00:00Z,GSW vs. TOR,119,15,1610612761,TOR,Toronto Raptors,TOR @ GSW,104,-15,Regular Season
22021,1610612756,PHX,Phoenix Suns,0022100251,2021-11-21T00:00:00Z,PHX vs. DEN,126,29,1610612743,DEN,Denver Nuggets,DEN @ PHX,97,-29,Regular Season
22021,1610612746,LAC,LA Clippers,0022100248,2021-11-21T00:00:00Z,LAC vs. DAL,97,6,1610612742,DAL,Dallas Mavericks,DAL @ LAC,91,-6,Regular Season
22021,1610612759,SAS,San Antonio Spurs,0022100260,2021-11-22T00:00:00Z,SAS vs. PHX,111,-4,1610612756,PHX,Phoenix Suns,PHX @ SAS,115,4,Regular Season
22021,1610612739,CLE,Cleveland Cavaliers,0022100253,2021-11-22T00:00:00Z,CLE vs. BKN,112,-5,1610612751,BKN,Brooklyn Nets,BKN @ CLE,117,5,Regular Season
22021,1610612740,NOP,New Orleans Pelicans,0022100259,2021-11-22T00:00:00Z,NOP vs. MIN,96,-14,1610612750,MIN,Minnesota Timberwolves,MIN @ NOP,110,14,Regular Season
22021,1610612738,BOS,Boston Celtics,0022100256,2021-11-22T00:00:00Z,BOS vs. HOU,108,18,1610612745,HOU,Houston Rockets,HOU @ BOS,90,-18,Regular Season
22021,1610612749,MIL,Milwaukee Bucks,0022100258,2021-11-22T00:00:00Z,MIL vs. ORL,123,31,1610612753,ORL,Orlando Magic,ORL @ MIL,92,-31,Regular Season
22021,1610612762,UTA,Utah Jazz,0022100261,2021-11-22T00:00:00Z,UTA vs. MEM,118,-1,1610612763,MEM,Memphis Grizzlies,MEM @ UTA,119,1,Regular Season
22021,1610612741,CHI,Chicago Bulls,0022100257,2021-11-22T00:00:00Z,CHI vs. IND,77,-32,1610612754,IND,Indiana Pacers,IND @ CHI,109,32,Regular Season
22021,1610612764,WAS,Washington Wizards,0022100254,2021-11-22T00:00:00Z,WAS vs. CHA,103,-6,1610612766,CHA,Charlotte Hornets,CHA @ WAS,109,6,Regular Season
22021,1610612758,SAC,Sacramento Kings,0022100262,2021-11-22T00:00:00Z,SAC vs. PHI,94,-8,1610612755,PHI,Philadelphia 76ers,PHI @ SAC,102,8,Regular Season
22021,1610612737,ATL,Atlanta Hawks,0022100255,2021-11-22T00:00:00Z,ATL vs. OKC,113,12,1610612760,OKC,Oklahoma City Thunder,OKC @ ATL,101,-12,Regular Season
22021,1610612746,LAC,LA Clippers,0022100266,2021-11-23T00:00:00Z,LAC vs. DAL,104,-8,1610612742,DAL,Dallas Mavericks,DAL @ LAC,112,8,Regular Season
22021,1610612765,DET,Detroit Pistons,0022100263,2021-11-23T00:00:00Z,DET vs. MIA,92,-8,1610612748,MIA,Miami Heat,MIA @ DET,100,8,Regular Season
22021,1610612752,NYK,New York Knicks,0022100264,2021-11-23T00:00:00Z,NYK vs. LAL,106,6,1610612747,LAL,Los Angeles Lakers,LAL @ NYK,100,-6,Regular Season
22021,1610612757,POR,Portland Trail Blazers,0022100265,2021-11-23T00:00:00Z,POR vs. DEN,119,19,1610612743,DEN,Denver Nuggets,DEN @ POR,100,-19,Regular Season
22021,1610612758,SAC,Sacramento Kings,0022100279,2021-11-24T00:00:00Z,SAC vs. POR,125,4,1610612757,POR,Portland Trail Blazers,POR @ SAC,121,-4,Regular Season
22021,1610612744,GSW,Golden State Warriors,0022100278,2021-11-24T00:00:00Z,GSW vs. PHI,116,20,1610612755,PHI,Philadelphia 76ers,PHI @ GSW,96,-20,Regular Season
22021,1610612739,CLE,Cleveland Cavaliers,0022100267,2021-11-24T00:00:00Z,CLE vs. PHX,115,-5,1610612756,PHX,Phoenix Suns,PHX @ CLE,120,5,Regular Season
22021,1610612759,SAS,San Antonio Spurs,0022100277,2021-11-24T00:00:00Z,SAS vs. ATL,106,-18,1610612737,ATL,Atlanta Hawks,ATL @ SAS,124,18,Regular Season
22021,1610612738,BOS,Boston Celtics,0022100270,2021-11-24T00:00:00Z,BOS vs. BKN,104,-19,1610612751,BKN,Brooklyn Nets,BKN @ BOS,123,19,Regular Season
22021,1610612749,MIL,Milwaukee Bucks,0022100273,2021-11-24T00:00:00Z,MIL vs. DET,114,21,1610612765,DET,Detroit Pistons,DET @ MIL,93,-21,Regular Season
22021,1610612760,OKC,Oklahoma City Thunder,0022100276,2021-11-24T00:00:00Z,OKC vs. UTA,104,-6,1610612762,UTA,Utah Jazz,UTA @ OKC,110,6,Regular Season
22021,1610612763,MEM,Memphis Grizzlies,0022100272,2021-11-24T00:00:00Z,MEM vs. TOR,113,-13,1610612761,TOR,Toronto Raptors,TOR @ MEM,126,13,Regular Season
22021,1610612753,ORL,Orlando Magic,0022100269,2021-11-24T00:00:00Z,ORL vs. CHA,99,-7,1610612766,CHA,Charlotte Hornets,CHA @ ORL,106,7,Regular Season
22021,1610612745,HOU,Houston Rockets,0022100271,2021-11-24T00:00:00Z,HOU vs. CHI,118,5,1610612741,CHI,Chicago Bulls,CHI @ HOU,113,-5,Regular Season
22021,1610612740,NOP,New Orleans Pelicans,0022100275,2021-11-24T00:00:00Z,NOP vs. WAS,127,25,1610612764,WAS,Washington Wizards,WAS @ NOP,102,-25,Regular Season
22021,1610612750,MIN,Minnesota Timberwolves,0022100274,2021-11-24T00:00:00Z,MIN vs. MIA,113,12,1610612748,MIA,Miami Heat,MIA @ MIN,101,-12,Regular Season
22021,1610612754,IND,Indiana Pacers,0022100268,2021-11-24T00:00:00Z,IND vs. LAL,116,-8,1610612747,LAL,Los Angeles Lakers,LAL @ IND,124,8,Regular Season
22021,1610612762,UTA,Utah Jazz,0022100289,2021-11-26T00:00:00Z,UTA vs. NOP,97,-1,1610612740,NOP,New Orleans Pelicans,NOP @ UTA,98,1,Regular Season
22021,1610612743,DEN,Denver Nuggets,0022100288,2021-11-26T00:00:00Z,DEN vs. MIL,109,-11,1610612749,MIL,Milwaukee Bucks,MIL @ DEN,120,11,Regular Season
22021,1610612744,GSW,Golden State Warriors,0022100290,2021-11-26T00:00:00Z,GSW vs. POR,118,15,1610612757,POR,Portland Trail Blazers,POR @ GSW,103,-15,Regular Season
22021,1610612747,LAL,Los Angeles Lakers,0022100291,2021-11-26T00:00:00Z,LAL vs. SAC,137,-4,1610612758,SAC,Sacramento Kings,SAC @ LAL,141,4,Regular Season
22021,1610612766,CHA,Charlotte Hornets,0022100281,2021-11-26T00:00:00Z,CHA vs. MIN,133,18,1610612750,MIN,Minnesota Timberwolves,MIN @ CHA,115,-18,Regular Season
22021,1610612754,IND,Indiana Pacers,0022100284,2021-11-26T00:00:00Z,IND vs. TOR,114,17,1610612761,TOR,Toronto Raptors,TOR @ IND,97,-17,Regular Season
22021,1610612760,OKC,Oklahoma City Thunder,0022100286,2021-11-26T00:00:00Z,OKC vs. WAS,99,-2,1610612764,WAS,Washington Wizards,WAS @ OKC,101,2,Regular Season
22021,1610612753,ORL,Orlando Magic,0022100283,2021-11-26T00:00:00Z,ORL vs. CHI,88,-35,1610612741,CHI,Chicago Bulls,CHI @ ORL,123,35,Regular Season
22021,1610612752,NYK,New York Knicks,0022100282,2021-11-26T00:00:00Z,NYK vs. PHX,97,-21,1610612756,PHX,Phoenix Suns,PHX @ NYK,118,21,Regular Season
22021,1610612759,SAS,San Antonio Spurs,0022100287,2021-11-26T00:00:00Z,SAS vs. BOS,96,8,1610612738,BOS,Boston Celtics,BOS @ SAS,88,-8,Regular Season
22021,1610612746,LAC,LA Clippers,0022100280,2021-11-26T00:00:00Z,LAC vs. DET,107,11,1610612765,DET,Detroit Pistons,DET @ LAC,96,-11,Regular Season
22021,1610612763,MEM,Memphis Grizzlies,0022100285,2021-11-26T00:00:00Z,MEM vs. ATL,100,-32,1610612737,ATL,Atlanta Hawks,ATL @ MEM,132,32,Regular Season
22021,1610612737,ATL,Atlanta Hawks,0022100293,2021-11-27T00:00:00Z,ATL vs. NYK,90,-9,1610612752,NYK,New York Knicks,NYK @ ATL,99,9,Regular Season
22021,1610612739,CLE,Cleveland Cavaliers,0022100295,2021-11-27T00:00:00Z,CLE vs. ORL,105,13,1610612753,ORL,Orlando Magic,ORL @ CLE,92,-13,Regular Season
22021,1610612741,CHI,Chicago Bulls,0022100296,2021-11-27T00:00:00Z,CHI vs. MIA,104,-3,1610612748,MIA,Miami Heat,MIA @ CHI,107,3,Regular Season
22021,1610612742,DAL,Dallas Mavericks,0022100298,2021-11-27T00:00:00Z,DAL vs. WAS,114,-6,1610612764,WAS,Washington Wizards,WAS @ DAL,120,6,Regular Season
22021,1610612745,HOU,Houston Rockets,0022100297,2021-11-27T00:00:00Z,HOU vs. CHA,146,3,1610612766,CHA,Charlotte Hornets,CHA @ HOU,143,-3,Regular Season
22021,1610612762,UTA,Utah Jazz,0022100299,2021-11-27T00:00:00Z,UTA vs. NOP,127,22,1610612740,NOP,New Orleans Pelicans,NOP @ UTA,105,-22,Regular Season
22021,1610612755,PHI,Philadelphia 76ers,0022100292,2021-11-27T00:00:00Z,PHI vs. MIN,120,-1,1610612750,MIN,Minnesota Timberwolves,MIN @ PHI,121,1,Regular Season
22021,1610612751,BKN,Brooklyn Nets,0022100294,2021-11-27T00:00:00Z,BKN vs. PHX,107,-6,1610612756,PHX,Phoenix Suns,PHX @ BKN,113,6,Regular Season
22021,1610612763,MEM,Memphis Grizzlies,0022100303,2021-11-28T00:00:00Z,MEM vs. SAC,128,27,1610612758,SAC,Sacramento Kings,SAC @ MEM,101,-27,Regular Season
22021,1610612754,IND,Indiana Pacers,0022100301,2021-11-28T00:00:00Z,IND vs. MIL,100,-18,1610612749,MIL,Milwaukee Bucks,MIL @ IND,118,18,Regular Season
22021,1610612746,LAC,LA Clippers,0022100300,2021-11-28T00:00:00Z,LAC vs. GSW,90,-15,1610612744,GSW,Golden State Warriors,GSW @ LAC,105,15,Regular Season
22021,1610612761,TOR,Toronto Raptors,0022100302,2021-11-28T00:00:00Z,TOR vs. BOS,97,-12,1610612738,BOS,Boston Celtics,BOS @ TOR,109,12,Regular Season
22021,1610612747,LAL,Los Angeles Lakers,0022100304,2021-11-28T00:00:00Z,LAL vs. DET,110,4,1610612765,DET,Detroit Pistons,DET @ LAL,106,-4,Regular Season
22021,1610612748,MIA,Miami Heat,0022100306,2021-11-29T00:00:00Z,MIA vs. DEN,111,-9,1610612743,DEN,Denver Nuggets,DEN @ MIA,120,9,Regular Season
22021,1610612742,DAL,Dallas Mavericks,0022100310,2021-11-29T00:00:00Z,DAL vs. CLE,96,-18,1610612739,CLE,Cleveland Cavaliers,CLE @ DAL,114,18,Regular Season
22021,1610612759,SAS,San Antonio Spurs,0022100311,2021-11-29T00:00:00Z,SAS vs. WAS,116,17,1610612764,WAS,Washington Wizards,WAS @ SAS,99,-17,Regular Season
22021,1610612762,UTA,Utah Jazz,0022100312,2021-11-29T00:00:00Z,UTA vs. POR,129,22,1610612757,POR,Portland Trail Blazers,POR @ UTA,107,-22,Regular Season
22021,1610612750,MIN,Minnesota Timberwolves,0022100309,2021-11-29T00:00:00Z,MIN vs. IND,100,2,1610612754,IND,Indiana Pacers,IND @ MIN,98,-2,Regular Season
22021,1610612746,LAC,LA Clippers,0022100313,2021-11-29T00:00:00Z,LAC vs. NOP,104,-19,1610612740,NOP,New Orleans Pelicans,NOP @ LAC,123,19,Regular Season
22021,1610612755,PHI,Philadelphia 76ers,0022100305,2021-11-29T00:00:00Z,PHI vs. ORL,101,5,1610612753,ORL,Orlando Magic,ORL @ PHI,96,-5,Regular Season
22021,1610612741,CHI,Chicago Bulls,0022100307,2021-11-29T00:00:00Z,CHI vs. CHA,133,14,1610612766,CHA,Charlotte Hornets,CHA @ CHI,119,-14,Regular Season
22021,1610612745,HOU,Houston Rockets,0022100308,2021-11-29T00:00:00Z,HOU vs. OKC,102,13,1610612760,OKC,Oklahoma City Thunder,OKC @ HOU,89,-13,Regular Season
22021,1610612758,SAC,Sacramento Kings,0022100318,2021-11-30T00:00:00Z,SAC vs. LAL,92,-25,1610612747,LAL,Los Angeles Lakers,LAL @ SAC,117,25,Regular Season
22021,1610612756,PHX,Phoenix Suns,0022100316,2021-11-30T00:00:00Z,PHX vs. GSW,104,8,1610612744,GSW,Golden State Warriors,GSW @ PHX,96,-8,Regular Season
22021,1610612757,POR,Portland Trail Blazers,0022100317,2021-11-30T00:00:00Z,POR vs. DET,110,18,1610612765,DET,Detroit Pistons,DET @ POR,92,-18,Regular Season
22021,1610612751,BKN,Brooklyn Nets,0022100314,2021-11-30T00:00:00Z,BKN vs. NYK,112,2,1610612752,NYK,New York Knicks,NYK @ BKN,110,-2,Regular Season
22021,1610612761,TOR,Toronto Raptors,0022100315,2021-11-30T00:00:00Z,TOR vs. MEM,91,-7,1610612763,MEM,Memphis Grizzlies,MEM @ TOR,98,7,Regular Season
22021,1610612754,IND,Indiana Pacers,0022100319,2021-12-01T00:00:00Z,IND vs. ATL,111,-3,1610612737,ATL,Atlanta Hawks,ATL @ IND,114,3,Regular Season
22021,1610612746,LAC,LA Clippers,0022100327,2021-12-01T00:00:00Z,LAC vs. SAC,115,-9,1610612758,SAC,Sacramento Kings,SAC @ LAC,124,9,Regular Season
22021,1610612753,ORL,Orlando Magic,0022100320,2021-12-01T00:00:00Z,ORL vs. DEN,108,5,1610612743,DEN,Denver Nuggets,DEN @ ORL,103,-5,Regular Season
22021,1610612760,OKC,Oklahoma City Thunder,0022100326,2021-12-01T00:00:00Z,OKC vs. HOU,110,-4,1610612745,HOU,Houston Rockets,HOU @ OKC,114,4,Regular Season
22021,1610612764,WAS,Washington Wizards,0022100321,2021-12-01T00:00:00Z,WAS vs. MIN,115,8,1610612750,MIN,Minnesota Timberwolves,MIN @ WAS,107,-8,Regular Season
22021,1610612738,BOS,Boston Celtics,0022100322,2021-12-01T00:00:00Z,BOS vs. PHI,88,1,1610612755,PHI,Philadelphia 76ers,PHI @ BOS,87,-1,Regular Season
22021,1610612749,MIL,Milwaukee Bucks,0022100324,2021-12-01T00:00:00Z,MIL vs. CHA,127,2,1610612766,CHA,Charlotte Hornets,CHA @ MIL,125,-2,Regular Season
22021,1610612740,NOP,New Orleans Pelicans,0022100325,2021-12-01T00:00:00Z,NOP vs. DAL,107,-32,1610612742,DAL,Dallas Mavericks,DAL @ NOP,139,32,Regular Season
22021,1610612748,MIA,Miami Heat,0022100323,2021-12-01T00:00:00Z,MIA vs. CLE,85,-26,1610612739,CLE,Cleveland Cavaliers,CLE @ MIA,111,26,Regular Season
22021,1610612757,POR,Portland Trail Blazers,0022100332,2021-12-02T00:00:00Z,POR vs. SAS,83,-31,1610612759,SAS,San Antonio Spurs,SAS @ POR,114,31,Regular Season
22021,1610612763,MEM,Memphis Grizzlies,0022100330,2021-12-02T00:00:00Z,MEM vs. OKC,152,73,1610612760,OKC,Oklahoma City Thunder,OKC @ MEM,79,-73,Regular Season
22021,1610612756,PHX,Phoenix Suns,0022100331,2021-12-02T00:00:00Z,PHX vs. DET,114,11,1610612765,DET,Detroit Pistons,DET @ PHX,103,-11,Regular Season
22021,1610612761,TOR,Toronto Raptors,0022100329,2021-12-02T00:00:00Z,TOR vs. MIL,97,4,1610612749,MIL,Milwaukee Bucks,MIL @ TOR,93,-4,Regular Season
22021,1610612752,NYK,New York Knicks,0022100328,2021-12-02T00:00:00Z,NYK vs. CHI,115,-4,1610612741,CHI,Chicago Bulls,CHI @ NYK,119,4,Regular Season
22021,1610612744,GSW,Golden State Warriors,0022100340,2021-12-03T00:00:00Z,GSW vs. PHX,118,22,1610612756,PHX,Phoenix Suns,PHX @ GSW,96,-22,Regular Season
22021,1610612762,UTA,Utah Jazz,0022100339,2021-12-03T00:00:00Z,UTA vs. BOS,137,7,1610612738,BOS,Boston Celtics,BOS @ UTA,130,-7,Regular Season
22021,1610612747,LAL,Los Angeles Lakers,0022100341,2021-12-03T00:00:00Z,LAL vs. LAC,115,-4,1610612746,LAC,LA Clippers,LAC @ LAL,119,4,Regular Season
22021,1610612742,DAL,Dallas Mavericks,0022100338,2021-12-03T00:00:00Z,DAL vs. NOP,91,-16,1610612740,NOP,New Orleans Pelicans,NOP @ DAL,107,16,Regular Season
22021,1610612754,IND,Indiana Pacers,0022100333,2021-12-03T00:00:00Z,IND vs. MIA,104,-9,1610612748,MIA,Miami Heat,MIA @ IND,113,9,Regular Season
22021,1610612751,BKN,Brooklyn Nets,0022100336,2021-12-03T00:00:00Z,BKN vs. MIN,110,5,1610612750,MIN,Minnesota Timberwolves,MIN @ BKN,105,-5,Regular Season
22021,1610612764,WAS,Washington Wizards,0022100334,2021-12-03T00:00:00Z,WAS vs. CLE,101,-15,1610612739,CLE,Cleveland Cavaliers,CLE @ WAS,116,15,Regular Season
22021,1610612745,HOU,Houston Rockets,0022100337,2021-12-03T00:00:00Z,HOU vs. ORL,118,2,1610612753,ORL,Orlando Magic,ORL @ HOU,116,-2,Regular Season
22021,1610612737,ATL,Atlanta Hawks,0022100335,2021-12-03T00:00:00Z,ATL vs. PHI,96,-2,1610612755,PHI,Philadelphia 76ers,PHI @ ATL,98,2,Regular Season
22021,1610612758,SAC,Sacramento Kings,0022100348,2021-12-04T00:00:00Z,SAC vs. LAC,104,5,1610612746,LAC,LA Clippers,LAC @ SAC,99,-5,Regular Season
22021,1610612742,DAL,Dallas Mavericks,0022100345,2021-12-04T00:00:00Z,DAL vs. MEM,90,-7,1610612763,MEM,Memphis Grizzlies,MEM @ DAL,97,7,Regular Season
22021,1610612752,NYK,New York Knicks,0022100342,2021-12-04T00:00:00Z,NYK vs. DEN,99,-14,1610612743,DEN,Denver Nuggets,DEN @ NYK,113,14,Regular Season
22021,1610612744,GSW,Golden State Warriors,0022100346,2021-12-04T00:00:00Z,GSW vs. SAS,107,-5,1610612759,SAS,San Antonio Spurs,SAS @ GSW,112,5,Regular Season
22021,1610612749,MIL,Milwaukee Bucks,0022100344,2021-12-04T00:00:00Z,MIL vs. MIA,124,22,1610612748,MIA,Miami Heat,MIA @ MIL,102,-22,Regular Season
22021,1610612757,POR,Portland Trail Blazers,0022100347,2021-12-04T00:00:00Z,POR vs. BOS,117,-28,1610612738,BOS,Boston Celtics,BOS @ POR,145,28,Regular Season
22021,1610612751,BKN,Brooklyn Nets,0022100343,2021-12-04T00:00:00Z,BKN vs. CHI,107,-4,1610612741,CHI,Chicago Bulls,CHI @ BKN,111,4,Regular Season
22021,1610612745,HOU,Houston Rockets,0022100352,2021-12-05T00:00:00Z,HOU vs. NOP,118,10,1610612740,NOP,New Orleans Pelicans,NOP @ HOU,108,-10,Regular Season
22021,1610612761,TOR,Toronto Raptors,0022100351,2021-12-05T00:00:00Z,TOR vs. WAS,102,12,1610612764,WAS,Washington Wizards,WAS @ TOR,90,-12,Regular Season
22021,1610612737,ATL,Atlanta Hawks,0022100350,2021-12-05T00:00:00Z,ATL vs. CHA,127,-3,1610612766,CHA,Charlotte Hornets,CHA @ ATL,130,3,Regular Season
22021,1610612739,CLE,Cleveland Cavaliers,0022100349,2021-12-05T00:00:00Z,CLE vs. UTA,108,-1,1610612762,UTA,Utah Jazz,UTA @ CLE,109,1,Regular Season
22021,1610612749,MIL,Milwaukee Bucks,0022100358,2021-12-06T00:00:00Z,MIL vs. CLE,112,8,1610612739,CLE,Cleveland Cavaliers,CLE @ MIL,104,-8,Regular Season
22021,1610612748,MIA,Miami Heat,0022100356,2021-12-06T00:00:00Z,MIA vs. MEM,90,-15,1610612763,MEM,Memphis Grizzlies,MEM @ MIA,105,15,Regular Season
22021,1610612750,MIN,Minnesota Timberwolves,0022100359,2021-12-06T00:00:00Z,MIN vs. ATL,110,-11,1610612737,ATL,Atlanta Hawks,ATL @ MIN,121,11,Regular Season
22021,1610612756,PHX,Phoenix Suns,0022100360,2021-12-06T00:00:00Z,PHX vs. SAS,108,4,1610612759,SAS,San Antonio Spurs,SAS @ PHX,104,-4,Regular Season
22021,1610612766,CHA,Charlotte Hornets,0022100353,2021-12-06T00:00:00Z,CHA vs. PHI,124,-3,1610612755,PHI,Philadelphia 76ers,PHI @ CHA,127,3,Regular Season
22021,1610612754,IND,Indiana Pacers,0022100355,2021-12-06T00:00:00Z,IND vs. WAS,116,6,1610612764,WAS,Washington Wizards,WAS @ IND,110,-6,Regular Season
22021,1610612765,DET,Detroit Pistons,0022100354,2021-12-06T00:00:00Z,DET vs. OKC,103,-11,1610612760,OKC,Oklahoma City Thunder,OKC @ DET,114,11,Regular Season
22021,1610612741,CHI,Chicago Bulls,0022100357,2021-12-06T00:00:00Z,CHI vs. DEN,109,12,1610612743,DEN,Denver Nuggets,DEN @ CHI,97,-12,Regular Season
22021,1610612757,POR,Portland Trail Blazers,0022100362,2021-12-06T00:00:00Z,POR vs. LAC,90,-12,1610612746,LAC,LA Clippers,LAC @ POR,102,12,Regular Season
22021,1610612744,GSW,Golden State Warriors,0022100361,2021-12-06T00:00:00Z,GSW vs. ORL,126,31,1610612753,ORL,Orlando Magic,ORL @ GSW,95,-31,Regular Season
22021,1610612747,LAL,Los Angeles Lakers,0022100365,2021-12-07T00:00:00Z,LAL vs. BOS,117,15,1610612738,BOS,Boston Celtics,BOS @ LAL,102,-15,Regular Season
22021,1610612759,SAS,San Antonio Spurs,0022100364,2021-12-07T00:00:00Z,SAS vs. NYK,109,-12,1610612752,NYK,New York Knicks,NYK @ SAS,121,12,Regular Season
22021,1610612742,DAL,Dallas Mavericks,0022100363,2021-12-07T00:00:00Z,DAL vs. BKN,99,-3,1610612751,BKN,Brooklyn Nets,BKN @ DAL,102,3,Regular Season
22021,1610612745,HOU,Houston Rockets,0022100372,2021-12-08T00:00:00Z,HOU vs. BKN,114,10,1610612751,BKN,Brooklyn Nets,BKN @ HOU,104,-10,Regular Season
22021,1610612739,CLE,Cleveland Cavaliers,0022100367,2021-12-08T00:00:00Z,CLE vs. CHI,115,23,1610612741,CHI,Chicago Bulls,CHI @ CLE,92,-23,Regular Season
22021,1610612761,TOR,Toronto Raptors,0022100371,2021-12-08T00:00:00Z,TOR vs. OKC,109,-1,1610612760,OKC,Oklahoma City Thunder,OKC @ TOR,110,1,Regular Season
22021,1610612750,MIN,Minnesota Timberwolves,0022100374,2021-12-08T00:00:00Z,MIN vs. UTA,104,-32,1610612762,UTA,Utah Jazz,UTA @ MIN,136,32,Regular Season
22021,1610612766,CHA,Charlotte Hornets,0022100366,2021-12-08T00:00:00Z,CHA vs. PHI,106,-4,1610612755,PHI,Philadelphia 76ers,PHI @ CHA,110,4,Regular Season
22021,1610612754,IND,Indiana Pacers,0022100369,2021-12-08T00:00:00Z,IND vs. NYK,122,20,1610612752,NYK,New York Knicks,NYK @ IND,102,-20,Regular Season
22021,1610612765,DET,Detroit Pistons,0022100368,2021-12-08T00:00:00Z,DET vs. WAS,116,-3,1610612764,WAS,Washington Wizards,WAS @ DET,119,3,Regular Season
22021,1610612744,GSW,Golden State Warriors,0022100376,2021-12-08T00:00:00Z,GSW vs. POR,104,10,1610612757,POR,Portland Trail Blazers,POR @ GSW,94,-10,Regular Season
22021,1610612748,MIA,Miami Heat,0022100370,2021-12-08T00:00:00Z,MIA vs. MIL,113,9,1610612749,MIL,Milwaukee Bucks,MIL @ MIA,104,-9,Regular Season
22021,1610612763,MEM,Memphis Grizzlies,0022100373,2021-12-08T00:00:00Z,MEM vs. DAL,96,-8,1610612742,DAL,Dallas Mavericks,DAL @ MEM,104,8,Regular Season
22021,1610612740,NOP,New Orleans Pelicans,0022100375,2021-12-08T00:00:00Z,NOP vs. DEN,114,-6,1610612743,DEN,Denver Nuggets,DEN @ NOP,120,6,Regular Season
22021,1610612758,SAC,Sacramento Kings,0022100377,2021-12-08T00:00:00Z,SAC vs. ORL,142,12,1610612753,ORL,Orlando Magic,ORL @ SAC,130,-12,Regular Season
22021,1610612746,LAC,LA Clippers,0022100378,2021-12-08T00:00:00Z,LAC vs. BOS,114,3,1610612738,BOS,Boston Celtics,BOS @ LAC,111,-3,Regular Season
22021,1610612755,PHI,Philadelphia 76ers,0022100379,2021-12-09T00:00:00Z,PHI vs. UTA,96,-22,1610612762,UTA,Utah Jazz,UTA @ PHI,118,22,Regular Season
22021,1610612763,MEM,Memphis Grizzlies,0022100380,2021-12-09T00:00:00Z,MEM vs. LAL,108,13,1610612747,LAL,Los Angeles Lakers,LAL @ MEM,95,-13,Regular Season
22021,1610612759,SAS,San Antonio Spurs,0022100381,2021-12-09T00:00:00Z,SAS vs. DEN,123,12,1610612743,DEN,Denver Nuggets,DEN @ SAS,111,-12,Regular Season
22021,1610612745,HOU,Houston Rockets,0022100386,2021-12-10T00:00:00Z,HOU vs. MIL,114,-9,1610612749,MIL,Milwaukee Bucks,MIL @ HOU,123,9,Regular Season
22021,1610612737,ATL,Atlanta Hawks,0022100384,2021-12-10T00:00:00Z,ATL vs. BKN,105,-8,1610612751,BKN,Brooklyn Nets,BKN @ ATL,113,8,Regular Season
22021,1610612766,CHA,Charlotte Hornets,0022100382,2021-12-10T00:00:00Z,CHA vs. SAC,124,1,1610612758,SAC,Sacramento Kings,SAC @ CHA,123,-1,Regular Season
22021,1610612740,NOP,New Orleans Pelicans,0022100388,2021-12-10T00:00:00Z,NOP vs. DET,109,16,1610612765,DET,Detroit Pistons,DET @ NOP,93,-16,Regular Season
22021,1610612761,TOR,Toronto Raptors,0022100385,2021-12-10T00:00:00Z,TOR vs. NYK,90,3,1610612752,NYK,New York Knicks,NYK @ TOR,87,-3,Regular Season
22021,1610612756,PHX,Phoenix Suns,0022100390,2021-12-10T00:00:00Z,PHX vs. BOS,111,21,1610612738,BOS,Boston Celtics,BOS @ PHX,90,-21,Regular Season
22021,1610612754,IND,Indiana Pacers,0022100383,2021-12-10T00:00:00Z,IND vs. DAL,106,13,1610612742,DAL,Dallas Mavericks,DAL @ IND,93,-13,Regular Season
22021,1610612760,OKC,Oklahoma City Thunder,0022100389,2021-12-10T00:00:00Z,OKC vs. LAL,95,-21,1610612747,LAL,Los Angeles Lakers,LAL @ OKC,116,21,Regular Season
22021,1610612750,MIN,Minnesota Timberwolves,0022100387,2021-12-10T00:00:00Z,MIN vs. CLE,106,-17,1610612739,CLE,Cleveland Cavaliers,CLE @ MIN,123,17,Regular Season
22021,1610612759,SAS,San Antonio Spurs,0022100397,2021-12-11T00:00:00Z,SAS vs. DEN,112,-15,1610612743,DEN,Denver Nuggets,DEN @ SAS,127,15,Regular Season
22021,1610612746,LAC,LA Clippers,0022100391,2021-12-11T00:00:00Z,LAC vs. ORL,106,2,1610612753,ORL,Orlando Magic,ORL @ LAC,104,-2,Regular Season
22021,1610612748,MIA,Miami Heat,0022100394,2021-12-11T00:00:00Z,MIA vs. CHI,118,26,1610612741,CHI,Chicago Bulls,CHI @ MIA,92,-26,Regular Season
22021,1610612739,CLE,Cleveland Cavaliers,0022100393,2021-12-11T00:00:00Z,CLE vs. SAC,117,14,1610612758,SAC,Sacramento Kings,SAC @ CLE,103,-14,Regular Season
22021,1610612764,WAS,Washington Wizards,0022100392,2021-12-11T00:00:00Z,WAS vs. UTA,98,-25,1610612762,UTA,Utah Jazz,UTA @ WAS,123,25,Regular Season
22021,1610612755,PHI,Philadelphia 76ers,0022100396,2021-12-11T00:00:00Z,PHI vs. GSW,102,9,1610612744,GSW,Golden State Warriors,GSW @ PHI,93,-9,Regular Season
22021,1610612763,MEM,Memphis Grizzlies,0022100395,2021-12-11T00:00:00Z,MEM vs. HOU,113,7,1610612745,HOU,Houston Rockets,HOU @ MEM,106,-7,Regular Season
22021,1610612752,NYK,New York Knicks,0022100398,2021-12-12T00:00:00Z,NYK vs. MIL,97,-15,1610612749,MIL,Milwaukee Bucks,MIL @ NYK,112,15,Regular Season
22021,1610612765,DET,Detroit Pistons,0022100399,2021-12-12T00:00:00Z,DET vs. BKN,104,-12,1610612751,BKN,Brooklyn Nets,BKN @ DET,116,12,Regular Season
22021,1610612757,POR,Portland Trail Blazers,0022100402,2021-12-12T00:00:00Z,POR vs. MIN,111,-5,1610612750,MIN,Minnesota Timberwolves,MIN @ POR,116,5,Regular Season
22021,1610612747,LAL,Los Angeles Lakers,0022100403,2021-12-12T00:00:00Z,LAL vs. ORL,106,12,1610612753,ORL,Orlando Magic,ORL @ LAL,94,-12,Regular Season
22021,1610612759,SAS,San Antonio Spurs,0022100401,2021-12-12T00:00:00Z,SAS vs. NOP,112,15,1610612740,NOP,New Orleans Pelicans,NOP @ SAS,97,-15,Regular Season
22021,1610612760,OKC,Oklahoma City Thunder,0022100400,2021-12-12T00:00:00Z,OKC vs. DAL,84,-19,1610612742,DAL,Dallas Mavericks,DAL @ OKC,103,19,Regular Season
22021,1610612761,TOR,Toronto Raptors,0022100406,2021-12-13T00:00:00Z,TOR vs. SAC,124,23,1610612758,SAC,Sacramento Kings,SAC @ TOR,101,-23,Regular Season
22021,1610612739,CLE,Cleveland Cavaliers,0022100404,2021-12-13T00:00:00Z,CLE vs. MIA,105,11,1610612748,MIA,Miami Heat,MIA @ CLE,94,-11,Regular Season
22021,1610612737,ATL,Atlanta Hawks,0022100407,2021-12-13T00:00:00Z,ATL vs. HOU,126,-6,1610612745,HOU,Houston Rockets,HOU @ ATL,132,6,Regular Season
22021,1610612742,DAL,Dallas Mavericks,0022100410,2021-12-13T00:00:00Z,DAL vs. CHA,120,24,1610612766,CHA,Charlotte Hornets,CHA @ DAL,96,-24,Regular Season
22021,1610612763,MEM,Memphis Grizzlies,0022100409,2021-12-13T00:00:00Z,MEM vs. PHI,126,35,1610612755,PHI,Philadelphia 76ers,PHI @ MEM,91,-35,Regular Season
22021,1610612743,DEN,Denver Nuggets,0022100411,2021-12-13T00:00:00Z,DEN vs. WAS,113,6,1610612764,WAS,Washington Wizards,WAS @ DEN,107,-6,Regular Season
22021,1610612746,LAC,LA Clippers,0022100412,2021-12-13T00:00:00Z,LAC vs. PHX,111,16,1610612756,PHX,Phoenix Suns,PHX @ LAC,95,-16,Regular Season
22021,1610612738,BOS,Boston Celtics,0022100408,2021-12-13T00:00:00Z,BOS vs. MIL,117,14,1610612749,MIL,Milwaukee Bucks,MIL @ BOS,103,-14,Regular Season
22021,1610612754,IND,Indiana Pacers,0022100405,2021-12-13T00:00:00Z,IND vs. GSW,100,-2,1610612744,GSW,Golden State Warriors,GSW @ IND,102,2,Regular Season
22021,1610612757,POR,Portland Trail Blazers,0022100416,2021-12-14T00:00:00Z,POR vs. PHX,107,-4,1610612756,PHX,Phoenix Suns,PHX @ POR,111,4,Regular Season
22021,1610612752,NYK,New York Knicks,0022100414,2021-12-14T00:00:00Z,NYK vs. GSW,96,-9,1610612744,GSW,Golden State Warriors,GSW @ NYK,105,9,Regular Season
22021,1610612751,BKN,Brooklyn Nets,0022100413,2021-12-14T00:00:00Z,BKN vs. TOR,131,2,1610612761,TOR,Toronto Raptors,TOR @ BKN,129,-2,Regular Season
22021,1610612759,SAS,San Antonio Spurs,0022100423,2021-12-15T00:00:00Z,SAS vs. CHA,115,-16,1610612766,CHA,Charlotte Hornets,CHA @ SAS,131,16,Regular Season
22021,1610612760,OKC,Oklahoma City Thunder,0022100422,2021-12-15T00:00:00Z,OKC vs. NOP,110,-3,1610612740,NOP,New Orleans Pelicans,NOP @ OKC,113,3,Regular Season
22021,1610612743,DEN,Denver Nuggets,0022100424,2021-12-15T00:00:00Z,DEN vs. MIN,107,-17,1610612750,MIN,Minnesota Timberwolves,MIN @ DEN,124,17,Regular Season
22021,1610612742,DAL,Dallas Mavericks,0022100420,2021-12-15T00:00:00Z,DAL vs. LAL,104,-3,1610612747,LAL,Los Angeles Lakers,LAL @ DAL,107,3,Regular Season
22021,1610612758,SAC,Sacramento Kings,0022100427,2021-12-15T00:00:00Z,SAC vs. WAS,119,14,1610612764,WAS,Washington Wizards,WAS @ SAC,105,-14,Regular Season
22021,1610612749,MIL,Milwaukee Bucks,0022100421,2021-12-15T00:00:00Z,MIL vs. IND,114,15,1610612754,IND,Indiana Pacers,IND @ MIL,99,-15,Regular Season
22021,1610612762,UTA,Utah Jazz,0022100425,2021-12-15T00:00:00Z,UTA vs. LAC,124,21,1610612746,LAC,LA Clippers,LAC @ UTA,103,-21,Regular Season
22021,1610612757,POR,Portland Trail Blazers,0022100426,2021-12-15T00:00:00Z,POR vs. MEM,103,-10,1610612763,MEM,Memphis Grizzlies,MEM @ POR,113,10,Regular Season
22021,1610612755,PHI,Philadelphia 76ers,0022100419,2021-12-15T00:00:00Z,PHI vs. MIA,96,-5,1610612748,MIA,Miami Heat,MIA @ PHI,101,5,Regular Season
22021,1610612739,CLE,Cleveland Cavaliers,0022100417,2021-12-15T00:00:00Z,CLE vs. HOU,124,35,1610612745,HOU,Houston Rockets,HOU @ CLE,89,-35,Regular Season
22021,1610612753,ORL,Orlando Magic,0022100418,2021-12-15T00:00:00Z,ORL vs. ATL,99,-12,1610612737,ATL,Atlanta Hawks,ATL @ ORL,111,12,Regular Season
22021,1610612751,BKN,Brooklyn Nets,0022100429,2021-12-16T00:00:00Z,BKN vs. PHI,114,9,1610612755,PHI,Philadelphia 76ers,PHI @ BKN,105,-9,Regular Season
22021,1610612754,IND,Indiana Pacers,0022100428,2021-12-16T00:00:00Z,IND vs. DET,122,9,1610612765,DET,Detroit Pistons,DET @ IND,113,-9,Regular Season
22021,1610612745,HOU,Houston Rockets,0022100431,2021-12-16T00:00:00Z,HOU vs. NYK,103,-13,1610612752,NYK,New York Knicks,NYK @ HOU,116,13,Regular Season
22021,1610612756,PHX,Phoenix Suns,0022100432,2021-12-16T00:00:00Z,PHX vs. WAS,118,20,1610612764,WAS,Washington Wizards,WAS @ PHX,98,-20,Regular Season
22021,1610612762,UTA,Utah Jazz,0022100437,2021-12-17T00:00:00Z,UTA vs. SAS,126,-2,1610612759,SAS,San Antonio Spurs,SAS @ UTA,128,2,Regular Season
22021,1610612750,MIN,Minnesota Timberwolves,0022100436,2021-12-17T00:00:00Z,MIN vs. LAL,110,18,1610612747,LAL,Los Angeles Lakers,LAL @ MIN,92,-18,Regular Season
22021,1610612757,POR,Portland Trail Blazers,0022100439,2021-12-17T00:00:00Z,POR vs. CHA,125,9,1610612766,CHA,Charlotte Hornets,CHA @ POR,116,-9,Regular Season
22021,1610612740,NOP,New Orleans Pelicans,0022100438,2021-12-17T00:00:00Z,NOP vs. MIL,116,4,1610612749,MIL,Milwaukee Bucks,MIL @ NOP,112,-4,Regular Season
22021,1610612758,SAC,Sacramento Kings,0022100440,2021-12-17T00:00:00Z,SAC vs. MEM,105,-19,1610612763,MEM,Memphis Grizzlies,MEM @ SAC,124,19,Regular Season
22021,1610612753,ORL,Orlando Magic,0022100433,2021-12-17T00:00:00Z,ORL vs. MIA,105,-10,1610612748,MIA,Miami Heat,MIA @ ORL,115,10,Regular Season
22021,1610612737,ATL,Atlanta Hawks,0022100434,2021-12-17T00:00:00Z,ATL vs. DEN,115,-18,1610612743,DEN,Denver Nuggets,DEN @ ATL,133,18,Regular Season
22021,1610612738,BOS,Boston Celtics,0022100435,2021-12-17T00:00:00Z,BOS vs. GSW,107,-4,1610612744,GSW,Golden State Warriors,GSW @ BOS,111,4,Regular Season
22021,1610612765,DET,Detroit Pistons,0022100441,2021-12-18T00:00:00Z,DET vs. HOU,107,-9,1610612745,HOU,Houston Rockets,HOU @ DET,116,9,Regular Season
22021,1610612762,UTA,Utah Jazz,0022100447,2021-12-18T00:00:00Z,UTA vs. WAS,103,-6,1610612764,WAS,Washington Wizards,WAS @ UTA,109,6,Regular Season
22021,1610612738,BOS,Boston Celtics,0022100445,2021-12-18T00:00:00Z,BOS vs. NYK,114,7,1610612752,NYK,New York Knicks,NYK @ BOS,107,-7,Regular Season
22021,1610612761,TOR,Toronto Raptors,0022100443,2021-12-18T00:00:00Z,TOR vs. GSW,119,19,1610612744,GSW,Golden State Warriors,GSW @ TOR,100,-19,Regular Season
22021,1610612760,OKC,Oklahoma City Thunder,0022100444,2021-12-18T00:00:00Z,OKC vs. LAC,104,1,1610612746,LAC,LA Clippers,LAC @ OKC,103,-1,Regular Season
22021,1610612751,BKN,Brooklyn Nets,0022100442,2021-12-18T00:00:00Z,BKN vs. ORL,93,-7,1610612753,ORL,Orlando Magic,ORL @ BKN,100,7,Regular Season
22021,1610612749,MIL,Milwaukee Bucks,0022100446,2021-12-18T00:00:00Z,MIL vs. CLE,90,-29,1610612739,CLE,Cleveland Cavaliers,CLE @ MIL,119,29,Regular Season
22021,1610612765,DET,Detroit Pistons,0022100449,2021-12-19T00:00:00Z,DET vs. MIA,100,10,1610612748,MIA,Miami Heat,MIA @ DET,90,-10,Regular Season
22021,1610612758,SAC,Sacramento Kings,0022100451,2021-12-19T00:00:00Z,SAC vs. SAS,121,7,1610612759,SAS,San Antonio Spurs,SAS @ SAC,114,-7,Regular Season
22021,1610612741,CHI,Chicago Bulls,0022100448,2021-12-19T00:00:00Z,CHI vs. LAL,115,5,1610612747,LAL,Los Angeles Lakers,LAL @ CHI,110,-5,Regular Season
22021,1610612750,MIN,Minnesota Timberwolves,0022100455,2021-12-19T00:00:00Z,MIN vs. DAL,111,6,1610612742,DAL,Dallas Mavericks,DAL @ MIN,105,-6,Regular Season
22021,1610612763,MEM,Memphis Grizzlies,0022100450,2021-12-19T00:00:00Z,MEM vs. POR,100,-5,1610612757,POR,Portland Trail Blazers,POR @ MEM,105,5,Regular Season
22021,1610612756,PHX,Phoenix Suns,0022100456,2021-12-19T00:00:00Z,PHX vs. CHA,137,31,1610612766,CHA,Charlotte Hornets,CHA @ PHX,106,-31,Regular Season
22021,1610612746,LAC,LA Clippers,0022100463,2021-12-20T00:00:00Z,LAC vs. SAS,92,-24,1610612759,SAS,San Antonio Spurs,SAS @ LAC,116,24,Regular Season
22021,1610612741,CHI,Chicago Bulls,0022100459,2021-12-20T00:00:00Z,CHI vs. HOU,133,15,1610612745,HOU,Houston Rockets,HOU @ CHI,118,-15,Regular Season
22021,1610612744,GSW,Golden State Warriors,0022100462,2021-12-20T00:00:00Z,GSW vs. SAC,113,15,1610612758,SAC,Sacramento Kings,SAC @ GSW,98,-15,Regular Season
22021,1610612738,BOS,Boston Celtics,0022100457,2021-12-20T00:00:00Z,BOS vs. PHI,103,-5,1610612755,PHI,Philadelphia 76ers,PHI @ BOS,108,5,Regular Season
22021,1610612762,UTA,Utah Jazz,0022100461,2021-12-20T00:00:00Z,UTA vs. CHA,112,10,1610612766,CHA,Charlotte Hornets,CHA @ UTA,102,-10,Regular Season
22021,1610612763,MEM,Memphis Grizzlies,0022100460,2021-12-20T00:00:00Z,MEM vs. OKC,99,-3,1610612760,OKC,Oklahoma City Thunder,OKC @ MEM,102,3,Regular Season
22021,1610612742,DAL,Dallas Mavericks,0022100468,2021-12-21T00:00:00Z,DAL vs. MIN,114,12,1610612750,MIN,Minnesota Timberwolves,MIN @ DAL,102,-12,Regular Season
22021,1610612747,LAL,Los Angeles Lakers,0022100469,2021-12-21T00:00:00Z,LAL vs. PHX,90,-18,1610612756,PHX,Phoenix Suns,PHX @ LAL,108,18,Regular Season
22021,1610612748,MIA,Miami Heat,0022100465,2021-12-21T00:00:00Z,MIA vs. IND,125,29,1610612754,IND,Indiana Pacers,IND @ MIA,96,-29,Regular Season
22021,1610612752,NYK,New York Knicks,0022100466,2021-12-21T00:00:00Z,NYK vs. DET,105,14,1610612765,DET,Detroit Pistons,DET @ NYK,91,-14,Regular Season
22021,1610612740,NOP,New Orleans Pelicans,0022100467,2021-12-21T00:00:00Z,NOP vs. POR,111,14,1610612757,POR,Portland Trail Blazers,POR @ NOP,97,-14,Regular Season
22021,1610612758,SAC,Sacramento Kings,0022100475,2021-12-22T00:00:00Z,SAC vs. LAC,89,-16,1610612746,LAC,LA Clippers,LAC @ SAC,105,16,Regular Season
22021,1610612738,BOS,Boston Celtics,0022100471,2021-12-22T00:00:00Z,BOS vs. CLE,111,10,1610612739,CLE,Cleveland Cavaliers,CLE @ BOS,101,-10,Regular Season
22021,1610612737,ATL,Atlanta Hawks,0022100470,2021-12-22T00:00:00Z,ATL vs. ORL,98,-6,1610612753,ORL,Orlando Magic,ORL @ ATL,104,6,Regular Season
22021,1610612760,OKC,Oklahoma City Thunder,0022100474,2021-12-22T00:00:00Z,OKC vs. DEN,108,14,1610612743,DEN,Denver Nuggets,DEN @ OKC,94,-14,Regular Season
22021,1610612749,MIL,Milwaukee Bucks,0022100473,2021-12-22T00:00:00Z,MIL vs. HOU,126,20,1610612745,HOU,Houston Rockets,HOU @ MIL,106,-20,Regular Season
22021,1610612752,NYK,New York Knicks,0022100480,2021-12-23T00:00:00Z,NYK vs. WAS,117,-7,1610612764,WAS,Washington Wizards,WAS @ NYK,124,7,Regular Season
22021,1610612747,LAL,Los Angeles Lakers,0022100487,2021-12-23T00:00:00Z,LAL vs. SAS,110,-28,1610612759,SAS,San Antonio Spurs,SAS @ LAL,138,28,Regular Season
22021,1610612743,DEN,Denver Nuggets,0022100482,2021-12-23T00:00:00Z,DEN vs. CHA,107,-8,1610612766,CHA,Charlotte Hornets,CHA @ DEN,115,8,Regular Season
22021,1610612755,PHI,Philadelphia 76ers,0022100478,2021-12-23T00:00:00Z,PHI vs. ATL,96,-2,1610612737,ATL,Atlanta Hawks,ATL @ PHI,98,2,Regular Season
22021,1610612754,IND,Indiana Pacers,0022100476,2021-12-23T00:00:00Z,IND vs. HOU,118,12,1610612745,HOU,Houston Rockets,HOU @ IND,106,-12,Regular Season
22021,1610612753,ORL,Orlando Magic,0022100477,2021-12-23T00:00:00Z,ORL vs. NOP,104,-6,1610612740,NOP,New Orleans Pelicans,NOP @ ORL,110,6,Regular Season
22021,1610612756,PHX,Phoenix Suns,0022100483,2021-12-23T00:00:00Z,PHX vs. OKC,113,12,1610612760,OKC,Oklahoma City Thunder,OKC @ PHX,101,-12,Regular Season
22021,1610612748,MIA,Miami Heat,0022100479,2021-12-23T00:00:00Z,MIA vs. DET,115,3,1610612765,DET,Detroit Pistons,DET @ MIA,112,-3,Regular Season
22021,1610612742,DAL,Dallas Mavericks,0022100481,2021-12-23T00:00:00Z,DAL vs. MIL,95,-7,1610612749,MIL,Milwaukee Bucks,MIL @ DAL,102,7,Regular Season
22021,1610612762,UTA,Utah Jazz,0022100484,2021-12-23T00:00:00Z,UTA vs. MIN,128,12,1610612750,MIN,Minnesota Timberwolves,MIN @ UTA,116,-12,Regular Season
22021,1610612744,GSW,Golden State Warriors,0022100485,2021-12-23T00:00:00Z,GSW vs. MEM,113,9,1610612763,MEM,Memphis Grizzlies,MEM @ GSW,104,-9,Regular Season
22021,1610612756,PHX,Phoenix Suns,0022100490,2021-12-25T00:00:00Z,PHX vs. GSW,107,-9,1610612744,GSW,Golden State Warriors,GSW @ PHX,116,9,Regular Season
22021,1610612749,MIL,Milwaukee Bucks,0022100489,2021-12-25T00:00:00Z,MIL vs. BOS,117,4,1610612738,BOS,Boston Celtics,BOS @ MIL,113,-4,Regular Season
22021,1610612762,UTA,Utah Jazz,0022100492,2021-12-25T00:00:00Z,UTA vs. DAL,120,4,1610612742,DAL,Dallas Mavericks,DAL @ UTA,116,-4,Regular Season
22021,1610612752,NYK,New York Knicks,0022100488,2021-12-25T00:00:00Z,NYK vs. ATL,101,14,1610612737,ATL,Atlanta Hawks,ATL @ NYK,87,-14,Regular Season
22021,1610612747,LAL,Los Angeles Lakers,0022100491,2021-12-25T00:00:00Z,LAL vs. BKN,115,-7,1610612751,BKN,Brooklyn Nets,BKN @ LAL,122,7,Regular Season
22021,1610612764,WAS,Washington Wizards,0022100495,2021-12-26T00:00:00Z,WAS vs. PHI,96,-21,1610612755,PHI,Philadelphia 76ers,PHI @ WAS,117,21,Regular Season
22021,1610612759,SAS,San Antonio Spurs,0022100498,2021-12-26T00:00:00Z,SAS vs. DET,144,35,1610612765,DET,Detroit Pistons,DET @ SAS,109,-35,Regular Season
22021,1610612741,CHI,Chicago Bulls,0022100499,2021-12-26T00:00:00Z,CHI vs. IND,113,8,1610612754,IND,Indiana Pacers,IND @ CHI,105,-8,Regular Season
22021,1610612748,MIA,Miami Heat,0022100493,2021-12-26T00:00:00Z,MIA vs. ORL,93,10,1610612753,ORL,Orlando Magic,ORL @ MIA,83,-10,Regular Season
22021,1610612760,OKC,Oklahoma City Thunder,0022100497,2021-12-26T00:00:00Z,OKC vs. NOP,117,5,1610612740,NOP,New Orleans Pelicans,NOP @ OKC,112,-5,Regular Season
22021,1610612758,SAC,Sacramento Kings,0022100496,2021-12-26T00:00:00Z,SAC vs. MEM,102,-25,1610612763,MEM,Memphis Grizzlies,MEM @ SAC,127,25,Regular Season
22021,1610612746,LAC,LA Clippers,0022100500,2021-12-26T00:00:00Z,LAC vs. DEN,100,-3,1610612743,DEN,Denver Nuggets,DEN @ LAC,103,3,Regular Season
22021,1610612739,CLE,Cleveland Cavaliers,0022100494,2021-12-26T00:00:00Z,CLE vs. TOR,144,45,1610612761,TOR,Toronto Raptors,TOR @ CLE,99,-45,Regular Season
22021,1610612766,CHA,Charlotte Hornets,0022100501,2021-12-27T00:00:00Z,CHA vs. HOU,123,24,1610612745,HOU,Houston Rockets,HOU @ CHA,99,-24,Regular Season
22021,1610612756,PHX,Phoenix Suns,0022100505,2021-12-27T00:00:00Z,PHX vs. MEM,113,-1,1610612763,MEM,Memphis Grizzlies,MEM @ PHX,114,1,Regular Season
22021,1610612757,POR,Portland Trail Blazers,0022100506,2021-12-27T00:00:00Z,POR vs. DAL,117,-15,1610612742,DAL,Dallas Mavericks,DAL @ POR,132,15,Regular Season
22021,1610612746,LAC,LA Clippers,0022100507,2021-12-27T00:00:00Z,LAC vs. BKN,108,-16,1610612751,BKN,Brooklyn Nets,BKN @ LAC,124,16,Regular Season
22021,1610612737,ATL,Atlanta Hawks,0022100502,2021-12-27T00:00:00Z,ATL vs. CHI,118,-12,1610612741,CHI,Chicago Bulls,CHI @ ATL,130,12,Regular Season
22021,1610612759,SAS,San Antonio Spurs,0022100504,2021-12-27T00:00:00Z,SAS vs. UTA,104,-6,1610612762,UTA,Utah Jazz,UTA @ SAS,110,6,Regular Season
22021,1610612750,MIN,Minnesota Timberwolves,0022100503,2021-12-27T00:00:00Z,MIN vs. BOS,108,5,1610612738,BOS,Boston Celtics,BOS @ MIN,103,-5,Regular Season
22021,1610612761,TOR,Toronto Raptors,0022100510,2021-12-28T00:00:00Z,TOR vs. PHI,109,-5,1610612755,PHI,Philadelphia 76ers,PHI @ TOR,114,5,Regular Season
22021,1610612745,HOU,Houston Rockets,0022100511,2021-12-28T00:00:00Z,HOU vs. LAL,123,-9,1610612747,LAL,Los Angeles Lakers,LAL @ HOU,132,9,Regular Season
22021,1610612758,SAC,Sacramento Kings,0022100515,2021-12-28T00:00:00Z,SAC vs. OKC,117,6,1610612760,OKC,Oklahoma City Thunder,OKC @ SAC,111,-6,Regular Season
22021,1610612750,MIN,Minnesota Timberwolves,0022100512,2021-12-28T00:00:00Z,MIN vs. NYK,88,-8,1610612752,NYK,New York Knicks,NYK @ MIN,96,8,Regular Season
22021,1610612740,NOP,New Orleans Pelicans,0022100513,2021-12-28T00:00:00Z,NOP vs. CLE,108,4,1610612739,CLE,Cleveland Cavaliers,CLE @ NOP,104,-4,Regular Season
22021,1610612744,GSW,Golden State Warriors,0022100514,2021-12-28T00:00:00Z,GSW vs. DEN,86,-3,1610612743,DEN,Denver Nuggets,DEN @ GSW,89,3,Regular Season
22021,1610612748,MIA,Miami Heat,0022100509,2021-12-28T00:00:00Z,MIA vs. WAS,119,7,1610612764,WAS,Washington Wizards,WAS @ MIA,112,-7,Regular Season
22021,1610612753,ORL,Orlando Magic,0022100508,2021-12-28T00:00:00Z,ORL vs. MIL,110,-17,1610612749,MIL,Milwaukee Bucks,MIL @ ORL,127,17,Regular Season
22021,1610612738,BOS,Boston Celtics,0022100518,2021-12-29T00:00:00Z,BOS vs. LAC,82,-9,1610612746,LAC,LA Clippers,LAC @ BOS,91,9,Regular Season
22021,1610612758,SAC,Sacramento Kings,0022100524,2021-12-29T00:00:00Z,SAC vs. DAL,95,1,1610612742,DAL,Dallas Mavericks,DAL @ SAC,94,-1,Regular Season
22021,1610612757,POR,Portland Trail Blazers,0022100523,2021-12-29T00:00:00Z,POR vs. UTA,105,-15,1610612762,UTA,Utah Jazz,UTA @ POR,120,15,Regular Season
22021,1610612756,PHX,Phoenix Suns,0022100522,2021-12-29T00:00:00Z,PHX vs. OKC,115,18,1610612760,OKC,Oklahoma City Thunder,OKC @ PHX,97,-18,Regular Season
22021,1610612763,MEM,Memphis Grizzlies,0022100520,2021-12-29T00:00:00Z,MEM vs. LAL,104,5,1610612747,LAL,Los Angeles Lakers,LAL @ MEM,99,-5,Regular Season
22021,1610612741,CHI,Chicago Bulls,0022100519,2021-12-29T00:00:00Z,CHI vs. ATL,131,14,1610612737,ATL,Atlanta Hawks,ATL @ CHI,117,-14,Regular Season
22021,1610612754,IND,Indiana Pacers,0022100517,2021-12-29T00:00:00Z,IND vs. CHA,108,-8,1610612766,CHA,Charlotte Hornets,CHA @ IND,116,8,Regular Season
22021,1610612765,DET,Detroit Pistons,0022100516,2021-12-29T00:00:00Z,DET vs. NYK,85,-9,1610612752,NYK,New York Knicks,NYK @ DET,94,9,Regular Season
22021,1610612753,ORL,Orlando Magic,0022100526,2021-12-30T00:00:00Z,ORL vs. MIL,118,-18,1610612749,MIL,Milwaukee Bucks,MIL @ ORL,136,18,Regular Season
22021,1610612751,BKN,Brooklyn Nets,0022100525,2021-12-30T00:00:00Z,BKN vs. PHI,102,-8,1610612755,PHI,Philadelphia 76ers,PHI @ BKN,110,8,Regular Season
22021,1610612764,WAS,Washington Wizards,0022100527,2021-12-30T00:00:00Z,WAS vs. CLE,110,17,1610612739,CLE,Cleveland Cavaliers,CLE @ WAS,93,-17,Regular Season
22021,1610612745,HOU,Houston Rockets,0022100532,2021-12-31T00:00:00Z,HOU vs. MIA,110,-10,1610612748,MIA,Miami Heat,MIA @ HOU,120,10,Regular Season
22021,1610612761,TOR,Toronto Raptors,0022100534,2021-12-31T00:00:00Z,TOR vs. LAC,116,8,1610612746,LAC,LA Clippers,LAC @ TOR,108,-8,Regular Season
22021,1610612758,SAC,Sacramento Kings,0022100531,2021-12-31T00:00:00Z,SAC vs. DAL,96,-16,1610612742,DAL,Dallas Mavericks,DAL @ SAC,112,16,Regular Season
22021,1610612760,OKC,Oklahoma City Thunder,0022100536,2021-12-31T00:00:00Z,OKC vs. NYK,95,15,1610612752,NYK,New York Knicks,NYK @ OKC,80,-15,Regular Season
22021,1610612754,IND,Indiana Pacers,0022100530,2021-12-31T00:00:00Z,IND vs. CHI,106,-2,1610612741,CHI,Chicago Bulls,CHI @ IND,108,2,Regular Season
22021,1610612738,BOS,Boston Celtics,0022100529,2021-12-31T00:00:00Z,BOS vs. PHX,123,15,1610612756,PHX,Phoenix Suns,PHX @ BOS,108,-15,Regular Season
22021,1610612739,CLE,Cleveland Cavaliers,0022100533,2021-12-31T00:00:00Z,CLE vs. ATL,118,-3,1610612737,ATL,Atlanta Hawks,ATL @ CLE,121,3,Regular Season
22021,1610612763,MEM,Memphis Grizzlies,0022100535,2021-12-31T00:00:00Z,MEM vs. SAS,118,13,1610612759,SAS,San Antonio Spurs,SAS @ MEM,105,-13,Regular Season
22021,1610612747,LAL,Los Angeles Lakers,0022100538,2021-12-31T00:00:00Z,LAL vs. POR,139,33,1610612757,POR,Portland Trail Blazers,POR @ LAL,106,-33,Regular Season
22021,1610612762,UTA,Utah Jazz,0022100537,2021-12-31T00:00:00Z,UTA vs. MIN,120,12,1610612750,MIN,Minnesota Timberwolves,MIN @ UTA,108,-12,Regular Season
22021,1610612764,WAS,Washington Wizards,0022100541,2022-01-01T00:00:00Z,WAS vs. CHI,119,-1,1610612741,CHI,Chicago Bulls,CHI @ WAS,120,1,Regular Season
22021,1610612745,HOU,Houston Rockets,0022100543,2022-01-01T00:00:00Z,HOU vs. DEN,111,-13,1610612743,DEN,Denver Nuggets,DEN @ HOU,124,13,Regular Season
22021,1610612749,MIL,Milwaukee Bucks,0022100539,2022-01-01T00:00:00Z,MIL vs. NOP,136,23,1610612740,NOP,New Orleans Pelicans,NOP @ MIL,113,-23,Regular Season
22021,1610612762,UTA,Utah Jazz,0022100544,2022-01-01T00:00:00Z,UTA vs. GSW,116,-7,1610612744,GSW,Golden State Warriors,GSW @ UTA,123,7,Regular Season
22021,1610612765,DET,Detroit Pistons,0022100540,2022-01-01T00:00:00Z,DET vs. SAS,117,1,1610612759,SAS,San Antonio Spurs,SAS @ DET,116,-1,Regular Season
22021,1610612751,BKN,Brooklyn Nets,0022100542,2022-01-01T00:00:00Z,BKN vs. LAC,116,-4,1610612746,LAC,LA Clippers,LAC @ BKN,120,4,Regular Season
22021,1610612766,CHA,Charlotte Hornets,0022100549,2022-01-02T00:00:00Z,CHA vs. PHX,99,-34,1610612756,PHX,Phoenix Suns,PHX @ CHA,133,34,Regular Season
22021,1610612739,CLE,Cleveland Cavaliers,0022100547,2022-01-02T00:00:00Z,CLE vs. IND,108,4,1610612754,IND,Indiana Pacers,IND @ CLE,104,-4,Regular Season
22021,1610612758,SAC,Sacramento Kings,0022100548,2022-01-02T00:00:00Z,SAC vs. MIA,115,2,1610612748,MIA,Miami Heat,MIA @ SAC,113,-2,Regular Season
22021,1610612760,OKC,Oklahoma City Thunder,0022100550,2022-01-02T00:00:00Z,OKC vs. DAL,86,-9,1610612742,DAL,Dallas Mavericks,DAL @ OKC,95,9,Regular Season
22021,1610612747,LAL,Los Angeles Lakers,0022100551,2022-01-02T00:00:00Z,LAL vs. MIN,108,5,1610612750,MIN,Minnesota Timberwolves,MIN @ LAL,103,-5,Regular Season
22021,1610612761,TOR,Toronto Raptors,0022100545,2022-01-02T00:00:00Z,TOR vs. NYK,120,15,1610612752,NYK,New York Knicks,NYK @ TOR,105,-15,Regular Season
22021,1610612738,BOS,Boston Celtics,0022100546,2022-01-02T00:00:00Z,BOS vs. ORL,116,5,1610612753,ORL,Orlando Magic,ORL @ BOS,111,-5,Regular Season
22021,1610612764,WAS,Washington Wizards,0022100553,2022-01-03T00:00:00Z,WAS vs. CHA,124,3,1610612766,CHA,Charlotte Hornets,CHA @ WAS,121,-3,Regular Season
22021,1610612755,PHI,Philadelphia 76ers,0022100552,2022-01-03T00:00:00Z,PHI vs. HOU,133,20,1610612745,HOU,Houston Rockets,HOU @ PHI,113,-20,Regular Season
22021,1610612751,BKN,Brooklyn Nets,0022100554,2022-01-03T00:00:00Z,BKN vs. MEM,104,-14,1610612763,MEM,Memphis Grizzlies,MEM @ BKN,118,14,Regular Season
22021,1610612749,MIL,Milwaukee Bucks,0022100556,2022-01-03T00:00:00Z,MIL vs. DET,106,-9,1610612765,DET,Detroit Pistons,DET @ MIL,115,9,Regular Season
22021,1610612741,CHI,Chicago Bulls,0022100555,2022-01-03T00:00:00Z,CHI vs. ORL,102,4,1610612753,ORL,Orlando Magic,ORL @ CHI,98,-4,Regular Season
22021,1610612740,NOP,New Orleans Pelicans,0022100557,2022-01-03T00:00:00Z,NOP vs. UTA,104,-11,1610612762,UTA,Utah Jazz,UTA @ NOP,115,11,Regular Season
22021,1610612742,DAL,Dallas Mavericks,0022100558,2022-01-03T00:00:00Z,DAL vs. DEN,103,14,1610612743,DEN,Denver Nuggets,DEN @ DAL,89,-14,Regular Season
22021,1610612757,POR,Portland Trail Blazers,0022100560,2022-01-03T00:00:00Z,POR vs. ATL,136,5,1610612737,ATL,Atlanta Hawks,ATL @ POR,131,-5,Regular Season
22021,1610612746,LAC,LA Clippers,0022100561,2022-01-03T00:00:00Z,LAC vs. MIN,104,-18,1610612750,MIN,Minnesota Timberwolves,MIN @ LAC,122,18,Regular Season
22021,1610612744,GSW,Golden State Warriors,0022100559,2022-01-03T00:00:00Z,GSW vs. MIA,115,7,1610612748,MIA,Miami Heat,MIA @ GSW,108,-7,Regular Season
22021,1610612740,NOP,New Orleans Pelicans,0022100565,2022-01-04T00:00:00Z,NOP vs. PHX,110,-13,1610612756,PHX,Phoenix Suns,PHX @ NOP,123,13,Regular Season
22021,1610612761,TOR,Toronto Raptors,0022100563,2022-01-04T00:00:00Z,TOR vs. SAS,129,25,1610612759,SAS,San Antonio Spurs,SAS @ TOR,104,-25,Regular Season
22021,1610612739,CLE,Cleveland Cavaliers,0022100562,2022-01-04T00:00:00Z,CLE vs. MEM,106,-4,1610612763,MEM,Memphis Grizzlies,MEM @ CLE,110,4,Regular Season
22021,1610612747,LAL,Los Angeles Lakers,0022100566,2022-01-04T00:00:00Z,LAL vs. SAC,122,8,1610612758,SAC,Sacramento Kings,SAC @ LAL,114,-8,Regular Season
22021,1610612752,NYK,New York Knicks,0022100564,2022-01-04T00:00:00Z,NYK vs. IND,104,10,1610612754,IND,Indiana Pacers,IND @ NYK,94,-10,Regular Season
22021,1610612738,BOS,Boston Celtics,0022100570,2022-01-05T00:00:00Z,BOS vs. SAS,97,-2,1610612759,SAS,San Antonio Spurs,SAS @ BOS,99,2,Regular Season
22021,1610612754,IND,Indiana Pacers,0022100571,2022-01-05T00:00:00Z,IND vs. BKN,121,-8,1610612751,BKN,Brooklyn Nets,BKN @ IND,129,8,Regular Season
22021,1610612749,MIL,Milwaukee Bucks,0022100573,2022-01-05T00:00:00Z,MIL vs. TOR,111,-6,1610612761,TOR,Toronto Raptors,TOR @ MIL,117,6,Regular Season
22021,1610612750,MIN,Minnesota Timberwolves,0022100574,2022-01-05T00:00:00Z,MIN vs. OKC,98,8,1610612760,OKC,Oklahoma City Thunder,OKC @ MIN,90,-8,Regular Season
22021,1610612743,DEN,Denver Nuggets,0022100575,2022-01-05T00:00:00Z,DEN vs. UTA,109,-6,1610612762,UTA,Utah Jazz,UTA @ DEN,115,6,Regular Season
22021,1610612742,DAL,Dallas Mavericks,0022100572,2022-01-05T00:00:00Z,DAL vs. GSW,99,17,1610612744,GSW,Golden State Warriors,GSW @ DAL,82,-17,Regular Season
22021,1610612766,CHA,Charlotte Hornets,0022100567,2022-01-05T00:00:00Z,CHA vs. DET,140,29,1610612765,DET,Detroit Pistons,DET @ CHA,111,-29,Regular Season
22021,1610612753,ORL,Orlando Magic,0022100568,2022-01-05T00:00:00Z,ORL vs. PHI,106,-10,1610612755,PHI,Philadelphia 76ers,PHI @ ORL,116,10,Regular Season
22021,1610612758,SAC,Sacramento Kings,0022100577,2022-01-05T00:00:00Z,SAC vs. ATL,102,-6,1610612737,ATL,Atlanta Hawks,ATL @ SAC,108,6,Regular Season
22021,1610612757,POR,Portland Trail Blazers,0022100576,2022-01-05T00:00:00Z,POR vs. MIA,109,-6,1610612748,MIA,Miami Heat,MIA @ POR,115,6,Regular Season
22021,1610612764,WAS,Washington Wizards,0022100569,2022-01-05T00:00:00Z,WAS vs. HOU,111,-3,1610612745,HOU,Houston Rockets,HOU @ WAS,114,3,Regular Season
22021,1610612740,NOP,New Orleans Pelicans,0022100580,2022-01-06T00:00:00Z,NOP vs. GSW,101,5,1610612744,GSW,Golden State Warriors,GSW @ NOP,96,-5,Regular Season
22021,1610612752,NYK,New York Knicks,0022100578,2022-01-06T00:00:00Z,NYK vs. BOS,108,3,1610612738,BOS,Boston Celtics,BOS @ NYK,105,-3,Regular Season
22021,1610612756,PHX,Phoenix Suns,0022100581,2022-01-06T00:00:00Z,PHX vs. LAC,106,17,1610612746,LAC,LA Clippers,LAC @ PHX,89,-17,Regular Season
22021,1610612763,MEM,Memphis Grizzlies,0022100579,2022-01-06T00:00:00Z,MEM vs. DET,118,30,1610612765,DET,Detroit Pistons,DET @ MEM,88,-30,Regular Season
22021,1610612747,LAL,Los Angeles Lakers,0022100589,2022-01-07T00:00:00Z,LAL vs. ATL,134,16,1610612737,ATL,Atlanta Hawks,ATL @ LAL,118,-16,Regular Season
22021,1610612755,PHI,Philadelphia 76ers,0022100582,2022-01-07T00:00:00Z,PHI vs. SAS,119,19,1610612759,SAS,San Antonio Spurs,SAS @ PHI,100,-19,Regular Season
22021,1610612743,DEN,Denver Nuggets,0022100588,2022-01-07T00:00:00Z,DEN vs. SAC,121,10,1610612758,SAC,Sacramento Kings,SAC @ DEN,111,-10,Regular Season
22021,1610612745,HOU,Houston Rockets,0022100586,2022-01-07T00:00:00Z,HOU vs. DAL,106,-24,1610612742,DAL,Dallas Mavericks,DAL @ HOU,130,24,Regular Season
22021,1610612751,BKN,Brooklyn Nets,0022100583,2022-01-07T00:00:00Z,BKN vs. MIL,109,-12,1610612749,MIL,Milwaukee Bucks,MIL @ BKN,121,12,Regular Season
22021,1610612760,OKC,Oklahoma City Thunder,0022100587,2022-01-07T00:00:00Z,OKC vs. MIN,105,-30,1610612750,MIN,Minnesota Timberwolves,MIN @ OKC,135,30,Regular Season
22021,1610612741,CHI,Chicago Bulls,0022100585,2022-01-07T00:00:00Z,CHI vs. WAS,130,8,1610612764,WAS,Washington Wizards,WAS @ CHI,122,-8,Regular Season
22021,1610612757,POR,Portland Trail Blazers,0022100590,2022-01-07T00:00:00Z,POR vs. CLE,101,-13,1610612739,CLE,Cleveland Cavaliers,CLE @ POR,114,13,Regular Season
22021,1610612761,TOR,Toronto Raptors,0022100584,2022-01-07T00:00:00Z,TOR vs. UTA,122,14,1610612762,UTA,Utah Jazz,UTA @ TOR,108,-14,Regular Season
22021,1610612746,LAC,LA Clippers,0022100591,2022-01-08T00:00:00Z,LAC vs. MEM,108,-15,1610612763,MEM,Memphis Grizzlies,MEM @ LAC,123,15,Regular Season
22021,1610612756,PHX,Phoenix Suns,0022100596,2022-01-08T00:00:00Z,PHX vs. MIA,100,-23,1610612748,MIA,Miami Heat,MIA @ PHX,123,23,Regular Season
22021,1610612738,BOS,Boston Celtics,0022100595,2022-01-08T00:00:00Z,BOS vs. NYK,99,24,1610612752,NYK,New York Knicks,NYK @ BOS,75,-24,Regular Season
22021,1610612766,CHA,Charlotte Hornets,0022100592,2022-01-08T00:00:00Z,CHA vs. MIL,114,8,1610612749,MIL,Milwaukee Bucks,MIL @ CHA,106,-8,Regular Season
22021,1610612765,DET,Detroit Pistons,0022100593,2022-01-08T00:00:00Z,DET vs. ORL,97,5,1610612753,ORL,Orlando Magic,ORL @ DET,92,-5,Regular Season
22021,1610612754,IND,Indiana Pacers,0022100594,2022-01-08T00:00:00Z,IND vs. UTA,125,12,1610612762,UTA,Utah Jazz,UTA @ IND,113,-12,Regular Season
22021,1610612761,TOR,Toronto Raptors,0022100599,2022-01-09T00:00:00Z,TOR vs. NOP,105,4,1610612740,NOP,New Orleans Pelicans,NOP @ TOR,101,-4,Regular Season
22021,1610612747,LAL,Los Angeles Lakers,0022100606,2022-01-09T00:00:00Z,LAL vs. MEM,119,-8,1610612763,MEM,Memphis Grizzlies,MEM @ LAL,127,8,Regular Season
22021,1610612757,POR,Portland Trail Blazers,0022100605,2022-01-09T00:00:00Z,POR vs. SAC,103,15,1610612758,SAC,Sacramento Kings,SAC @ POR,88,-15,Regular Season
22021,1610612746,LAC,LA Clippers,0022100597,2022-01-09T00:00:00Z,LAC vs. ATL,106,13,1610612737,ATL,Atlanta Hawks,ATL @ LAC,93,-13,Regular Season
22021,1610612744,GSW,Golden State Warriors,0022100604,2022-01-09T00:00:00Z,GSW vs. CLE,96,14,1610612739,CLE,Cleveland Cavaliers,CLE @ GSW,82,-14,Regular Season
22021,1610612742,DAL,Dallas Mavericks,0022100603,2022-01-09T00:00:00Z,DAL vs. CHI,113,14,1610612741,CHI,Chicago Bulls,CHI @ DAL,99,-14,Regular Season
22021,1610612751,BKN,Brooklyn Nets,0022100602,2022-01-09T00:00:00Z,BKN vs. SAS,121,2,1610612759,SAS,San Antonio Spurs,SAS @ BKN,119,-2,Regular Season
22021,1610612753,ORL,Orlando Magic,0022100598,2022-01-09T00:00:00Z,ORL vs. WAS,100,-2,1610612764,WAS,Washington Wizards,WAS @ ORL,102,2,Regular Season
22021,1610612745,HOU,Houston Rockets,0022100600,2022-01-09T00:00:00Z,HOU vs. MIN,123,-18,1610612750,MIN,Minnesota Timberwolves,MIN @ HOU,141,18,Regular Season
22021,1610612760,OKC,Oklahoma City Thunder,0022100601,2022-01-09T00:00:00Z,OKC vs. DEN,95,-4,1610612743,DEN,Denver Nuggets,DEN @ OKC,99,4,Regular Season
22021,1610612738,BOS,Boston Celtics,0022100609,2022-01-10T00:00:00Z,BOS vs. IND,101,3,1610612754,IND,Indiana Pacers,IND @ BOS,98,-3,Regular Season
22021,1610612758,SAC,Sacramento Kings,0022100611,2022-01-10T00:00:00Z,SAC vs. CLE,108,-1,1610612739,CLE,Cleveland Cavaliers,CLE @ SAC,109,1,Regular Season
22021,1610612757,POR,Portland Trail Blazers,0022100486,2022-01-10T00:00:00Z,POR vs. BKN,114,6,1610612751,BKN,Brooklyn Nets,BKN @ POR,108,-6,Regular Season
22021,1610612766,CHA,Charlotte Hornets,0022100607,2022-01-10T00:00:00Z,CHA vs. MIL,103,4,1610612749,MIL,Milwaukee Bucks,MIL @ CHA,99,-4,Regular Season
22021,1610612752,NYK,New York Knicks,0022100610,2022-01-10T00:00:00Z,NYK vs. SAS,111,15,1610612759,SAS,San Antonio Spurs,SAS @ NYK,96,-15,Regular Season
22021,1610612745,HOU,Houston Rockets,0022100711,2022-01-10T00:00:00Z,HOU vs. PHI,91,-20,1610612755,PHI,Philadelphia 76ers,PHI @ HOU,111,20,Regular Season
22021,1610612765,DET,Detroit Pistons,0022100608,2022-01-10T00:00:00Z,DET vs. UTA,126,10,1610612762,UTA,Utah Jazz,UTA @ DET,116,-10,Regular Season
22021,1610612761,TOR,Toronto Raptors,0022100613,2022-01-11T00:00:00Z,TOR vs. PHX,95,-4,1610612756,PHX,Phoenix Suns,PHX @ TOR,99,4,Regular Season
22021,1610612763,MEM,Memphis Grizzlies,0022100614,2022-01-11T00:00:00Z,MEM vs. GSW,116,8,1610612744,GSW,Golden State Warriors,GSW @ MEM,108,-8,Regular Season
22021,1610612741,CHI,Chicago Bulls,0022100415,2022-01-11T00:00:00Z,CHI vs. DET,133,46,1610612765,DET,Detroit Pistons,DET @ CHI,87,-46,Regular Season
22021,1610612764,WAS,Washington Wizards,0022100612,2022-01-11T00:00:00Z,WAS vs. OKC,122,4,1610612760,OKC,Oklahoma City Thunder,OKC @ WAS,118,-4,Regular Season
22021,1610612746,LAC,LA Clippers,0022100616,2022-01-11T00:00:00Z,LAC vs. DEN,87,2,1610612743,DEN,Denver Nuggets,DEN @ LAC,85,-2,Regular Season
22021,1610612740,NOP,New Orleans Pelicans,0022100615,2022-01-11T00:00:00Z,NOP vs. MIN,128,3,1610612750,MIN,Minnesota Timberwolves,MIN @ NOP,125,-3,Regular Season
22021,1610612758,SAC,Sacramento Kings,0022100626,2022-01-12T00:00:00Z,SAC vs. LAL,125,9,1610612747,LAL,Los Angeles Lakers,LAL @ SAC,116,-9,Regular Season
22021,1610612764,WAS,Washington Wizards,0022100620,2022-01-12T00:00:00Z,WAS vs. ORL,112,6,1610612753,ORL,Orlando Magic,ORL @ WAS,106,-6,Regular Season
22021,1610612752,NYK,New York Knicks,0022100622,2022-01-12T00:00:00Z,NYK vs. DAL,108,23,1610612742,DAL,Dallas Mavericks,DAL @ NYK,85,-23,Regular Season
22021,1610612762,UTA,Utah Jazz,0022100624,2022-01-12T00:00:00Z,UTA vs. CLE,91,-20,1610612739,CLE,Cleveland Cavaliers,CLE @ UTA,111,20,Regular Season
22021,1610612741,CHI,Chicago Bulls,0022100625,2022-01-12T00:00:00Z,CHI vs. BKN,112,-26,1610612751,BKN,Brooklyn Nets,BKN @ CHI,138,26,Regular Season
22021,1610612755,PHI,Philadelphia 76ers,0022100619,2022-01-12T00:00:00Z,PHI vs. CHA,98,-11,1610612766,CHA,Charlotte Hornets,CHA @ PHI,109,11,Regular Season
22021,1610612754,IND,Indiana Pacers,0022100618,2022-01-12T00:00:00Z,IND vs. BOS,100,-19,1610612738,BOS,Boston Celtics,BOS @ IND,119,19,Regular Season
22021,1610612737,ATL,Atlanta Hawks,0022100621,2022-01-12T00:00:00Z,ATL vs. MIA,91,-24,1610612748,MIA,Miami Heat,MIA @ ATL,115,24,Regular Season
22021,1610612759,SAS,San Antonio Spurs,0022100623,2022-01-12T00:00:00Z,SAS vs. HOU,124,-4,1610612745,HOU,Houston Rockets,HOU @ SAS,128,4,Regular Season
22021,1610612743,DEN,Denver Nuggets,0022100631,2022-01-13T00:00:00Z,DEN vs. POR,140,32,1610612757,POR,Portland Trail Blazers,POR @ DEN,108,-32,Regular Season
22021,1610612763,MEM,Memphis Grizzlies,0022100628,2022-01-13T00:00:00Z,MEM vs. MIN,116,8,1610612750,MIN,Minnesota Timberwolves,MIN @ MEM,108,-8,Regular Season
22021,1610612749,MIL,Milwaukee Bucks,0022100627,2022-01-13T00:00:00Z,MIL vs. GSW,118,19,1610612744,GSW,Golden State Warriors,GSW @ MIL,99,-19,Regular Season
22021,1610612751,BKN,Brooklyn Nets,0022100630,2022-01-13T00:00:00Z,BKN vs. OKC,109,-21,1610612760,OKC,Oklahoma City Thunder,OKC @ BKN,130,21,Regular Season
22021,1610612740,NOP,New Orleans Pelicans,0022100629,2022-01-13T00:00:00Z,NOP vs. LAC,113,24,1610612746,LAC,LA Clippers,LAC @ NOP,89,-24,Regular Season
22021,1610612765,DET,Detroit Pistons,0022100633,2022-01-14T00:00:00Z,DET vs. TOR,103,16,1610612761,TOR,Toronto Raptors,TOR @ DET,87,-16,Regular Season
22021,1610612748,MIA,Miami Heat,0022100636,2022-01-14T00:00:00Z,MIA vs. ATL,124,6,1610612737,ATL,Atlanta Hawks,ATL @ MIA,118,-6,Regular Season
22021,1610612759,SAS,San Antonio Spurs,0022100638,2022-01-14T00:00:00Z,SAS vs. CLE,109,-5,1610612739,CLE,Cleveland Cavaliers,CLE @ SAS,114,5,Regular Season
22021,1610612763,MEM,Memphis Grizzlies,0022100639,2022-01-14T00:00:00Z,MEM vs. DAL,85,-27,1610612742,DAL,Dallas Mavericks,DAL @ MEM,112,27,Regular Season
22021,1610612755,PHI,Philadelphia 76ers,0022100635,2022-01-14T00:00:00Z,PHI vs. BOS,111,12,1610612738,BOS,Boston Celtics,BOS @ PHI,99,-12,Regular Season
22021,1610612741,CHI,Chicago Bulls,0022100637,2022-01-14T00:00:00Z,CHI vs. GSW,96,-42,1610612744,GSW,Golden State Warriors,GSW @ CHI,138,42,Regular Season
22021,1610612754,IND,Indiana Pacers,0022100634,2022-01-14T00:00:00Z,IND vs. PHX,94,-18,1610612756,PHX,Phoenix Suns,PHX @ IND,112,18,Regular Season
22021,1610612758,SAC,Sacramento Kings,0022100640,2022-01-14T00:00:00Z,SAC vs. HOU,126,12,1610612745,HOU,Houston Rockets,HOU @ SAC,114,-12,Regular Season
22021,1610612766,CHA,Charlotte Hornets,0022100632,2022-01-14T00:00:00Z,CHA vs. ORL,109,-7,1610612753,ORL,Orlando Magic,ORL @ CHA,116,7,Regular Season
22021,1610612764,WAS,Washington Wizards,0022100642,2022-01-15T00:00:00Z,WAS vs. POR,110,-5,1610612757,POR,Portland Trail Blazers,POR @ WAS,115,5,Regular Season
22021,1610612749,MIL,Milwaukee Bucks,0022100641,2022-01-15T00:00:00Z,MIL vs. TOR,96,-7,1610612761,TOR,Toronto Raptors,TOR @ MIL,103,7,Regular Season
22021,1610612751,BKN,Brooklyn Nets,0022100644,2022-01-15T00:00:00Z,BKN vs. NOP,120,15,1610612740,NOP,New Orleans Pelicans,NOP @ BKN,105,-15,Regular Season
22021,1610612748,MIA,Miami Heat,0022100645,2022-01-15T00:00:00Z,MIA vs. PHI,98,-11,1610612755,PHI,Philadelphia 76ers,PHI @ MIA,109,11,Regular Season
22021,1610612737,ATL,Atlanta Hawks,0022100643,2022-01-15T00:00:00Z,ATL vs. NYK,108,-9,1610612752,NYK,New York Knicks,NYK @ ATL,117,9,Regular Season
22021,1610612760,OKC,Oklahoma City Thunder,0022100646,2022-01-15T00:00:00Z,OKC vs. CLE,102,-5,1610612739,CLE,Cleveland Cavaliers,CLE @ OKC,107,5,Regular Season
22021,1610612759,SAS,San Antonio Spurs,0022100648,2022-01-15T00:00:00Z,SAS vs. LAC,101,7,1610612746,LAC,LA Clippers,LAC @ SAS,94,-7,Regular Season
22021,1610612738,BOS,Boston Celtics,0022100647,2022-01-15T00:00:00Z,BOS vs. CHI,114,2,1610612741,CHI,Chicago Bulls,CHI @ BOS,112,-2,Regular Season
22021,1610612743,DEN,Denver Nuggets,0022100649,2022-01-15T00:00:00Z,DEN vs. LAL,133,37,1610612747,LAL,Los Angeles Lakers,LAL @ DEN,96,-37,Regular Season
22021,1610612742,DAL,Dallas Mavericks,0022100650,2022-01-15T00:00:00Z,DAL vs. ORL,108,16,1610612753,ORL,Orlando Magic,ORL @ DAL,92,-16,Regular Season
22021,1610612758,SAC,Sacramento Kings,0022100651,2022-01-16T00:00:00Z,SAC vs. HOU,112,-6,1610612745,HOU,Houston Rockets,HOU @ SAC,118,6,Regular Season
22021,1610612765,DET,Detroit Pistons,0022100617,2022-01-16T00:00:00Z,DET vs. PHX,108,-27,1610612756,PHX,Phoenix Suns,PHX @ DET,135,27,Regular Season
22021,1610612743,DEN,Denver Nuggets,0022100653,2022-01-16T00:00:00Z,DEN vs. UTA,102,-23,1610612762,UTA,Utah Jazz,UTA @ DEN,125,23,Regular Season
22021,1610612750,MIN,Minnesota Timberwolves,0022100652,2022-01-16T00:00:00Z,MIN vs. GSW,119,20,1610612744,GSW,Golden State Warriors,GSW @ MIN,99,-20,Regular Season
22021,1610612742,DAL,Dallas Mavericks,0022100663,2022-01-17T00:00:00Z,DAL vs. OKC,104,2,1610612760,OKC,Oklahoma City Thunder,OKC @ DAL,102,-2,Regular Season
22021,1610612763,MEM,Memphis Grizzlies,0022100658,2022-01-17T00:00:00Z,MEM vs. CHI,119,13,1610612741,CHI,Chicago Bulls,CHI @ MEM,106,-13,Regular Season
22021,1610612739,CLE,Cleveland Cavaliers,0022100657,2022-01-17T00:00:00Z,CLE vs. BKN,114,7,1610612751,BKN,Brooklyn Nets,BKN @ CLE,107,-7,Regular Season
22021,1610612752,NYK,New York Knicks,0022100655,2022-01-17T00:00:00Z,NYK vs. CHA,87,-10,1610612766,CHA,Charlotte Hornets,CHA @ NYK,97,10,Regular Season
22021,1610612737,ATL,Atlanta Hawks,0022100660,2022-01-17T00:00:00Z,ATL vs. MIL,121,7,1610612749,MIL,Milwaukee Bucks,MIL @ ATL,114,-7,Regular Season
22021,1610612764,WAS,Washington Wizards,0022100656,2022-01-17T00:00:00Z,WAS vs. PHI,117,19,1610612755,PHI,Philadelphia 76ers,PHI @ WAS,98,-19,Regular Season
22021,1610612746,LAC,LA Clippers,0022100659,2022-01-17T00:00:00Z,LAC vs. IND,139,6,1610612754,IND,Indiana Pacers,IND @ LAC,133,-6,Regular Season
22021,1610612747,LAL,Los Angeles Lakers,0022100665,2022-01-17T00:00:00Z,LAL vs. UTA,101,6,1610612762,UTA,Utah Jazz,UTA @ LAL,95,-6,Regular Season
22021,1610612738,BOS,Boston Celtics,0022100654,2022-01-17T00:00:00Z,BOS vs. NOP,104,12,1610612740,NOP,New Orleans Pelicans,NOP @ BOS,92,-12,Regular Season
22021,1610612759,SAS,San Antonio Spurs,0022100664,2022-01-17T00:00:00Z,SAS vs. PHX,107,-14,1610612756,PHX,Phoenix Suns,PHX @ SAS,121,14,Regular Season
22021,1610612753,ORL,Orlando Magic,0022100661,2022-01-17T00:00:00Z,ORL vs. POR,88,-10,1610612757,POR,Portland Trail Blazers,POR @ ORL,98,10,Regular Season
22021,1610612748,MIA,Miami Heat,0022100662,2022-01-17T00:00:00Z,MIA vs. TOR,104,5,1610612761,TOR,Toronto Raptors,TOR @ MIA,99,-5,Regular Season
22021,1610612752,NYK,New York Knicks,0022100666,2022-01-18T00:00:00Z,NYK vs. MIN,110,-2,1610612750,MIN,Minnesota Timberwolves,MIN @ NYK,112,2,Regular Season
22021,1610612744,GSW,Golden State Warriors,0022100667,2022-01-18T00:00:00Z,GSW vs. DET,102,16,1610612765,DET,Detroit Pistons,DET @ GSW,86,-16,Regular Season
22021,1610612748,MIA,Miami Heat,0022100672,2022-01-19T00:00:00Z,MIA vs. POR,104,12,1610612757,POR,Portland Trail Blazers,POR @ MIA,92,-12,Regular Season
22021,1610612747,LAL,Los Angeles Lakers,0022100680,2022-01-19T00:00:00Z,LAL vs. IND,104,-7,1610612754,IND,Indiana Pacers,IND @ LAL,111,7,Regular Season
22021,1610612743,DEN,Denver Nuggets,0022100678,2022-01-19T00:00:00Z,DEN vs. LAC,130,2,1610612746,LAC,LA Clippers,LAC @ DEN,128,-2,Regular Season
22021,1610612764,WAS,Washington Wizards,0022100669,2022-01-19T00:00:00Z,WAS vs. BKN,118,-1,1610612751,BKN,Brooklyn Nets,BKN @ WAS,119,1,Regular Season
22021,1610612755,PHI,Philadelphia 76ers,0022100668,2022-01-19T00:00:00Z,PHI vs. ORL,123,13,1610612753,ORL,Orlando Magic,ORL @ PHI,110,-13,Regular Season
22021,1610612758,SAC,Sacramento Kings,0022100679,2022-01-19T00:00:00Z,SAC vs. DET,131,-2,1610612765,DET,Detroit Pistons,DET @ SAC,133,2,Regular Season
22021,1610612762,UTA,Utah Jazz,0022100677,2022-01-19T00:00:00Z,UTA vs. HOU,111,-5,1610612745,HOU,Houston Rockets,HOU @ UTA,116,5,Regular Season
22021,1610612742,DAL,Dallas Mavericks,0022100675,2022-01-19T00:00:00Z,DAL vs. TOR,102,4,1610612761,TOR,Toronto Raptors,TOR @ DAL,98,-4,Regular Season
22021,1610612759,SAS,San Antonio Spurs,0022100676,2022-01-19T00:00:00Z,SAS vs. OKC,118,22,1610612760,OKC,Oklahoma City Thunder,OKC @ SAS,96,-22,Regular Season
22021,1610612749,MIL,Milwaukee Bucks,0022100674,2022-01-19T00:00:00Z,MIL vs. MEM,126,12,1610612763,MEM,Memphis Grizzlies,MEM @ MIL,114,-12,Regular Season
22021,1610612738,BOS,Boston Celtics,0022100671,2022-01-19T00:00:00Z,BOS vs. CHA,102,-9,1610612766,CHA,Charlotte Hornets,CHA @ BOS,111,9,Regular Season
22021,1610612741,CHI,Chicago Bulls,0022100673,2022-01-19T00:00:00Z,CHI vs. CLE,117,13,1610612739,CLE,Cleveland Cavaliers,CLE @ CHI,104,-13,Regular Season
22021,1610612737,ATL,Atlanta Hawks,0022100670,2022-01-19T00:00:00Z,ATL vs. MIN,134,12,1610612750,MIN,Minnesota Timberwolves,MIN @ ATL,122,-12,Regular Season
22021,1610612752,NYK,New York Knicks,0022100681,2022-01-20T00:00:00Z,NYK vs. NOP,91,-11,1610612740,NOP,New Orleans Pelicans,NOP @ NYK,102,11,Regular Season
22021,1610612742,DAL,Dallas Mavericks,0022100682,2022-01-20T00:00:00Z,DAL vs. PHX,101,-8,1610612756,PHX,Phoenix Suns,PHX @ DAL,109,8,Regular Season
22021,1610612744,GSW,Golden State Warriors,0022100683,2022-01-20T00:00:00Z,GSW vs. IND,117,-4,1610612754,IND,Indiana Pacers,IND @ GSW,121,4,Regular Season
22021,1610612762,UTA,Utah Jazz,0022100693,2022-01-21T00:00:00Z,UTA vs. DET,111,10,1610612765,DET,Detroit Pistons,DET @ UTA,101,-10,Regular Season
22021,1610612764,WAS,Washington Wizards,0022100689,2022-01-21T00:00:00Z,WAS vs. TOR,105,-4,1610612761,TOR,Toronto Raptors,TOR @ WAS,109,4,Regular Season
22021,1610612755,PHI,Philadelphia 76ers,0022100686,2022-01-21T00:00:00Z,PHI vs. LAC,101,-1,1610612746,LAC,LA Clippers,LAC @ PHI,102,1,Regular Season
22021,1610612753,ORL,Orlando Magic,0022100685,2022-01-21T00:00:00Z,ORL vs. LAL,105,-11,1610612747,LAL,Los Angeles Lakers,LAL @ ORL,116,11,Regular Season
22021,1610612737,ATL,Atlanta Hawks,0022100687,2022-01-21T00:00:00Z,ATL vs. MIA,110,2,1610612748,MIA,Miami Heat,MIA @ ATL,108,-2,Regular Season
22021,1610612738,BOS,Boston Celtics,0022100688,2022-01-21T00:00:00Z,BOS vs. POR,105,-4,1610612757,POR,Portland Trail Blazers,POR @ BOS,109,4,Regular Season
22021,1610612766,CHA,Charlotte Hornets,0022100684,2022-01-21T00:00:00Z,CHA vs. OKC,121,23,1610612760,OKC,Oklahoma City Thunder,OKC @ CHA,98,-23,Regular Season
22021,1610612759,SAS,San Antonio Spurs,0022100691,2022-01-21T00:00:00Z,SAS vs. BKN,102,-15,1610612751,BKN,Brooklyn Nets,BKN @ SAS,117,15,Regular Season
22021,1610612749,MIL,Milwaukee Bucks,0022100690,2022-01-21T00:00:00Z,MIL vs. CHI,94,4,1610612741,CHI,Chicago Bulls,CHI @ MIL,90,-4,Regular Season
22021,1610612743,DEN,Denver Nuggets,0022100692,2022-01-21T00:00:00Z,DEN vs. MEM,118,-4,1610612763,MEM,Memphis Grizzlies,MEM @ DEN,122,4,Regular Season
22021,1610612744,GSW,Golden State Warriors,0022100694,2022-01-21T00:00:00Z,GSW vs. HOU,105,2,1610612745,HOU,Houston Rockets,HOU @ GSW,103,-2,Regular Season
22021,1610612739,CLE,Cleveland Cavaliers,0022100695,2022-01-22T00:00:00Z,CLE vs. OKC,94,7,1610612760,OKC,Oklahoma City Thunder,OKC @ CLE,87,-7,Regular Season
22021,1610612756,PHX,Phoenix Suns,0022100697,2022-01-22T00:00:00Z,PHX vs. IND,113,10,1610612754,IND,Indiana Pacers,IND @ PHX,103,-10,Regular Season
22021,1610612749,MIL,Milwaukee Bucks,0022100696,2022-01-22T00:00:00Z,MIL vs. SAC,133,6,1610612758,SAC,Sacramento Kings,SAC @ MIL,127,-6,Regular Season
22021,1610612759,SAS,San Antonio Spurs,0022100704,2022-01-23T00:00:00Z,SAS vs. PHI,109,-6,1610612755,PHI,Philadelphia 76ers,PHI @ SAS,115,6,Regular Season
22021,1610612766,CHA,Charlotte Hornets,0022100703,2022-01-23T00:00:00Z,CHA vs. ATL,91,-22,1610612737,ATL,Atlanta Hawks,ATL @ CHA,113,22,Regular Season
22021,1610612753,ORL,Orlando Magic,0022100701,2022-01-23T00:00:00Z,ORL vs. CHI,114,19,1610612741,CHI,Chicago Bulls,CHI @ ORL,95,-19,Regular Season
22021,1610612748,MIA,Miami Heat,0022100700,2022-01-23T00:00:00Z,MIA vs. LAL,113,6,1610612747,LAL,Los Angeles Lakers,LAL @ MIA,107,-6,Regular Season
22021,1610612744,GSW,Golden State Warriors,0022100708,2022-01-23T00:00:00Z,GSW vs. UTA,94,2,1610612762,UTA,Utah Jazz,UTA @ GSW,92,-2,Regular Season
22021,1610612764,WAS,Washington Wizards,0022100699,2022-01-23T00:00:00Z,WAS vs. BOS,87,-29,1610612738,BOS,Boston Celtics,BOS @ WAS,116,29,Regular Season
22021,1610612761,TOR,Toronto Raptors,0022100702,2022-01-23T00:00:00Z,TOR vs. POR,105,-9,1610612757,POR,Portland Trail Blazers,POR @ TOR,114,9,Regular Season
22021,1610612743,DEN,Denver Nuggets,0022100707,2022-01-23T00:00:00Z,DEN vs. DET,117,6,1610612765,DET,Detroit Pistons,DET @ DEN,111,-6,Regular Season
22021,1610612752,NYK,New York Knicks,0022100698,2022-01-23T00:00:00Z,NYK vs. LAC,110,8,1610612746,LAC,LA Clippers,LAC @ NYK,102,-8,Regular Season
22021,1610612742,DAL,Dallas Mavericks,0022100705,2022-01-23T00:00:00Z,DAL vs. MEM,104,13,1610612763,MEM,Memphis Grizzlies,MEM @ DAL,91,-13,Regular Season
22021,1610612750,MIN,Minnesota Timberwolves,0022100706,2022-01-23T00:00:00Z,MIN vs. BKN,136,11,1610612751,BKN,Brooklyn Nets,BKN @ MIN,125,-11,Regular Season
22021,1610612740,NOP,New Orleans Pelicans,0022100712,2022-01-24T00:00:00Z,NOP vs. IND,117,4,1610612754,IND,Indiana Pacers,IND @ NOP,113,-4,Regular Season
22021,1610612756,PHX,Phoenix Suns,0022100713,2022-01-24T00:00:00Z,PHX vs. UTA,115,6,1610612762,UTA,Utah Jazz,UTA @ PHX,109,-6,Regular Season
22021,1610612760,OKC,Oklahoma City Thunder,0022100730,2022-01-24T00:00:00Z,OKC vs. CHI,110,-1,1610612741,CHI,Chicago Bulls,CHI @ OKC,111,1,Regular Season
22021,1610612739,CLE,Cleveland Cavaliers,0022100709,2022-01-24T00:00:00Z,CLE vs. NYK,95,2,1610612752,NYK,New York Knicks,NYK @ CLE,93,-2,Regular Season
22021,1610612751,BKN,Brooklyn Nets,0022100718,2022-01-25T00:00:00Z,BKN vs. LAL,96,-10,1610612747,LAL,Los Angeles Lakers,LAL @ BKN,106,10,Regular Season
22021,1610612757,POR,Portland Trail Blazers,0022100721,2022-01-25T00:00:00Z,POR vs. MIN,107,-2,1610612750,MIN,Minnesota Timberwolves,MIN @ POR,109,2,Regular Season
22021,1610612744,GSW,Golden State Warriors,0022100720,2022-01-25T00:00:00Z,GSW vs. DAL,130,38,1610612742,DAL,Dallas Mavericks,DAL @ GSW,92,-38,Regular Season
22021,1610612745,HOU,Houston Rockets,0022100719,2022-01-25T00:00:00Z,HOU vs. SAS,104,-30,1610612759,SAS,San Antonio Spurs,SAS @ HOU,134,30,Regular Season
22021,1610612755,PHI,Philadelphia 76ers,0022100454,2022-01-25T00:00:00Z,PHI vs. NOP,117,10,1610612740,NOP,New Orleans Pelicans,NOP @ PHI,107,-10,Regular Season
22021,1610612764,WAS,Washington Wizards,0022100716,2022-01-25T00:00:00Z,WAS vs. LAC,115,-1,1610612746,LAC,LA Clippers,LAC @ WAS,116,1,Regular Season
22021,1610612738,BOS,Boston Celtics,0022100717,2022-01-25T00:00:00Z,BOS vs. SAC,128,53,1610612758,SAC,Sacramento Kings,SAC @ BOS,75,-53,Regular Season
22021,1610612765,DET,Detroit Pistons,0022100714,2022-01-25T00:00:00Z,DET vs. DEN,105,-5,1610612743,DEN,Denver Nuggets,DEN @ DET,110,5,Regular Season
22021,1610612761,TOR,Toronto Raptors,0022100715,2022-01-25T00:00:00Z,TOR vs. CHA,125,12,1610612766,CHA,Charlotte Hornets,CHA @ TOR,113,-12,Regular Season
22021,1610612762,UTA,Utah Jazz,0022100731,2022-01-26T00:00:00Z,UTA vs. PHX,97,-8,1610612756,PHX,Phoenix Suns,PHX @ UTA,105,8,Regular Season
22021,1610612737,ATL,Atlanta Hawks,0022100725,2022-01-26T00:00:00Z,ATL vs. SAC,121,17,1610612758,SAC,Sacramento Kings,SAC @ ATL,104,-17,Regular Season
22021,1610612757,POR,Portland Trail Blazers,0022100732,2022-01-26T00:00:00Z,POR vs. DAL,112,-20,1610612742,DAL,Dallas Mavericks,DAL @ POR,132,20,Regular Season
22021,1610612759,SAS,San Antonio Spurs,0022100728,2022-01-26T00:00:00Z,SAS vs. MEM,110,-8,1610612763,MEM,Memphis Grizzlies,MEM @ SAS,118,8,Regular Season
22021,1610612751,BKN,Brooklyn Nets,0022100453,2022-01-26T00:00:00Z,BKN vs. DEN,118,-6,1610612743,DEN,Denver Nuggets,DEN @ BKN,124,6,Regular Season
22021,1610612741,CHI,Chicago Bulls,0022100472,2022-01-26T00:00:00Z,CHI vs. TOR,111,6,1610612761,TOR,Toronto Raptors,TOR @ CHI,105,-6,Regular Season
22021,1610612748,MIA,Miami Heat,0022100727,2022-01-26T00:00:00Z,MIA vs. NYK,110,14,1610612752,NYK,New York Knicks,NYK @ MIA,96,-14,Regular Season
22021,1610612753,ORL,Orlando Magic,0022100724,2022-01-26T00:00:00Z,ORL vs. LAC,102,-9,1610612746,LAC,LA Clippers,LAC @ ORL,111,9,Regular Season
22021,1610612754,IND,Indiana Pacers,0022100723,2022-01-26T00:00:00Z,IND vs. CHA,126,-32,1610612766,CHA,Charlotte Hornets,CHA @ IND,158,32,Regular Season
22021,1610612739,CLE,Cleveland Cavaliers,0022100722,2022-01-26T00:00:00Z,CLE vs. MIL,115,16,1610612749,MIL,Milwaukee Bucks,MIL @ CLE,99,-16,Regular Season
22021,1610612744,GSW,Golden State Warriors,0022100734,2022-01-27T00:00:00Z,GSW vs. MIN,124,9,1610612750,MIN,Minnesota Timberwolves,MIN @ GSW,115,-9,Regular Season
22021,1610612755,PHI,Philadelphia 76ers,0022100733,2022-01-27T00:00:00Z,PHI vs. LAL,105,18,1610612747,LAL,Los Angeles Lakers,LAL @ PHI,87,-18,Regular Season
22021,1610612760,OKC,Oklahoma City Thunder,0022100741,2022-01-28T00:00:00Z,OKC vs. IND,110,-3,1610612754,IND,Indiana Pacers,IND @ OKC,113,3,Regular Season
22021,1610612763,MEM,Memphis Grizzlies,0022100740,2022-01-28T00:00:00Z,MEM vs. UTA,119,10,1610612762,UTA,Utah Jazz,UTA @ MEM,109,-10,Regular Season
22021,1610612753,ORL,Orlando Magic,0022100736,2022-01-28T00:00:00Z,ORL vs. DET,119,16,1610612765,DET,Detroit Pistons,DET @ ORL,103,-16,Regular Season
22021,1610612737,ATL,Atlanta Hawks,0022100737,2022-01-28T00:00:00Z,ATL vs. BOS,108,16,1610612738,BOS,Boston Celtics,BOS @ ATL,92,-16,Regular Season
22021,1610612766,CHA,Charlotte Hornets,0022100735,2022-01-28T00:00:00Z,CHA vs. LAL,117,3,1610612747,LAL,Los Angeles Lakers,LAL @ CHA,114,-3,Regular Season
22021,1610612745,HOU,Houston Rockets,0022100739,2022-01-28T00:00:00Z,HOU vs. POR,110,-15,1610612757,POR,Portland Trail Blazers,POR @ HOU,125,15,Regular Season
22021,1610612740,NOP,New Orleans Pelicans,0022100729,2022-01-28T00:00:00Z,NOP vs. DEN,105,-11,1610612743,DEN,Denver Nuggets,DEN @ NOP,116,11,Regular Season
22021,1610612748,MIA,Miami Heat,0022100738,2022-01-28T00:00:00Z,MIA vs. LAC,121,7,1610612746,LAC,LA Clippers,LAC @ MIA,114,-7,Regular Season
22021,1610612759,SAS,San Antonio Spurs,0022100742,2022-01-28T00:00:00Z,SAS vs. CHI,131,9,1610612741,CHI,Chicago Bulls,CHI @ SAS,122,-9,Regular Season
22021,1610612756,PHX,Phoenix Suns,0022100743,2022-01-28T00:00:00Z,PHX vs. MIN,134,10,1610612750,MIN,Minnesota Timberwolves,MIN @ PHX,124,-10,Regular Season
22021,1610612749,MIL,Milwaukee Bucks,0022100744,2022-01-28T00:00:00Z,MIL vs. NYK,123,15,1610612752,NYK,New York Knicks,NYK @ MIL,108,-15,Regular Season
22021,1610612755,PHI,Philadelphia 76ers,0022100747,2022-01-29T00:00:00Z,PHI vs. SAC,103,2,1610612758,SAC,Sacramento Kings,SAC @ PHI,101,-2,Regular Season
22021,1610612763,MEM,Memphis Grizzlies,0022100749,2022-01-29T00:00:00Z,MEM vs. WAS,115,20,1610612764,WAS,Washington Wizards,WAS @ MEM,95,-20,Regular Season
22021,1610612742,DAL,Dallas Mavericks,0022100746,2022-01-29T00:00:00Z,DAL vs. IND,132,27,1610612754,IND,Indiana Pacers,IND @ DAL,105,-27,Regular Season
22021,1610612748,MIA,Miami Heat,0022100748,2022-01-29T00:00:00Z,MIA vs. TOR,120,-4,1610612761,TOR,Toronto Raptors,TOR @ MIA,124,4,Regular Season
22021,1610612740,NOP,New Orleans Pelicans,0022100745,2022-01-29T00:00:00Z,NOP vs. BOS,97,-10,1610612738,BOS,Boston Celtics,BOS @ NOP,107,10,Regular Season
22021,1610612744,GSW,Golden State Warriors,0022100750,2022-01-29T00:00:00Z,GSW vs. BKN,110,4,1610612751,BKN,Brooklyn Nets,BKN @ GSW,106,-4,Regular Season
22021,1610612741,CHI,Chicago Bulls,0022100753,2022-01-30T00:00:00Z,CHI vs. POR,130,14,1610612757,POR,Portland Trail Blazers,POR @ CHI,116,-14,Regular Season
22021,1610612737,ATL,Atlanta Hawks,0022100751,2022-01-30T00:00:00Z,ATL vs. LAL,129,8,1610612747,LAL,Los Angeles Lakers,LAL @ ATL,121,-8,Regular Season
22021,1610612766,CHA,Charlotte Hornets,0022100752,2022-01-30T00:00:00Z,CHA vs. LAC,90,-25,1610612746,LAC,LA Clippers,LAC @ CHA,115,25,Regular Season
22021,1610612749,MIL,Milwaukee Bucks,0022100756,2022-01-30T00:00:00Z,MIL vs. DEN,100,-36,1610612743,DEN,Denver Nuggets,DEN @ MIL,136,36,Regular Season
22021,1610612753,ORL,Orlando Magic,0022100755,2022-01-30T00:00:00Z,ORL vs. DAL,110,2,1610612742,DAL,Dallas Mavericks,DAL @ ORL,108,-2,Regular Season
22021,1610612750,MIN,Minnesota Timberwolves,0022100757,2022-01-30T00:00:00Z,MIN vs. UTA,126,20,1610612762,UTA,Utah Jazz,UTA @ MIN,106,-20,Regular Season
22021,1610612765,DET,Detroit Pistons,0022100754,2022-01-30T00:00:00Z,DET vs. CLE,115,10,1610612739,CLE,Cleveland Cavaliers,CLE @ DET,105,-10,Regular Season
22021,1610612756,PHX,Phoenix Suns,0022100758,2022-01-30T00:00:00Z,PHX vs. SAS,115,5,1610612759,SAS,San Antonio Spurs,SAS @ PHX,110,-5,Regular Season
22021,1610612739,CLE,Cleveland Cavaliers,0022100759,2022-01-31T00:00:00Z,CLE vs. NOP,93,3,1610612740,NOP,New Orleans Pelicans,NOP @ CLE,90,-3,Regular Season
22021,1610612754,IND,Indiana Pacers,0022100760,2022-01-31T00:00:00Z,IND vs. LAC,122,6,1610612746,LAC,LA Clippers,LAC @ IND,116,-6,Regular Season
22021,1610612755,PHI,Philadelphia 76ers,0022100761,2022-01-31T00:00:00Z,PHI vs. MEM,122,3,1610612763,MEM,Memphis Grizzlies,MEM @ PHI,119,-3,Regular Season
22021,1610612737,ATL,Atlanta Hawks,0022100767,2022-01-31T00:00:00Z,ATL vs. TOR,100,-6,1610612761,TOR,Toronto Raptors,TOR @ ATL,106,6,Regular Season
22021,1610612752,NYK,New York Knicks,0022100763,2022-01-31T00:00:00Z,NYK vs. SAC,116,20,1610612758,SAC,Sacramento Kings,SAC @ NYK,96,-20,Regular Season
22021,1610612738,BOS,Boston Celtics,0022100762,2022-01-31T00:00:00Z,BOS vs. MIA,122,30,1610612748,MIA,Miami Heat,MIA @ BOS,92,-30,Regular Season
22021,1610612760,OKC,Oklahoma City Thunder,0022100765,2022-01-31T00:00:00Z,OKC vs. POR,98,17,1610612757,POR,Portland Trail Blazers,POR @ OKC,81,-17,Regular Season
22021,1610612745,HOU,Houston Rockets,0022100764,2022-01-31T00:00:00Z,HOU vs. GSW,108,-14,1610612744,GSW,Golden State Warriors,GSW @ HOU,122,14,Regular Season
22021,1610612741,CHI,Chicago Bulls,0022100769,2022-02-01T00:00:00Z,CHI vs. ORL,126,11,1610612753,ORL,Orlando Magic,ORL @ CHI,115,-11,Regular Season
22021,1610612761,TOR,Toronto Raptors,0022100784,2022-02-01T00:00:00Z,TOR vs. MIA,110,4,1610612748,MIA,Miami Heat,MIA @ TOR,106,-4,Regular Season
22021,1610612749,MIL,Milwaukee Bucks,0022100768,2022-02-01T00:00:00Z,MIL vs. WAS,112,14,1610612764,WAS,Washington Wizards,WAS @ MIL,98,-14,Regular Season
22021,1610612765,DET,Detroit Pistons,0022100766,2022-02-01T00:00:00Z,DET vs. NOP,101,-10,1610612740,NOP,New Orleans Pelicans,NOP @ DET,111,10,Regular Season
22021,1610612759,SAS,San Antonio Spurs,0022100771,2022-02-01T00:00:00Z,SAS vs. GSW,120,-4,1610612744,GSW,Golden State Warriors,GSW @ SAS,124,4,Regular Season
22021,1610612750,MIN,Minnesota Timberwolves,0022100770,2022-02-01T00:00:00Z,MIN vs. DEN,130,15,1610612743,DEN,Denver Nuggets,DEN @ MIN,115,-15,Regular Season
22021,1610612756,PHX,Phoenix Suns,0022100772,2022-02-01T00:00:00Z,PHX vs. BKN,121,10,1610612751,BKN,Brooklyn Nets,BKN @ PHX,111,-10,Regular Season
22021,1610612755,PHI,Philadelphia 76ers,0022100774,2022-02-02T00:00:00Z,PHI vs. WAS,103,-3,1610612764,WAS,Washington Wizards,WAS @ PHI,106,3,Regular Season
22021,1610612754,IND,Indiana Pacers,0022100773,2022-02-02T00:00:00Z,IND vs. ORL,118,-1,1610612753,ORL,Orlando Magic,ORL @ IND,119,1,Regular Season
22021,1610612738,BOS,Boston Celtics,0022100775,2022-02-02T00:00:00Z,BOS vs. CHA,113,6,1610612766,CHA,Charlotte Hornets,CHA @ BOS,107,-6,Regular Season
22021,1610612752,NYK,New York Knicks,0022100776,2022-02-02T00:00:00Z,NYK vs. MEM,108,-12,1610612763,MEM,Memphis Grizzlies,MEM @ NYK,120,12,Regular Season
22021,1610612745,HOU,Houston Rockets,0022100777,2022-02-02T00:00:00Z,HOU vs. CLE,115,11,1610612739,CLE,Cleveland Cavaliers,CLE @ HOU,104,-11,Regular Season
22021,1610612742,DAL,Dallas Mavericks,0022100778,2022-02-02T00:00:00Z,DAL vs. OKC,114,-6,1610612760,OKC,Oklahoma City Thunder,OKC @ DAL,120,6,Regular Season
22021,1610612758,SAC,Sacramento Kings,0022100780,2022-02-02T00:00:00Z,SAC vs. BKN,112,11,1610612751,BKN,Brooklyn Nets,BKN @ SAC,101,-11,Regular Season
22021,1610612762,UTA,Utah Jazz,0022100779,2022-02-02T00:00:00Z,UTA vs. DEN,108,4,1610612743,DEN,Denver Nuggets,DEN @ UTA,104,-4,Regular Season
22021,1610612747,LAL,Los Angeles Lakers,0022100781,2022-02-02T00:00:00Z,LAL vs. POR,99,5,1610612757,POR,Portland Trail Blazers,POR @ LAL,94,-5,Regular Season
22021,1610612744,GSW,Golden State Warriors,0022100785,2022-02-03T00:00:00Z,GSW vs. SAC,126,12,1610612758,SAC,Sacramento Kings,SAC @ GSW,114,-12,Regular Season
22021,1610612746,LAC,LA Clippers,0022100786,2022-02-03T00:00:00Z,LAC vs. LAL,111,1,1610612747,LAL,Los Angeles Lakers,LAL @ LAC,110,-1,Regular Season
22021,1610612737,ATL,Atlanta Hawks,0022100783,2022-02-03T00:00:00Z,ATL vs. PHX,124,9,1610612756,PHX,Phoenix Suns,PHX @ ATL,115,-9,Regular Season
22021,1610612759,SAS,San Antonio Spurs,0022100521,2022-02-03T00:00:00Z,SAS vs. MIA,95,-17,1610612748,MIA,Miami Heat,MIA @ SAS,112,17,Regular Season
22021,1610612765,DET,Detroit Pistons,0022100782,2022-02-03T00:00:00Z,DET vs. MIN,117,-11,1610612750,MIN,Minnesota Timberwolves,MIN @ DET,128,11,Regular Season
22021,1610612761,TOR,Toronto Raptors,0022100430,2022-02-03T00:00:00Z,TOR vs. CHI,127,7,1610612741,CHI,Chicago Bulls,CHI @ TOR,120,-7,Regular Season
22021,1610612762,UTA,Utah Jazz,0022100793,2022-02-04T00:00:00Z,UTA vs. BKN,125,23,1610612751,BKN,Brooklyn Nets,BKN @ UTA,102,-23,Regular Season
22021,1610612766,CHA,Charlotte Hornets,0022100787,2022-02-04T00:00:00Z,CHA vs. CLE,101,-1,1610612739,CLE,Cleveland Cavaliers,CLE @ CHA,102,1,Regular Season
22021,1610612759,SAS,San Antonio Spurs,0022100792,2022-02-04T00:00:00Z,SAS vs. HOU,131,25,1610612745,HOU,Houston Rockets,HOU @ SAS,106,-25,Regular Season
22021,1610612742,DAL,Dallas Mavericks,0022100791,2022-02-04T00:00:00Z,DAL vs. PHI,107,9,1610612755,PHI,Philadelphia 76ers,PHI @ DAL,98,-9,Regular Season
22021,1610612757,POR,Portland Trail Blazers,0022100795,2022-02-04T00:00:00Z,POR vs. OKC,93,-3,1610612760,OKC,Oklahoma City Thunder,OKC @ POR,96,3,Regular Season
22021,1610612765,DET,Detroit Pistons,0022100788,2022-02-04T00:00:00Z,DET vs. BOS,93,-9,1610612738,BOS,Boston Celtics,BOS @ DET,102,9,Regular Season
22021,1610612754,IND,Indiana Pacers,0022100789,2022-02-04T00:00:00Z,IND vs. CHI,115,-7,1610612741,CHI,Chicago Bulls,CHI @ IND,122,7,Regular Season
22021,1610612743,DEN,Denver Nuggets,0022100794,2022-02-04T00:00:00Z,DEN vs. NOP,105,-8,1610612740,NOP,New Orleans Pelicans,NOP @ DEN,113,8,Regular Season
22021,1610612761,TOR,Toronto Raptors,0022100790,2022-02-04T00:00:00Z,TOR vs. ATL,125,11,1610612737,ATL,Atlanta Hawks,ATL @ TOR,114,-11,Regular Season
22021,1610612764,WAS,Washington Wizards,0022100798,2022-02-05T00:00:00Z,WAS vs. PHX,80,-15,1610612756,PHX,Phoenix Suns,PHX @ WAS,95,15,Regular Season
22021,1610612753,ORL,Orlando Magic,0022100796,2022-02-05T00:00:00Z,ORL vs. MEM,115,-20,1610612763,MEM,Memphis Grizzlies,MEM @ ORL,135,20,Regular Season
22021,1610612766,CHA,Charlotte Hornets,0022100797,2022-02-05T00:00:00Z,CHA vs. MIA,86,-18,1610612748,MIA,Miami Heat,MIA @ CHA,104,18,Regular Season
22021,1610612757,POR,Portland Trail Blazers,0022100800,2022-02-05T00:00:00Z,POR vs. MIL,108,-29,1610612749,MIL,Milwaukee Bucks,MIL @ POR,137,29,Regular Season
22021,1610612758,SAC,Sacramento Kings,0022100801,2022-02-05T00:00:00Z,SAC vs. OKC,113,10,1610612760,OKC,Oklahoma City Thunder,OKC @ SAC,103,-10,Regular Season
22021,1610612747,LAL,Los Angeles Lakers,0022100799,2022-02-05T00:00:00Z,LAL vs. NYK,122,7,1610612752,NYK,New York Knicks,NYK @ LAL,115,-7,Regular Season
22021,1610612750,MIN,Minnesota Timberwolves,0022100803,2022-02-06T00:00:00Z,MIN vs. DET,118,13,1610612765,DET,Detroit Pistons,DET @ MIN,105,-13,Regular Season
22021,1610612741,CHI,Chicago Bulls,0022100802,2022-02-06T00:00:00Z,CHI vs. PHI,108,-11,1610612755,PHI,Philadelphia 76ers,PHI @ CHI,119,11,Regular Season
22021,1610612742,DAL,Dallas Mavericks,0022100807,2022-02-06T00:00:00Z,DAL vs. ATL,103,9,1610612737,ATL,Atlanta Hawks,ATL @ DAL,94,-9,Regular Season
22021,1610612746,LAC,LA Clippers,0022100809,2022-02-06T00:00:00Z,LAC vs. MIL,113,-24,1610612749,MIL,Milwaukee Bucks,MIL @ LAC,137,24,Regular Season
22021,1610612743,DEN,Denver Nuggets,0022100804,2022-02-06T00:00:00Z,DEN vs. BKN,124,20,1610612751,BKN,Brooklyn Nets,BKN @ DEN,104,-20,Regular Season
22021,1610612739,CLE,Cleveland Cavaliers,0022100805,2022-02-06T00:00:00Z,CLE vs. IND,98,13,1610612754,IND,Indiana Pacers,IND @ CLE,85,-13,Regular Season
22021,1610612745,HOU,Houston Rockets,0022100808,2022-02-06T00:00:00Z,HOU vs. NOP,107,-13,1610612740,NOP,New Orleans Pelicans,NOP @ HOU,120,13,Regular Season
22021,1610612753,ORL,Orlando Magic,0022100806,2022-02-06T00:00:00Z,ORL vs. BOS,83,-33,1610612738,BOS,Boston Celtics,BOS @ ORL,116,33,Regular Season
22021,1610612762,UTA,Utah Jazz,0022100814,2022-02-07T00:00:00Z,UTA vs. NYK,113,9,1610612752,NYK,New York Knicks,NYK @ UTA,104,-9,Regular Season
22021,1610612741,CHI,Chicago Bulls,0022100812,2022-02-07T00:00:00Z,CHI vs. PHX,124,-3,1610612756,PHX,Phoenix Suns,PHX @ CHI,127,3,Regular Season
22021,1610612760,OKC,Oklahoma City Thunder,0022100813,2022-02-07T00:00:00Z,OKC vs. GSW,98,-12,1610612744,GSW,Golden State Warriors,GSW @ OKC,110,12,Regular Season
22021,1610612766,CHA,Charlotte Hornets,0022100810,2022-02-07T00:00:00Z,CHA vs. TOR,101,-15,1610612761,TOR,Toronto Raptors,TOR @ CHA,116,15,Regular Season
22021,1610612764,WAS,Washington Wizards,0022100811,2022-02-07T00:00:00Z,WAS vs. MIA,100,-21,1610612748,MIA,Miami Heat,MIA @ WAS,121,21,Regular Season
22021,1610612740,NOP,New Orleans Pelicans,0022100819,2022-02-08T00:00:00Z,NOP vs. HOU,110,13,1610612745,HOU,Houston Rockets,HOU @ NOP,97,-13,Regular Season
22021,1610612763,MEM,Memphis Grizzlies,0022100818,2022-02-08T00:00:00Z,MEM vs. LAC,135,26,1610612746,LAC,LA Clippers,LAC @ MEM,109,-26,Regular Season
22021,1610612737,ATL,Atlanta Hawks,0022100816,2022-02-08T00:00:00Z,ATL vs. IND,133,21,1610612754,IND,Indiana Pacers,IND @ ATL,112,-21,Regular Season
22021,1610612758,SAC,Sacramento Kings,0022100824,2022-02-08T00:00:00Z,SAC vs. MIN,114,-20,1610612750,MIN,Minnesota Timberwolves,MIN @ SAC,134,20,Regular Season
22021,1610612757,POR,Portland Trail Blazers,0022100823,2022-02-08T00:00:00Z,POR vs. ORL,95,-18,1610612753,ORL,Orlando Magic,ORL @ POR,113,18,Regular Season
22021,1610612755,PHI,Philadelphia 76ers,0022100815,2022-02-08T00:00:00Z,PHI vs. PHX,109,-5,1610612756,PHX,Phoenix Suns,PHX @ PHI,114,5,Regular Season
22021,1610612747,LAL,Los Angeles Lakers,0022100822,2022-02-08T00:00:00Z,LAL vs. MIL,116,-15,1610612749,MIL,Milwaukee Bucks,MIL @ LAL,131,15,Regular Season
22021,1610612751,BKN,Brooklyn Nets,0022100817,2022-02-08T00:00:00Z,BKN vs. BOS,91,-35,1610612738,BOS,Boston Celtics,BOS @ BKN,126,35,Regular Season
22021,1610612742,DAL,Dallas Mavericks,0022100820,2022-02-08T00:00:00Z,DAL vs. DET,116,30,1610612765,DET,Detroit Pistons,DET @ DAL,86,-30,Regular Season
22021,1610612743,DEN,Denver Nuggets,0022100821,2022-02-08T00:00:00Z,DEN vs. NYK,132,17,1610612752,NYK,New York Knicks,NYK @ DEN,115,-17,Regular Season
22021,1610612757,POR,Portland Trail Blazers,0022100829,2022-02-09T00:00:00Z,POR vs. LAL,107,2,1610612747,LAL,Los Angeles Lakers,LAL @ POR,105,-2,Regular Season
22021,1610612762,UTA,Utah Jazz,0022100828,2022-02-09T00:00:00Z,UTA vs. GSW,111,26,1610612744,GSW,Golden State Warriors,GSW @ UTA,85,-26,Regular Season
22021,1610612766,CHA,Charlotte Hornets,0022100826,2022-02-09T00:00:00Z,CHA vs. CHI,109,-12,1610612741,CHI,Chicago Bulls,CHI @ CHA,121,12,Regular Season
22021,1610612760,OKC,Oklahoma City Thunder,0022100827,2022-02-09T00:00:00Z,OKC vs. TOR,98,-19,1610612761,TOR,Toronto Raptors,TOR @ OKC,117,19,Regular Season
22021,1610612758,SAC,Sacramento Kings,0022100830,2022-02-09T00:00:00Z,SAC vs. MIN,132,13,1610612750,MIN,Minnesota Timberwolves,MIN @ SAC,119,-13,Regular Season
22021,1610612739,CLE,Cleveland Cavaliers,0022100825,2022-02-09T00:00:00Z,CLE vs. SAS,105,13,1610612759,SAS,San Antonio Spurs,SAS @ CLE,92,-13,Regular Season
22021,1610612740,NOP,New Orleans Pelicans,0022100833,2022-02-10T00:00:00Z,NOP vs. MIA,97,-15,1610612748,MIA,Miami Heat,MIA @ NOP,112,15,Regular Season
22021,1610612745,HOU,Houston Rockets,0022100834,2022-02-10T00:00:00Z,HOU vs. TOR,120,-19,1610612761,TOR,Toronto Raptors,TOR @ HOU,139,19,Regular Season
22021,1610612765,DET,Detroit Pistons,0022100831,2022-02-10T00:00:00Z,DET vs. MEM,107,-25,1610612763,MEM,Memphis Grizzlies,MEM @ DET,132,25,Regular Season
22021,1610612744,GSW,Golden State Warriors,0022100837,2022-02-10T00:00:00Z,GSW vs. NYK,114,-2,1610612752,NYK,New York Knicks,NYK @ GSW,116,2,Regular Season
22021,1610612764,WAS,Washington Wizards,0022100832,2022-02-10T00:00:00Z,WAS vs. BKN,113,1,1610612751,BKN,Brooklyn Nets,BKN @ WAS,112,-1,Regular Season
22021,1610612756,PHX,Phoenix Suns,0022100836,2022-02-10T00:00:00Z,PHX vs. MIL,131,24,1610612749,MIL,Milwaukee Bucks,MIL @ PHX,107,-24,Regular Season
22021,1610612742,DAL,Dallas Mavericks,0022100835,2022-02-10T00:00:00Z,DAL vs. LAC,112,7,1610612746,LAC,LA Clippers,LAC @ DAL,105,-7,Regular Season
22021,1610612762,UTA,Utah Jazz,0022100844,2022-02-11T00:00:00Z,UTA vs. ORL,114,15,1610612753,ORL,Orlando Magic,ORL @ UTA,99,-15,Regular Season
22021,1610612741,CHI,Chicago Bulls,0022100843,2022-02-11T00:00:00Z,CHI vs. MIN,134,12,1610612750,MIN,Minnesota Timberwolves,MIN @ CHI,122,-12,Regular Season
22021,1610612738,BOS,Boston Celtics,0022100842,2022-02-11T00:00:00Z,BOS vs. DEN,108,6,1610612743,DEN,Denver Nuggets,DEN @ BOS,102,-6,Regular Season
22021,1610612737,ATL,Atlanta Hawks,0022100841,2022-02-11T00:00:00Z,ATL vs. SAS,121,-15,1610612759,SAS,San Antonio Spurs,SAS @ ATL,136,15,Regular Season
22021,1610612765,DET,Detroit Pistons,0022100838,2022-02-11T00:00:00Z,DET vs. CHA,119,-22,1610612766,CHA,Charlotte Hornets,CHA @ DET,141,22,Regular Season
22021,1610612754,IND,Indiana Pacers,0022100839,2022-02-11T00:00:00Z,IND vs. CLE,113,-7,1610612739,CLE,Cleveland Cavaliers,CLE @ IND,120,7,Regular Season
22021,1610612755,PHI,Philadelphia 76ers,0022100840,2022-02-11T00:00:00Z,PHI vs. OKC,100,13,1610612760,OKC,Oklahoma City Thunder,OKC @ PHI,87,-13,Regular Season
22021,1610612742,DAL,Dallas Mavericks,0022100853,2022-02-12T00:00:00Z,DAL vs. LAC,97,-2,1610612746,LAC,LA Clippers,LAC @ DAL,99,2,Regular Season
22021,1610612741,CHI,Chicago Bulls,0022100852,2022-02-12T00:00:00Z,CHI vs. OKC,106,5,1610612760,OKC,Oklahoma City Thunder,OKC @ CHI,101,-5,Regular Season
22021,1610612748,MIA,Miami Heat,0022100851,2022-02-12T00:00:00Z,MIA vs. BKN,115,4,1610612751,BKN,Brooklyn Nets,BKN @ MIA,111,-4,Regular Season
22021,1610612756,PHX,Phoenix Suns,0022100855,2022-02-12T00:00:00Z,PHX vs. ORL,132,27,1610612753,ORL,Orlando Magic,ORL @ PHX,105,-27,Regular Season
22021,1610612744,GSW,Golden State Warriors,0022100854,2022-02-12T00:00:00Z,GSW vs. LAL,117,2,1610612747,LAL,Los Angeles Lakers,LAL @ GSW,115,-2,Regular Season
22021,1610612757,POR,Portland Trail Blazers,0022100845,2022-02-12T00:00:00Z,POR vs. NYK,112,9,1610612752,NYK,New York Knicks,NYK @ POR,103,-9,Regular Season
22021,1610612761,TOR,Toronto Raptors,0022100850,2022-02-12T00:00:00Z,TOR vs. DEN,109,-1,1610612743,DEN,Denver Nuggets,DEN @ TOR,110,1,Regular Season
22021,1610612755,PHI,Philadelphia 76ers,0022100849,2022-02-12T00:00:00Z,PHI vs. CLE,103,10,1610612739,CLE,Cleveland Cavaliers,CLE @ PHI,93,-10,Regular Season
22021,1610612766,CHA,Charlotte Hornets,0022100846,2022-02-12T00:00:00Z,CHA vs. MEM,118,-7,1610612763,MEM,Memphis Grizzlies,MEM @ CHA,125,7,Regular Season
22021,1610612740,NOP,New Orleans Pelicans,0022100848,2022-02-12T00:00:00Z,NOP vs. SAS,114,-10,1610612759,SAS,San Antonio Spurs,SAS @ NOP,124,10,Regular Season
22021,1610612764,WAS,Washington Wizards,0022100847,2022-02-12T00:00:00Z,WAS vs. SAC,110,-13,1610612758,SAC,Sacramento Kings,SAC @ WAS,123,13,Regular Season
22021,1610612754,IND,Indiana Pacers,0022100857,2022-02-13T00:00:00Z,IND vs. MIN,120,-9,1610612750,MIN,Minnesota Timberwolves,MIN @ IND,129,9,Regular Season
22021,1610612738,BOS,Boston Celtics,0022100856,2022-02-13T00:00:00Z,BOS vs. ATL,105,10,1610612737,ATL,Atlanta Hawks,ATL @ BOS,95,-10,Regular Season
22021,1610612743,DEN,Denver Nuggets,0022100864,2022-02-14T00:00:00Z,DEN vs. ORL,121,10,1610612753,ORL,Orlando Magic,ORL @ DEN,111,-10,Regular Season
22021,1610612741,CHI,Chicago Bulls,0022100861,2022-02-14T00:00:00Z,CHI vs. SAS,120,11,1610612759,SAS,San Antonio Spurs,SAS @ CHI,109,-11,Regular Season
22021,1610612746,LAC,LA Clippers,0022100866,2022-02-14T00:00:00Z,LAC vs. GSW,119,15,1610612744,GSW,Golden State Warriors,GSW @ LAC,104,-15,Regular Season
22021,1610612762,UTA,Utah Jazz,0022100865,2022-02-14T00:00:00Z,UTA vs. HOU,135,34,1610612745,HOU,Houston Rockets,HOU @ UTA,101,-34,Regular Season
22021,1610612740,NOP,New Orleans Pelicans,0022100863,2022-02-14T00:00:00Z,NOP vs. TOR,120,30,1610612761,TOR,Toronto Raptors,TOR @ NOP,90,-30,Regular Season
22021,1610612749,MIL,Milwaukee Bucks,0022100862,2022-02-14T00:00:00Z,MIL vs. POR,107,-15,1610612757,POR,Portland Trail Blazers,POR @ MIL,122,15,Regular Season
22021,1610612751,BKN,Brooklyn Nets,0022100859,2022-02-14T00:00:00Z,BKN vs. SAC,109,24,1610612758,SAC,Sacramento Kings,SAC @ BKN,85,-24,Regular Season
22021,1610612764,WAS,Washington Wizards,0022100858,2022-02-14T00:00:00Z,WAS vs. DET,103,9,1610612765,DET,Detroit Pistons,DET @ WAS,94,-9,Regular Season
22021,1610612752,NYK,New York Knicks,0022100860,2022-02-14T00:00:00Z,NYK vs. OKC,123,-4,1610612760,OKC,Oklahoma City Thunder,OKC @ NYK,127,4,Regular Season
22021,1610612750,MIN,Minnesota Timberwolves,0022100871,2022-02-15T00:00:00Z,MIN vs. CHA,126,6,1610612766,CHA,Charlotte Hornets,CHA @ MIN,120,-6,Regular Season
22021,1610612756,PHX,Phoenix Suns,0022100873,2022-02-15T00:00:00Z,PHX vs. LAC,103,7,1610612746,LAC,LA Clippers,LAC @ PHX,96,-7,Regular Season
22021,1610612748,MIA,Miami Heat,0022100868,2022-02-15T00:00:00Z,MIA vs. DAL,99,-8,1610612742,DAL,Dallas Mavericks,DAL @ MIA,107,8,Regular Season
22021,1610612749,MIL,Milwaukee Bucks,0022100870,2022-02-15T00:00:00Z,MIL vs. IND,128,9,1610612754,IND,Indiana Pacers,IND @ MIL,119,-9,Regular Season
22021,1610612740,NOP,New Orleans Pelicans,0022100872,2022-02-15T00:00:00Z,NOP vs. MEM,109,-12,1610612763,MEM,Memphis Grizzlies,MEM @ NOP,121,12,Regular Season
22021,1610612755,PHI,Philadelphia 76ers,0022100869,2022-02-15T00:00:00Z,PHI vs. BOS,87,-48,1610612738,BOS,Boston Celtics,BOS @ PHI,135,48,Regular Season
22021,1610612737,ATL,Atlanta Hawks,0022100867,2022-02-15T00:00:00Z,ATL vs. CLE,124,8,1610612739,CLE,Cleveland Cavaliers,CLE @ ATL,116,-8,Regular Season
22021,1610612763,MEM,Memphis Grizzlies,0022100879,2022-02-16T00:00:00Z,MEM vs. POR,119,-4,1610612757,POR,Portland Trail Blazers,POR @ MEM,123,4,Regular Season
22021,1610612752,NYK,New York Knicks,0022100877,2022-02-16T00:00:00Z,NYK vs. BKN,106,-5,1610612751,BKN,Brooklyn Nets,BKN @ NYK,111,5,Regular Season
22021,1610612747,LAL,Los Angeles Lakers,0022100884,2022-02-16T00:00:00Z,LAL vs. UTA,106,5,1610612762,UTA,Utah Jazz,UTA @ LAL,101,-5,Regular Season
22021,1610612753,ORL,Orlando Magic,0022100874,2022-02-16T00:00:00Z,ORL vs. ATL,109,-21,1610612737,ATL,Atlanta Hawks,ATL @ ORL,130,21,Regular Season
22021,1610612738,BOS,Boston Celtics,0022100875,2022-02-16T00:00:00Z,BOS vs. DET,111,-1,1610612765,DET,Detroit Pistons,DET @ BOS,112,1,Regular Season
22021,1610612754,IND,Indiana Pacers,0022100876,2022-02-16T00:00:00Z,IND vs. WAS,113,5,1610612764,WAS,Washington Wizards,WAS @ IND,108,-5,Regular Season
22021,1610612760,OKC,Oklahoma City Thunder,0022100881,2022-02-16T00:00:00Z,OKC vs. SAS,106,-8,1610612759,SAS,San Antonio Spurs,SAS @ OKC,114,8,Regular Season
22021,1610612741,CHI,Chicago Bulls,0022100878,2022-02-16T00:00:00Z,CHI vs. SAC,125,7,1610612758,SAC,Sacramento Kings,SAC @ CHI,118,-7,Regular Season
22021,1610612750,MIN,Minnesota Timberwolves,0022100880,2022-02-16T00:00:00Z,MIN vs. TOR,91,-12,1610612761,TOR,Toronto Raptors,TOR @ MIN,103,12,Regular Season
22021,1610612744,GSW,Golden State Warriors,0022100883,2022-02-16T00:00:00Z,GSW vs. DEN,116,-1,1610612743,DEN,Denver Nuggets,DEN @ GSW,117,1,Regular Season
22021,1610612756,PHX,Phoenix Suns,0022100882,2022-02-16T00:00:00Z,PHX vs. HOU,124,3,1610612745,HOU,Houston Rockets,HOU @ PHX,121,-3,Regular Season
22021,1610612740,NOP,New Orleans Pelicans,0022100886,2022-02-17T00:00:00Z,NOP vs. DAL,118,-7,1610612742,DAL,Dallas Mavericks,DAL @ NOP,125,7,Regular Season
22021,1610612766,CHA,Charlotte Hornets,0022100885,2022-02-17T00:00:00Z,CHA vs. MIA,107,-4,1610612748,MIA,Miami Heat,MIA @ CHA,111,4,Regular Season
22021,1610612749,MIL,Milwaukee Bucks,0022100887,2022-02-17T00:00:00Z,MIL vs. PHI,120,-3,1610612755,PHI,Philadelphia 76ers,PHI @ MIL,123,3,Regular Season
22021,1610612746,LAC,LA Clippers,0022100888,2022-02-17T00:00:00Z,LAC vs. HOU,142,31,1610612745,HOU,Houston Rockets,HOU @ LAC,111,-31,Regular Season
22021,1610612751,BKN,Brooklyn Nets,0022100464,2022-02-17T00:00:00Z,BKN vs. WAS,103,-14,1610612764,WAS,Washington Wizards,WAS @ BKN,117,14,Regular Season
22021,1610612758,SAC,Sacramento Kings,0022100895,2022-02-24T00:00:00Z,SAC vs. DEN,110,-18,1610612743,DEN,Denver Nuggets,DEN @ SAC,128,18,Regular Season
22021,1610612751,BKN,Brooklyn Nets,0022100890,2022-02-24T00:00:00Z,BKN vs. BOS,106,-23,1610612738,BOS,Boston Celtics,BOS @ BKN,129,23,Regular Season
22021,1610612757,POR,Portland Trail Blazers,0022100894,2022-02-24T00:00:00Z,POR vs. GSW,95,-37,1610612744,GSW,Golden State Warriors,GSW @ POR,132,37,Regular Season
22021,1610612765,DET,Detroit Pistons,0022100889,2022-02-24T00:00:00Z,DET vs. CLE,106,3,1610612739,CLE,Cleveland Cavaliers,CLE @ DET,103,-3,Regular Season
22021,1610612741,CHI,Chicago Bulls,0022100891,2022-02-24T00:00:00Z,CHI vs. ATL,112,4,1610612737,ATL,Atlanta Hawks,ATL @ CHI,108,-4,Regular Season
22021,1610612750,MIN,Minnesota Timberwolves,0022100892,2022-02-24T00:00:00Z,MIN vs. MEM,119,5,1610612763,MEM,Memphis Grizzlies,MEM @ MIN,114,-5,Regular Season
22021,1610612760,OKC,Oklahoma City Thunder,0022100893,2022-02-24T00:00:00Z,OKC vs. PHX,104,-20,1610612756,PHX,Phoenix Suns,PHX @ OKC,124,20,Regular Season
22021,1610612766,CHA,Charlotte Hornets,0022100896,2022-02-25T00:00:00Z,CHA vs. TOR,125,32,1610612761,TOR,Toronto Raptors,TOR @ CHA,93,-32,Regular Season
22021,1610612756,PHX,Phoenix Suns,0022100902,2022-02-25T00:00:00Z,PHX vs. NOP,102,-15,1610612740,NOP,New Orleans Pelicans,NOP @ PHX,117,15,Regular Season
22021,1610612747,LAL,Los Angeles Lakers,0022100904,2022-02-25T00:00:00Z,LAL vs. LAC,102,-3,1610612746,LAC,LA Clippers,LAC @ LAL,105,3,Regular Season
22021,1610612753,ORL,Orlando Magic,0022100898,2022-02-25T00:00:00Z,ORL vs. HOU,119,8,1610612745,HOU,Houston Rockets,HOU @ ORL,111,-8,Regular Season
22021,1610612764,WAS,Washington Wizards,0022100899,2022-02-25T00:00:00Z,WAS vs. SAS,153,-4,1610612759,SAS,San Antonio Spurs,SAS @ WAS,157,4,Regular Season
22021,1610612752,NYK,New York Knicks,0022100900,2022-02-25T00:00:00Z,NYK vs. MIA,100,-15,1610612748,MIA,Miami Heat,MIA @ NYK,115,15,Regular Season
22021,1610612750,MIN,Minnesota Timberwolves,0022100901,2022-02-25T00:00:00Z,MIN vs. PHI,102,-31,1610612755,PHI,Philadelphia 76ers,PHI @ MIN,133,31,Regular Season
22021,1610612754,IND,Indiana Pacers,0022100897,2022-02-25T00:00:00Z,IND vs. OKC,125,-4,1610612760,OKC,Oklahoma City Thunder,OKC @ IND,129,4,Regular Season
22021,1610612762,UTA,Utah Jazz,0022100903,2022-02-25T00:00:00Z,UTA vs. DAL,114,5,1610612742,DAL,Dallas Mavericks,DAL @ UTA,109,-5,Regular Season
22021,1610612748,MIA,Miami Heat,0022100908,2022-02-26T00:00:00Z,MIA vs. SAS,133,4,1610612759,SAS,San Antonio Spurs,SAS @ MIA,129,-4,Regular Season
22021,1610612741,CHI,Chicago Bulls,0022100909,2022-02-26T00:00:00Z,CHI vs. MEM,110,-6,1610612763,MEM,Memphis Grizzlies,MEM @ CHI,116,6,Regular Season
22021,1610612749,MIL,Milwaukee Bucks,0022100910,2022-02-26T00:00:00Z,MIL vs. BKN,123,-3,1610612751,BKN,Brooklyn Nets,BKN @ MIL,126,3,Regular Season
22021,1610612737,ATL,Atlanta Hawks,0022100906,2022-02-26T00:00:00Z,ATL vs. TOR,127,27,1610612761,TOR,Toronto Raptors,TOR @ ATL,100,-27,Regular Season
22021,1610612739,CLE,Cleveland Cavaliers,0022100907,2022-02-26T00:00:00Z,CLE vs. WAS,92,6,1610612764,WAS,Washington Wizards,WAS @ CLE,86,-6,Regular Season
22021,1610612743,DEN,Denver Nuggets,0022100911,2022-02-26T00:00:00Z,DEN vs. SAC,115,5,1610612758,SAC,Sacramento Kings,SAC @ DEN,110,-5,Regular Season
22021,1610612765,DET,Detroit Pistons,0022100905,2022-02-26T00:00:00Z,DET vs. BOS,104,-9,1610612738,BOS,Boston Celtics,BOS @ DET,113,9,Regular Season
22021,1610612744,GSW,Golden State Warriors,0022100917,2022-02-27T00:00:00Z,GSW vs. DAL,101,-6,1610612742,DAL,Dallas Mavericks,DAL @ GSW,107,6,Regular Season
22021,1610612756,PHX,Phoenix Suns,0022100913,2022-02-27T00:00:00Z,PHX vs. UTA,114,-4,1610612762,UTA,Utah Jazz,UTA @ PHX,118,4,Regular Season
22021,1610612757,POR,Portland Trail Blazers,0022100918,2022-02-27T00:00:00Z,POR vs. DEN,92,-32,1610612743,DEN,Denver Nuggets,DEN @ POR,124,32,Regular Season
22021,1610612754,IND,Indiana Pacers,0022100914,2022-02-27T00:00:00Z,IND vs. BOS,128,21,1610612738,BOS,Boston Celtics,BOS @ IND,107,-21,Regular Season
22021,1610612752,NYK,New York Knicks,0022100912,2022-02-27T00:00:00Z,NYK vs. PHI,109,-16,1610612755,PHI,Philadelphia 76ers,PHI @ NYK,125,16,Regular Season
22021,1610612747,LAL,Los Angeles Lakers,0022100919,2022-02-27T00:00:00Z,LAL vs. NOP,95,-28,1610612740,NOP,New Orleans Pelicans,NOP @ LAL,123,28,Regular Season
22021,1610612766,CHA,Charlotte Hornets,0022100915,2022-02-27T00:00:00Z,CHA vs. DET,126,-1,1610612765,DET,Detroit Pistons,DET @ CHA,127,1,Regular Season
22021,1610612745,HOU,Houston Rockets,0022100916,2022-02-27T00:00:00Z,HOU vs. LAC,98,-1,1610612746,LAC,LA Clippers,LAC @ HOU,99,1,Regular Season
22021,1610612739,CLE,Cleveland Cavaliers,0022100920,2022-02-28T00:00:00Z,CLE vs. MIN,122,-5,1610612750,MIN,Minnesota Timberwolves,MIN @ CLE,127,5,Regular Season
22021,1610612763,MEM,Memphis Grizzlies,0022100923,2022-02-28T00:00:00Z,MEM vs. SAS,118,13,1610612759,SAS,San Antonio Spurs,SAS @ MEM,105,-13,Regular Season
22021,1610612753,ORL,Orlando Magic,0022100921,2022-02-28T00:00:00Z,ORL vs. IND,119,16,1610612754,IND,Indiana Pacers,IND @ ORL,103,-16,Regular Season
22021,1610612749,MIL,Milwaukee Bucks,0022100924,2022-02-28T00:00:00Z,MIL vs. CHA,130,24,1610612766,CHA,Charlotte Hornets,CHA @ MIL,106,-24,Regular Season
22021,1610612760,OKC,Oklahoma City Thunder,0022100925,2022-02-28T00:00:00Z,OKC vs. SAC,110,-21,1610612758,SAC,Sacramento Kings,SAC @ OKC,131,21,Regular Season
22021,1610612748,MIA,Miami Heat,0022100922,2022-02-28T00:00:00Z,MIA vs. CHI,112,13,1610612741,CHI,Chicago Bulls,CHI @ MIA,99,-13,Regular Season
22021,1610612751,BKN,Brooklyn Nets,0022100726,2022-02-28T00:00:00Z,BKN vs. TOR,97,-36,1610612761,TOR,Toronto Raptors,TOR @ BKN,133,36,Regular Season
22021,1610612738,BOS,Boston Celtics,0022100927,2022-03-01T00:00:00Z,BOS vs. ATL,107,9,1610612737,ATL,Atlanta Hawks,ATL @ BOS,98,-9,Regular Season
22021,1610612761,TOR,Toronto Raptors,0022100928,2022-03-01T00:00:00Z,TOR vs. BKN,109,1,1610612751,BKN,Brooklyn Nets,BKN @ TOR,108,-1,Regular Season
22021,1610612764,WAS,Washington Wizards,0022100926,2022-03-01T00:00:00Z,WAS vs. DET,116,3,1610612765,DET,Detroit Pistons,DET @ WAS,113,-3,Regular Season
22021,1610612747,LAL,Los Angeles Lakers,0022100931,2022-03-01T00:00:00Z,LAL vs. DAL,104,-5,1610612742,DAL,Dallas Mavericks,DAL @ LAL,109,5,Regular Season
22021,1610612745,HOU,Houston Rockets,0022100929,2022-03-01T00:00:00Z,HOU vs. LAC,100,-13,1610612746,LAC,LA Clippers,LAC @ HOU,113,13,Regular Season
22021,1610612750,MIN,Minnesota Timberwolves,0022100930,2022-03-01T00:00:00Z,MIN vs. GSW,129,15,1610612744,GSW,Golden State Warriors,GSW @ MIN,114,-15,Regular Season
22021,1610612755,PHI,Philadelphia 76ers,0022100934,2022-03-02T00:00:00Z,PHI vs. NYK,123,15,1610612752,NYK,New York Knicks,NYK @ PHI,108,-15,Regular Season
22021,1610612749,MIL,Milwaukee Bucks,0022100936,2022-03-02T00:00:00Z,MIL vs. MIA,120,1,1610612748,MIA,Miami Heat,MIA @ MIL,119,-1,Regular Season
22021,1610612753,ORL,Orlando Magic,0022100933,2022-03-02T00:00:00Z,ORL vs. IND,114,-8,1610612754,IND,Indiana Pacers,IND @ ORL,122,8,Regular Season
22021,1610612745,HOU,Houston Rockets,0022100935,2022-03-02T00:00:00Z,HOU vs. UTA,127,-5,1610612762,UTA,Utah Jazz,UTA @ HOU,132,5,Regular Season
22021,1610612740,NOP,New Orleans Pelicans,0022100937,2022-03-02T00:00:00Z,NOP vs. SAC,125,30,1610612758,SAC,Sacramento Kings,SAC @ NOP,95,-30,Regular Season
22021,1610612743,DEN,Denver Nuggets,0022100938,2022-03-02T00:00:00Z,DEN vs. OKC,107,-12,1610612760,OKC,Oklahoma City Thunder,OKC @ DEN,119,12,Regular Season
22021,1610612739,CLE,Cleveland Cavaliers,0022100932,2022-03-02T00:00:00Z,CLE vs. CHA,98,-21,1610612766,CHA,Charlotte Hornets,CHA @ CLE,119,21,Regular Season
22021,1610612756,PHX,Phoenix Suns,0022100939,2022-03-02T00:00:00Z,PHX vs. POR,120,30,1610612757,POR,Portland Trail Blazers,POR @ PHX,90,-30,Regular Season
22021,1610612761,TOR,Toronto Raptors,0022100942,2022-03-03T00:00:00Z,TOR vs. DET,106,-2,1610612765,DET,Detroit Pistons,DET @ TOR,108,2,Regular Season
22021,1610612751,BKN,Brooklyn Nets,0022100941,2022-03-03T00:00:00Z,BKN vs. MIA,107,-6,1610612748,MIA,Miami Heat,MIA @ BKN,113,6,Regular Season
22021,1610612742,DAL,Dallas Mavericks,0022100943,2022-03-03T00:00:00Z,DAL vs. GSW,122,9,1610612744,GSW,Golden State Warriors,GSW @ DAL,113,-9,Regular Season
22021,1610612759,SAS,San Antonio Spurs,0022100944,2022-03-03T00:00:00Z,SAS vs. SAC,112,-3,1610612758,SAC,Sacramento Kings,SAC @ SAS,115,3,Regular Season
22021,1610612738,BOS,Boston Celtics,0022100940,2022-03-03T00:00:00Z,BOS vs. MEM,120,13,1610612763,MEM,Memphis Grizzlies,MEM @ BOS,107,-13,Regular Season
22021,1610612737,ATL,Atlanta Hawks,0022100710,2022-03-03T00:00:00Z,ATL vs. CHI,130,6,1610612741,CHI,Chicago Bulls,CHI @ ATL,124,-6,Regular Season
22021,1610612746,LAC,LA Clippers,0022100945,2022-03-03T00:00:00Z,LAC vs. LAL,132,21,1610612747,LAL,Los Angeles Lakers,LAL @ LAC,111,-21,Regular Season
22021,1610612741,CHI,Chicago Bulls,0022100949,2022-03-04T00:00:00Z,CHI vs. MIL,112,-6,1610612749,MIL,Milwaukee Bucks,MIL @ CHI,118,6,Regular Season
22021,1610612760,OKC,Oklahoma City Thunder,0022100951,2022-03-04T00:00:00Z,OKC vs. MIN,101,-37,1610612750,MIN,Minnesota Timberwolves,MIN @ OKC,138,37,Regular Season
22021,1610612743,DEN,Denver Nuggets,0022100952,2022-03-04T00:00:00Z,DEN vs. HOU,116,15,1610612745,HOU,Houston Rockets,HOU @ DEN,101,-15,Regular Season
22021,1610612761,TOR,Toronto Raptors,0022100458,2022-03-04T00:00:00Z,TOR vs. ORL,97,-6,1610612753,ORL,Orlando Magic,ORL @ TOR,103,6,Regular Season
22021,1610612765,DET,Detroit Pistons,0022100946,2022-03-04T00:00:00Z,DET vs. IND,111,5,1610612754,IND,Indiana Pacers,IND @ DET,106,-5,Regular Season
22021,1610612764,WAS,Washington Wizards,0022100948,2022-03-04T00:00:00Z,WAS vs. ATL,114,-3,1610612737,ATL,Atlanta Hawks,ATL @ WAS,117,3,Regular Season
22021,1610612755,PHI,Philadelphia 76ers,0022100947,2022-03-04T00:00:00Z,PHI vs. CLE,125,6,1610612739,CLE,Cleveland Cavaliers,CLE @ PHI,119,-6,Regular Season
22021,1610612740,NOP,New Orleans Pelicans,0022100950,2022-03-04T00:00:00Z,NOP vs. UTA,124,34,1610612762,UTA,Utah Jazz,UTA @ NOP,90,-34,Regular Season
22021,1610612756,PHX,Phoenix Suns,0022100953,2022-03-04T00:00:00Z,PHX vs. NYK,115,1,1610612752,NYK,New York Knicks,NYK @ PHX,114,-1,Regular Season
22021,1610612750,MIN,Minnesota Timberwolves,0022100958,2022-03-05T00:00:00Z,MIN vs. POR,135,14,1610612757,POR,Portland Trail Blazers,POR @ MIN,121,-14,Regular Season
22021,1610612766,CHA,Charlotte Hornets,0022100955,2022-03-05T00:00:00Z,CHA vs. SAS,123,6,1610612759,SAS,San Antonio Spurs,SAS @ CHA,117,-6,Regular Season
22021,1610612742,DAL,Dallas Mavericks,0022100954,2022-03-05T00:00:00Z,DAL vs. SAC,114,1,1610612758,SAC,Sacramento Kings,SAC @ DAL,113,-1,Regular Season
22021,1610612747,LAL,Los Angeles Lakers,0022100959,2022-03-05T00:00:00Z,LAL vs. GSW,124,8,1610612744,GSW,Golden State Warriors,GSW @ LAL,116,-8,Regular Season
22021,1610612748,MIA,Miami Heat,0022100956,2022-03-05T00:00:00Z,MIA vs. PHI,99,17,1610612755,PHI,Philadelphia 76ers,PHI @ MIA,82,-17,Regular Season
22021,1610612763,MEM,Memphis Grizzlies,0022100957,2022-03-05T00:00:00Z,MEM vs. ORL,124,28,1610612753,ORL,Orlando Magic,ORL @ MEM,96,-28,Regular Season
22021,1610612743,DEN,Denver Nuggets,0022100967,2022-03-06T00:00:00Z,DEN vs. NOP,138,8,1610612740,NOP,New Orleans Pelicans,NOP @ DEN,130,-8,Regular Season
22021,1610612746,LAC,LA Clippers,0022100966,2022-03-06T00:00:00Z,LAC vs. NYK,93,-23,1610612752,NYK,New York Knicks,NYK @ LAC,116,23,Regular Season
22021,1610612738,BOS,Boston Celtics,0022100960,2022-03-06T00:00:00Z,BOS vs. BKN,126,6,1610612751,BKN,Brooklyn Nets,BKN @ BOS,120,-6,Regular Season
22021,1610612739,CLE,Cleveland Cavaliers,0022100962,2022-03-06T00:00:00Z,CLE vs. TOR,104,8,1610612761,TOR,Toronto Raptors,TOR @ CLE,96,-8,Regular Season
22021,1610612745,HOU,Houston Rockets,0022100964,2022-03-06T00:00:00Z,HOU vs. MEM,123,11,1610612763,MEM,Memphis Grizzlies,MEM @ HOU,112,-11,Regular Season
22021,1610612749,MIL,Milwaukee Bucks,0022100961,2022-03-06T00:00:00Z,MIL vs. PHX,132,10,1610612756,PHX,Phoenix Suns,PHX @ MIL,122,-10,Regular Season
22021,1610612764,WAS,Washington Wizards,0022100963,2022-03-06T00:00:00Z,WAS vs. IND,133,10,1610612754,IND,Indiana Pacers,IND @ WAS,123,-10,Regular Season
22021,1610612760,OKC,Oklahoma City Thunder,0022100965,2022-03-06T00:00:00Z,OKC vs. UTA,103,-13,1610612762,UTA,Utah Jazz,UTA @ OKC,116,13,Regular Season
22021,1610612765,DET,Detroit Pistons,0022100968,2022-03-07T00:00:00Z,DET vs. ATL,113,3,1610612737,ATL,Atlanta Hawks,ATL @ DET,110,-3,Regular Season
22021,1610612743,DEN,Denver Nuggets,0022100528,2022-03-07T00:00:00Z,DEN vs. GSW,131,7,1610612744,GSW,Golden State Warriors,GSW @ DEN,124,-7,Regular Season
22021,1610612750,MIN,Minnesota Timberwolves,0022100971,2022-03-07T00:00:00Z,MIN vs. POR,124,43,1610612757,POR,Portland Trail Blazers,POR @ MIN,81,-43,Regular Season
22021,1610612759,SAS,San Antonio Spurs,0022100973,2022-03-07T00:00:00Z,SAS vs. LAL,117,7,1610612747,LAL,Los Angeles Lakers,LAL @ SAS,110,-7,Regular Season
22021,1610612755,PHI,Philadelphia 76ers,0022100969,2022-03-07T00:00:00Z,PHI vs. CHI,121,15,1610612741,CHI,Chicago Bulls,CHI @ PHI,106,-15,Regular Season
22021,1610612748,MIA,Miami Heat,0022100970,2022-03-07T00:00:00Z,MIA vs. HOU,123,17,1610612745,HOU,Houston Rockets,HOU @ MIA,106,-17,Regular Season
22021,1610612742,DAL,Dallas Mavericks,0022100972,2022-03-07T00:00:00Z,DAL vs. UTA,111,8,1610612762,UTA,Utah Jazz,UTA @ DAL,103,-8,Regular Season
22021,1610612758,SAC,Sacramento Kings,0022100974,2022-03-07T00:00:00Z,SAC vs. NYK,115,-16,1610612752,NYK,New York Knicks,NYK @ SAC,131,16,Regular Season
22021,1610612766,CHA,Charlotte Hornets,0022100975,2022-03-08T00:00:00Z,CHA vs. BKN,121,-11,1610612751,BKN,Brooklyn Nets,BKN @ CHA,132,11,Regular Season
22021,1610612753,ORL,Orlando Magic,0022100977,2022-03-08T00:00:00Z,ORL vs. PHX,99,-3,1610612756,PHX,Phoenix Suns,PHX @ ORL,102,3,Regular Season
22021,1610612763,MEM,Memphis Grizzlies,0022100978,2022-03-08T00:00:00Z,MEM vs. NOP,132,21,1610612740,NOP,New Orleans Pelicans,NOP @ MEM,111,-21,Regular Season
22021,1610612760,OKC,Oklahoma City Thunder,0022100979,2022-03-08T00:00:00Z,OKC vs. MIL,115,-27,1610612749,MIL,Milwaukee Bucks,MIL @ OKC,142,27,Regular Season
22021,1610612744,GSW,Golden State Warriors,0022100980,2022-03-08T00:00:00Z,GSW vs. LAC,112,15,1610612746,LAC,LA Clippers,LAC @ GSW,97,-15,Regular Season
22021,1610612754,IND,Indiana Pacers,0022100976,2022-03-08T00:00:00Z,IND vs. CLE,124,-3,1610612739,CLE,Cleveland Cavaliers,CLE @ IND,127,3,Regular Season
22021,1610612746,LAC,LA Clippers,0022100992,2022-03-09T00:00:00Z,LAC vs. WAS,115,6,1610612764,WAS,Washington Wizards,WAS @ LAC,109,-6,Regular Season
22021,1610612740,NOP,New Orleans Pelicans,0022100987,2022-03-09T00:00:00Z,NOP vs. ORL,102,-6,1610612753,ORL,Orlando Magic,ORL @ NOP,108,6,Regular Season
22021,1610612750,MIN,Minnesota Timberwolves,0022100986,2022-03-09T00:00:00Z,MIN vs. OKC,132,30,1610612760,OKC,Oklahoma City Thunder,OKC @ MIN,102,-30,Regular Season
22021,1610612749,MIL,Milwaukee Bucks,0022100984,2022-03-09T00:00:00Z,MIL vs. ATL,124,9,1610612737,ATL,Atlanta Hawks,ATL @ MIL,115,-9,Regular Season
22021,1610612759,SAS,San Antonio Spurs,0022100989,2022-03-09T00:00:00Z,SAS vs. TOR,104,-15,1610612761,TOR,Toronto Raptors,TOR @ SAS,119,15,Regular Season
22021,1610612748,MIA,Miami Heat,0022100983,2022-03-09T00:00:00Z,MIA vs. PHX,90,-21,1610612756,PHX,Phoenix Suns,PHX @ MIA,111,21,Regular Season
22021,1610612745,HOU,Houston Rockets,0022100985,2022-03-09T00:00:00Z,HOU vs. LAL,139,9,1610612747,LAL,Los Angeles Lakers,LAL @ HOU,130,-9,Regular Season
22021,1610612742,DAL,Dallas Mavericks,0022100988,2022-03-09T00:00:00Z,DAL vs. NYK,77,-30,1610612752,NYK,New York Knicks,NYK @ DAL,107,30,Regular Season
22021,1610612762,UTA,Utah Jazz,0022100990,2022-03-09T00:00:00Z,UTA vs. POR,123,38,1610612757,POR,Portland Trail Blazers,POR @ UTA,85,-38,Regular Season
22021,1610612758,SAC,Sacramento Kings,0022100991,2022-03-09T00:00:00Z,SAC vs. DEN,100,-6,1610612743,DEN,Denver Nuggets,DEN @ SAC,106,6,Regular Season
22021,1610612766,CHA,Charlotte Hornets,0022100981,2022-03-09T00:00:00Z,CHA vs. BOS,101,-14,1610612738,BOS,Boston Celtics,BOS @ CHA,115,14,Regular Season
22021,1610612765,DET,Detroit Pistons,0022100982,2022-03-09T00:00:00Z,DET vs. CHI,108,-6,1610612741,CHI,Chicago Bulls,CHI @ DET,114,6,Regular Season
22021,1610612743,DEN,Denver Nuggets,0022100994,2022-03-10T00:00:00Z,DEN vs. GSW,102,-11,1610612744,GSW,Golden State Warriors,GSW @ DEN,113,11,Regular Season
22021,1610612755,PHI,Philadelphia 76ers,0022100993,2022-03-10T00:00:00Z,PHI vs. BKN,100,-29,1610612751,BKN,Brooklyn Nets,BKN @ PHI,129,29,Regular Season
22021,1610612763,MEM,Memphis Grizzlies,0022101000,2022-03-11T00:00:00Z,MEM vs. NYK,118,4,1610612752,NYK,New York Knicks,NYK @ MEM,114,-4,Regular Season
22021,1610612738,BOS,Boston Celtics,0022100997,2022-03-11T00:00:00Z,BOS vs. DET,114,11,1610612765,DET,Detroit Pistons,DET @ BOS,103,-11,Regular Season
22021,1610612756,PHX,Phoenix Suns,0022101003,2022-03-11T00:00:00Z,PHX vs. TOR,112,-5,1610612761,TOR,Toronto Raptors,TOR @ PHX,117,5,Regular Season
22021,1610612745,HOU,Houston Rockets,0022100999,2022-03-11T00:00:00Z,HOU vs. DAL,100,-13,1610612742,DAL,Dallas Mavericks,DAL @ HOU,113,13,Regular Season
22021,1610612740,NOP,New Orleans Pelicans,0022101001,2022-03-11T00:00:00Z,NOP vs. CHA,120,-22,1610612766,CHA,Charlotte Hornets,CHA @ NOP,142,22,Regular Season
22021,1610612748,MIA,Miami Heat,0022100998,2022-03-11T00:00:00Z,MIA vs. CLE,117,12,1610612739,CLE,Cleveland Cavaliers,CLE @ MIA,105,-12,Regular Season
22021,1610612753,ORL,Orlando Magic,0022100995,2022-03-11T00:00:00Z,ORL vs. MIN,118,8,1610612750,MIN,Minnesota Timberwolves,MIN @ ORL,110,-8,Regular Season
22021,1610612759,SAS,San Antonio Spurs,0022101002,2022-03-11T00:00:00Z,SAS vs. UTA,104,2,1610612762,UTA,Utah Jazz,UTA @ SAS,102,-2,Regular Season
22021,1610612747,LAL,Los Angeles Lakers,0022101004,2022-03-11T00:00:00Z,LAL vs. WAS,122,13,1610612764,WAS,Washington Wizards,WAS @ LAL,109,-13,Regular Season
22021,1610612737,ATL,Atlanta Hawks,0022100996,2022-03-11T00:00:00Z,ATL vs. LAC,112,6,1610612746,LAC,LA Clippers,LAC @ ATL,106,-6,Regular Season
22021,1610612741,CHI,Chicago Bulls,0022101006,2022-03-12T00:00:00Z,CHI vs. CLE,101,10,1610612739,CLE,Cleveland Cavaliers,CLE @ CHI,91,-10,Regular Season
22021,1610612762,UTA,Utah Jazz,0022101010,2022-03-12T00:00:00Z,UTA vs. SAC,134,9,1610612758,SAC,Sacramento Kings,SAC @ UTA,125,-9,Regular Season
22021,1610612743,DEN,Denver Nuggets,0022101009,2022-03-12T00:00:00Z,DEN vs. TOR,115,-12,1610612761,TOR,Toronto Raptors,TOR @ DEN,127,12,Regular Season
22021,1610612757,POR,Portland Trail Blazers,0022101011,2022-03-12T00:00:00Z,POR vs. WAS,127,9,1610612764,WAS,Washington Wizards,WAS @ POR,118,-9,Regular Season
22021,1610612744,GSW,Golden State Warriors,0022101008,2022-03-12T00:00:00Z,GSW vs. MIL,122,13,1610612749,MIL,Milwaukee Bucks,MIL @ GSW,109,-13,Regular Season
22021,1610612748,MIA,Miami Heat,0022101005,2022-03-12T00:00:00Z,MIA vs. MIN,104,-9,1610612750,MIN,Minnesota Timberwolves,MIN @ MIA,113,9,Regular Season
22021,1610612759,SAS,San Antonio Spurs,0022101007,2022-03-12T00:00:00Z,SAS vs. IND,108,-11,1610612754,IND,Indiana Pacers,IND @ SAS,119,11,Regular Season
22021,1610612751,BKN,Brooklyn Nets,0022101012,2022-03-13T00:00:00Z,BKN vs. NYK,110,3,1610612752,NYK,New York Knicks,NYK @ BKN,107,-3,Regular Season
22021,1610612765,DET,Detroit Pistons,0022101013,2022-03-13T00:00:00Z,DET vs. LAC,102,-4,1610612746,LAC,LA Clippers,LAC @ DET,106,4,Regular Season
22021,1610612737,ATL,Atlanta Hawks,0022101016,2022-03-13T00:00:00Z,ATL vs. IND,131,3,1610612754,IND,Indiana Pacers,IND @ ATL,128,-3,Regular Season
22021,1610612760,OKC,Oklahoma City Thunder,0022101018,2022-03-13T00:00:00Z,OKC vs. MEM,118,-7,1610612763,MEM,Memphis Grizzlies,MEM @ OKC,125,7,Regular Season
22021,1610612756,PHX,Phoenix Suns,0022101019,2022-03-13T00:00:00Z,PHX vs. LAL,140,29,1610612747,LAL,Los Angeles Lakers,LAL @ PHX,111,-29,Regular Season
22021,1610612753,ORL,Orlando Magic,0022101015,2022-03-13T00:00:00Z,ORL vs. PHI,114,-2,1610612755,PHI,Philadelphia 76ers,PHI @ ORL,116,2,Regular Season
22021,1610612738,BOS,Boston Celtics,0022101014,2022-03-13T00:00:00Z,BOS vs. DAL,92,-3,1610612742,DAL,Dallas Mavericks,DAL @ BOS,95,3,Regular Season
22021,1610612740,NOP,New Orleans Pelicans,0022101017,2022-03-13T00:00:00Z,NOP vs. HOU,130,25,1610612745,HOU,Houston Rockets,HOU @ NOP,105,-25,Regular Season
22021,1610612737,ATL,Atlanta Hawks,0022101021,2022-03-14T00:00:00Z,ATL vs. POR,122,9,1610612757,POR,Portland Trail Blazers,POR @ ATL,113,-9,Regular Season
22021,1610612755,PHI,Philadelphia 76ers,0022101022,2022-03-14T00:00:00Z,PHI vs. DEN,110,-4,1610612743,DEN,Denver Nuggets,DEN @ PHI,114,4,Regular Season
22021,1610612747,LAL,Los Angeles Lakers,0022101028,2022-03-14T00:00:00Z,LAL vs. TOR,103,-11,1610612761,TOR,Toronto Raptors,TOR @ LAL,114,11,Regular Season
22021,1610612760,OKC,Oklahoma City Thunder,0022101023,2022-03-14T00:00:00Z,OKC vs. CHA,116,-18,1610612766,CHA,Charlotte Hornets,CHA @ OKC,134,18,Regular Season
22021,1610612759,SAS,San Antonio Spurs,0022101024,2022-03-14T00:00:00Z,SAS vs. MIN,139,-10,1610612750,MIN,Minnesota Timberwolves,MIN @ SAS,149,10,Regular Season
22021,1610612762,UTA,Utah Jazz,0022101027,2022-03-14T00:00:00Z,UTA vs. MIL,111,-6,1610612749,MIL,Milwaukee Bucks,MIL @ UTA,117,6,Regular Season
22021,1610612758,SAC,Sacramento Kings,0022101026,2022-03-14T00:00:00Z,SAC vs. CHI,112,9,1610612741,CHI,Chicago Bulls,CHI @ SAC,103,-9,Regular Season
22021,1610612739,CLE,Cleveland Cavaliers,0022101020,2022-03-14T00:00:00Z,CLE vs. LAC,120,9,1610612746,LAC,LA Clippers,LAC @ CLE,111,-9,Regular Season
22021,1610612744,GSW,Golden State Warriors,0022101025,2022-03-14T00:00:00Z,GSW vs. WAS,126,14,1610612764,WAS,Washington Wizards,WAS @ GSW,112,-14,Regular Season
22021,1610612754,IND,Indiana Pacers,0022101029,2022-03-15T00:00:00Z,IND vs. MEM,102,-33,1610612763,MEM,Memphis Grizzlies,MEM @ IND,135,33,Regular Season
22021,1610612748,MIA,Miami Heat,0022101031,2022-03-15T00:00:00Z,MIA vs. DET,105,7,1610612765,DET,Detroit Pistons,DET @ MIA,98,-7,Regular Season
22021,1610612753,ORL,Orlando Magic,0022101030,2022-03-15T00:00:00Z,ORL vs. BKN,108,-42,1610612751,BKN,Brooklyn Nets,BKN @ ORL,150,42,Regular Season
22021,1610612740,NOP,New Orleans Pelicans,0022101032,2022-03-15T00:00:00Z,NOP vs. PHX,115,-16,1610612756,PHX,Phoenix Suns,PHX @ NOP,131,16,Regular Season
22021,1610612739,CLE,Cleveland Cavaliers,0022101034,2022-03-16T00:00:00Z,CLE vs. PHI,114,-4,1610612755,PHI,Philadelphia 76ers,PHI @ CLE,118,4,Regular Season
22021,1610612750,MIN,Minnesota Timberwolves,0022101039,2022-03-16T00:00:00Z,MIN vs. LAL,124,20,1610612747,LAL,Los Angeles Lakers,LAL @ MIN,104,-20,Regular Season
22021,1610612764,WAS,Washington Wizards,0022101035,2022-03-16T00:00:00Z,WAS vs. DEN,109,-18,1610612743,DEN,Denver Nuggets,DEN @ WAS,127,18,Regular Season
22021,1610612752,NYK,New York Knicks,0022101037,2022-03-16T00:00:00Z,NYK vs. POR,128,30,1610612757,POR,Portland Trail Blazers,POR @ NYK,98,-30,Regular Season
22021,1610612758,SAC,Sacramento Kings,0022101043,2022-03-16T00:00:00Z,SAC vs. MIL,126,-9,1610612749,MIL,Milwaukee Bucks,MIL @ SAC,135,9,Regular Season
22021,1610612751,BKN,Brooklyn Nets,0022101036,2022-03-16T00:00:00Z,BKN vs. DAL,111,-2,1610612742,DAL,Dallas Mavericks,DAL @ BKN,113,2,Regular Season
22021,1610612745,HOU,Houston Rockets,0022101038,2022-03-16T00:00:00Z,HOU vs. PHX,112,-17,1610612756,PHX,Phoenix Suns,PHX @ HOU,129,17,Regular Season
22021,1610612759,SAS,San Antonio Spurs,0022101040,2022-03-16T00:00:00Z,SAS vs. OKC,122,2,1610612760,OKC,Oklahoma City Thunder,OKC @ SAS,120,-2,Regular Season
22021,1610612746,LAC,LA Clippers,0022101044,2022-03-16T00:00:00Z,LAC vs. TOR,100,-3,1610612761,TOR,Toronto Raptors,TOR @ LAC,103,3,Regular Season
22021,1610612762,UTA,Utah Jazz,0022101041,2022-03-16T00:00:00Z,UTA vs. CHI,125,15,1610612741,CHI,Chicago Bulls,CHI @ UTA,110,-15,Regular Season
22021,1610612766,CHA,Charlotte Hornets,0022101033,2022-03-16T00:00:00Z,CHA vs. ATL,116,10,1610612737,ATL,Atlanta Hawks,ATL @ CHA,106,-10,Regular Season
22021,1610612744,GSW,Golden State Warriors,0022101042,2022-03-16T00:00:00Z,GSW vs. BOS,88,-22,1610612738,BOS,Boston Celtics,BOS @ GSW,110,22,Regular Season
22021,1610612753,ORL,Orlando Magic,0022101045,2022-03-17T00:00:00Z,ORL vs. DET,120,-14,1610612765,DET,Detroit Pistons,DET @ ORL,134,14,Regular Season
22021,1610612737,ATL,Atlanta Hawks,0022101047,2022-03-18T00:00:00Z,ATL vs. MEM,120,15,1610612763,MEM,Memphis Grizzlies,MEM @ ATL,105,-15,Regular Season
22021,1610612752,NYK,New York Knicks,0022101050,2022-03-18T00:00:00Z,NYK vs. WAS,100,3,1610612764,WAS,Washington Wizards,WAS @ NYK,97,-3,Regular Season
22021,1610612751,BKN,Brooklyn Nets,0022101048,2022-03-18T00:00:00Z,BKN vs. POR,128,5,1610612757,POR,Portland Trail Blazers,POR @ BKN,123,-5,Regular Season
22021,1610612755,PHI,Philadelphia 76ers,0022101046,2022-03-18T00:00:00Z,PHI vs. DAL,111,10,1610612742,DAL,Dallas Mavericks,DAL @ PHI,101,-10,Regular Season
22021,1610612761,TOR,Toronto Raptors,0022101051,2022-03-18T00:00:00Z,TOR vs. LAL,123,-5,1610612747,LAL,Los Angeles Lakers,LAL @ TOR,128,5,Regular Season
22021,1610612748,MIA,Miami Heat,0022101052,2022-03-18T00:00:00Z,MIA vs. OKC,120,12,1610612760,OKC,Oklahoma City Thunder,OKC @ MIA,108,-12,Regular Season
22021,1610612759,SAS,San Antonio Spurs,0022101054,2022-03-18T00:00:00Z,SAS vs. NOP,91,-33,1610612740,NOP,New Orleans Pelicans,NOP @ SAS,124,33,Regular Season
22021,1610612762,UTA,Utah Jazz,0022101055,2022-03-18T00:00:00Z,UTA vs. LAC,121,29,1610612746,LAC,LA Clippers,LAC @ UTA,92,-29,Regular Season
22021,1610612745,HOU,Houston Rockets,0022101053,2022-03-18T00:00:00Z,HOU vs. IND,118,-3,1610612754,IND,Indiana Pacers,IND @ HOU,121,3,Regular Season
22021,1610612758,SAC,Sacramento Kings,0022101057,2022-03-18T00:00:00Z,SAC vs. BOS,97,-29,1610612738,BOS,Boston Celtics,BOS @ SAC,126,29,Regular Season
22021,1610612756,PHX,Phoenix Suns,0022101056,2022-03-18T00:00:00Z,PHX vs. CHI,129,27,1610612741,CHI,Chicago Bulls,CHI @ PHX,102,-27,Regular Season
22021,1610612739,CLE,Cleveland Cavaliers,0022101049,2022-03-18T00:00:00Z,CLE vs. DEN,119,3,1610612743,DEN,Denver Nuggets,DEN @ CLE,116,-3,Regular Season
22021,1610612766,CHA,Charlotte Hornets,0022101059,2022-03-19T00:00:00Z,CHA vs. DAL,129,21,1610612742,DAL,Dallas Mavericks,DAL @ CHA,108,-21,Regular Season
22021,1610612764,WAS,Washington Wizards,0022101061,2022-03-19T00:00:00Z,WAS vs. LAL,127,8,1610612747,LAL,Los Angeles Lakers,LAL @ WAS,119,-8,Regular Season
22021,1610612750,MIN,Minnesota Timberwolves,0022101058,2022-03-19T00:00:00Z,MIN vs. MIL,138,19,1610612749,MIL,Milwaukee Bucks,MIL @ MIN,119,-19,Regular Season
22021,1610612739,CLE,Cleveland Cavaliers,0022101060,2022-03-19T00:00:00Z,CLE vs. DET,113,4,1610612765,DET,Detroit Pistons,DET @ CLE,109,-4,Regular Season
22021,1610612737,ATL,Atlanta Hawks,0022101064,2022-03-20T00:00:00Z,ATL vs. NOP,112,-5,1610612740,NOP,New Orleans Pelicans,NOP @ ATL,117,5,Regular Season
22021,1610612758,SAC,Sacramento Kings,0022101066,2022-03-20T00:00:00Z,SAC vs. PHX,124,-3,1610612756,PHX,Phoenix Suns,PHX @ SAC,127,3,Regular Season
22021,1610612745,HOU,Houston Rockets,0022101063,2022-03-20T00:00:00Z,HOU vs. MEM,98,-24,1610612763,MEM,Memphis Grizzlies,MEM @ HOU,122,24,Regular Season
22021,1610612752,NYK,New York Knicks,0022101067,2022-03-20T00:00:00Z,NYK vs. UTA,93,-15,1610612762,UTA,Utah Jazz,UTA @ NYK,108,15,Regular Season
22021,1610612744,GSW,Golden State Warriors,0022101070,2022-03-20T00:00:00Z,GSW vs. SAS,108,-2,1610612759,SAS,San Antonio Spurs,SAS @ GSW,110,2,Regular Season
22021,1610612753,ORL,Orlando Magic,0022101065,2022-03-20T00:00:00Z,ORL vs. OKC,90,5,1610612760,OKC,Oklahoma City Thunder,OKC @ ORL,85,-5,Regular Season
22021,1610612755,PHI,Philadelphia 76ers,0022101069,2022-03-20T00:00:00Z,PHI vs. TOR,88,-5,1610612761,TOR,Toronto Raptors,TOR @ PHI,93,5,Regular Season
22021,1610612743,DEN,Denver Nuggets,0022101068,2022-03-20T00:00:00Z,DEN vs. BOS,104,-20,1610612738,BOS,Boston Celtics,BOS @ DEN,124,20,Regular Season
22021,1610612754,IND,Indiana Pacers,0022101062,2022-03-20T00:00:00Z,IND vs. POR,129,31,1610612757,POR,Portland Trail Blazers,POR @ IND,98,-31,Regular Season
22021,1610612741,CHI,Chicago Bulls,0022101076,2022-03-21T00:00:00Z,CHI vs. TOR,113,14,1610612761,TOR,Toronto Raptors,TOR @ CHI,99,-14,Regular Season
22021,1610612739,CLE,Cleveland Cavaliers,0022101072,2022-03-21T00:00:00Z,CLE vs. LAL,120,-11,1610612747,LAL,Los Angeles Lakers,LAL @ CLE,131,11,Regular Season
22021,1610612765,DET,Detroit Pistons,0022101073,2022-03-21T00:00:00Z,DET vs. POR,115,-4,1610612757,POR,Portland Trail Blazers,POR @ DET,119,4,Regular Season
22021,1610612755,PHI,Philadelphia 76ers,0022101074,2022-03-21T00:00:00Z,PHI vs. MIA,113,7,1610612748,MIA,Miami Heat,MIA @ PHI,106,-7,Regular Season
22021,1610612760,OKC,Oklahoma City Thunder,0022101078,2022-03-21T00:00:00Z,OKC vs. BOS,123,-9,1610612738,BOS,Boston Celtics,BOS @ OKC,132,9,Regular Season
22021,1610612751,BKN,Brooklyn Nets,0022101075,2022-03-21T00:00:00Z,BKN vs. UTA,114,8,1610612762,UTA,Utah Jazz,UTA @ BKN,106,-8,Regular Season
22021,1610612745,HOU,Houston Rockets,0022101077,2022-03-21T00:00:00Z,HOU vs. WAS,115,18,1610612764,WAS,Washington Wizards,WAS @ HOU,97,-18,Regular Season
22021,1610612766,CHA,Charlotte Hornets,0022101071,2022-03-21T00:00:00Z,CHA vs. NOP,106,3,1610612740,NOP,New Orleans Pelicans,NOP @ CHA,103,-3,Regular Season
22021,1610612742,DAL,Dallas Mavericks,0022101079,2022-03-21T00:00:00Z,DAL vs. MIN,110,2,1610612750,MIN,Minnesota Timberwolves,MIN @ DAL,108,-2,Regular Season
22021,1610612749,MIL,Milwaukee Bucks,0022101082,2022-03-22T00:00:00Z,MIL vs. CHI,126,28,1610612741,CHI,Chicago Bulls,CHI @ MIL,98,-28,Regular Season
22021,1610612752,NYK,New York Knicks,0022101081,2022-03-22T00:00:00Z,NYK vs. ATL,111,-6,1610612737,ATL,Atlanta Hawks,ATL @ NYK,117,6,Regular Season
22021,1610612743,DEN,Denver Nuggets,0022101083,2022-03-22T00:00:00Z,DEN vs. LAC,127,12,1610612746,LAC,LA Clippers,LAC @ DEN,115,-12,Regular Season
22021,1610612753,ORL,Orlando Magic,0022101080,2022-03-22T00:00:00Z,ORL vs. GSW,94,4,1610612744,GSW,Golden State Warriors,GSW @ ORL,90,-4,Regular Season
22021,1610612750,MIN,Minnesota Timberwolves,0022101090,2022-03-23T00:00:00Z,MIN vs. PHX,116,-9,1610612756,PHX,Phoenix Suns,PHX @ MIN,125,9,Regular Season
22021,1610612742,DAL,Dallas Mavericks,0022101092,2022-03-23T00:00:00Z,DAL vs. HOU,110,19,1610612745,HOU,Houston Rockets,HOU @ DAL,91,-19,Regular Season
22021,1610612760,OKC,Oklahoma City Thunder,0022101091,2022-03-23T00:00:00Z,OKC vs. ORL,118,16,1610612753,ORL,Orlando Magic,ORL @ OKC,102,-16,Regular Season
22021,1610612748,MIA,Miami Heat,0022101088,2022-03-23T00:00:00Z,MIA vs. GSW,104,-14,1610612744,GSW,Golden State Warriors,GSW @ MIA,118,14,Regular Season
22021,1610612763,MEM,Memphis Grizzlies,0022101089,2022-03-23T00:00:00Z,MEM vs. BKN,132,12,1610612751,BKN,Brooklyn Nets,BKN @ MEM,120,-12,Regular Season
22021,1610612738,BOS,Boston Celtics,0022101087,2022-03-23T00:00:00Z,BOS vs. UTA,125,28,1610612762,UTA,Utah Jazz,UTA @ BOS,97,-28,Regular Season
22021,1610612757,POR,Portland Trail Blazers,0022101094,2022-03-23T00:00:00Z,POR vs. SAS,96,-37,1610612759,SAS,San Antonio Spurs,SAS @ POR,133,37,Regular Season
22021,1610612765,DET,Detroit Pistons,0022101085,2022-03-23T00:00:00Z,DET vs. ATL,122,21,1610612737,ATL,Atlanta Hawks,ATL @ DET,101,-21,Regular Season
22021,1610612754,IND,Indiana Pacers,0022101086,2022-03-23T00:00:00Z,IND vs. SAC,109,-1,1610612758,SAC,Sacramento Kings,SAC @ IND,110,1,Regular Season
22021,1610612766,CHA,Charlotte Hornets,0022101084,2022-03-23T00:00:00Z,CHA vs. NYK,106,-15,1610612752,NYK,New York Knicks,NYK @ CHA,121,15,Regular Season
22021,1610612747,LAL,Los Angeles Lakers,0022101093,2022-03-23T00:00:00Z,LAL vs. PHI,121,-5,1610612755,PHI,Philadelphia 76ers,PHI @ LAL,126,5,Regular Season
22021,1610612749,MIL,Milwaukee Bucks,0022101097,2022-03-24T00:00:00Z,MIL vs. WAS,114,12,1610612764,WAS,Washington Wizards,WAS @ MIL,102,-12,Regular Season
22021,1610612740,NOP,New Orleans Pelicans,0022101098,2022-03-24T00:00:00Z,NOP vs. CHI,126,17,1610612741,CHI,Chicago Bulls,CHI @ NOP,109,-17,Regular Season
22021,1610612743,DEN,Denver Nuggets,0022101099,2022-03-24T00:00:00Z,DEN vs. PHX,130,-10,1610612756,PHX,Phoenix Suns,PHX @ DEN,140,10,Regular Season
22021,1610612763,MEM,Memphis Grizzlies,0022101096,2022-03-24T00:00:00Z,MEM vs. IND,133,30,1610612754,IND,Indiana Pacers,IND @ MEM,103,-30,Regular Season
22021,1610612761,TOR,Toronto Raptors,0022101095,2022-03-24T00:00:00Z,TOR vs. CLE,117,13,1610612739,CLE,Cleveland Cavaliers,CLE @ TOR,104,-13,Regular Season
22021,1610612757,POR,Portland Trail Blazers,0022101105,2022-03-25T00:00:00Z,POR vs. HOU,106,-19,1610612745,HOU,Houston Rockets,HOU @ POR,125,19,Regular Season
22021,1610612748,MIA,Miami Heat,0022101103,2022-03-25T00:00:00Z,MIA vs. NYK,103,-8,1610612752,NYK,New York Knicks,NYK @ MIA,111,8,Regular Season
22021,1610612750,MIN,Minnesota Timberwolves,0022101104,2022-03-25T00:00:00Z,MIN vs. DAL,116,21,1610612742,DAL,Dallas Mavericks,DAL @ MIN,95,-21,Regular Season
22021,1610612737,ATL,Atlanta Hawks,0022101102,2022-03-25T00:00:00Z,ATL vs. GSW,121,11,1610612744,GSW,Golden State Warriors,GSW @ ATL,110,-11,Regular Season
22021,1610612766,CHA,Charlotte Hornets,0022101100,2022-03-25T00:00:00Z,CHA vs. UTA,107,6,1610612762,UTA,Utah Jazz,UTA @ CHA,101,-6,Regular Season
22021,1610612746,LAC,LA Clippers,0022101106,2022-03-25T00:00:00Z,LAC vs. PHI,97,-25,1610612755,PHI,Philadelphia 76ers,PHI @ LAC,122,25,Regular Season
22021,1610612765,DET,Detroit Pistons,0022101101,2022-03-25T00:00:00Z,DET vs. WAS,97,-3,1610612764,WAS,Washington Wizards,WAS @ DET,100,3,Regular Season
22021,1610612763,MEM,Memphis Grizzlies,0022101112,2022-03-26T00:00:00Z,MEM vs. MIL,127,25,1610612749,MIL,Milwaukee Bucks,MIL @ MEM,102,-25,Regular Season
22021,1610612748,MIA,Miami Heat,0022101111,2022-03-26T00:00:00Z,MIA vs. BKN,95,-15,1610612751,BKN,Brooklyn Nets,BKN @ MIA,110,15,Regular Season
22021,1610612761,TOR,Toronto Raptors,0022101109,2022-03-26T00:00:00Z,TOR vs. IND,131,40,1610612754,IND,Indiana Pacers,IND @ TOR,91,-40,Regular Season
22021,1610612740,NOP,New Orleans Pelicans,0022101107,2022-03-26T00:00:00Z,NOP vs. SAS,103,-4,1610612759,SAS,San Antonio Spurs,SAS @ NOP,107,4,Regular Season
22021,1610612739,CLE,Cleveland Cavaliers,0022101110,2022-03-26T00:00:00Z,CLE vs. CHI,94,-4,1610612741,CHI,Chicago Bulls,CHI @ CLE,98,4,Regular Season
22021,1610612753,ORL,Orlando Magic,0022101108,2022-03-26T00:00:00Z,ORL vs. SAC,110,-4,1610612758,SAC,Sacramento Kings,SAC @ ORL,114,4,Regular Season
22021,1610612743,DEN,Denver Nuggets,0022101113,2022-03-26T00:00:00Z,DEN vs. OKC,113,6,1610612760,OKC,Oklahoma City Thunder,OKC @ DEN,107,-6,Regular Season
22021,1610612757,POR,Portland Trail Blazers,0022101114,2022-03-26T00:00:00Z,POR vs. HOU,98,-17,1610612745,HOU,Houston Rockets,HOU @ POR,115,17,Regular Season
22021,1610612764,WAS,Washington Wizards,0022101117,2022-03-27T00:00:00Z,WAS vs. GSW,123,8,1610612744,GSW,Golden State Warriors,GSW @ WAS,115,-8,Regular Season
22021,1610612738,BOS,Boston Celtics,0022101116,2022-03-27T00:00:00Z,BOS vs. MIN,134,22,1610612750,MIN,Minnesota Timberwolves,MIN @ BOS,112,-22,Regular Season
22021,1610612740,NOP,New Orleans Pelicans,0022101119,2022-03-27T00:00:00Z,NOP vs. LAL,116,8,1610612747,LAL,Los Angeles Lakers,LAL @ NOP,108,-8,Regular Season
22021,1610612765,DET,Detroit Pistons,0022101115,2022-03-27T00:00:00Z,DET vs. NYK,102,-2,1610612752,NYK,New York Knicks,NYK @ DET,104,2,Regular Season
22021,1610612751,BKN,Brooklyn Nets,0022101120,2022-03-27T00:00:00Z,BKN vs. CHA,110,-9,1610612766,CHA,Charlotte Hornets,CHA @ BKN,119,9,Regular Season
22021,1610612756,PHX,Phoenix Suns,0022101118,2022-03-27T00:00:00Z,PHX vs. PHI,114,10,1610612755,PHI,Philadelphia 76ers,PHI @ PHX,104,-10,Regular Season
22021,1610612742,DAL,Dallas Mavericks,0022101121,2022-03-27T00:00:00Z,DAL vs. UTA,114,14,1610612762,UTA,Utah Jazz,UTA @ DAL,100,-14,Regular Season
22021,1610612745,HOU,Houston Rockets,0022101128,2022-03-28T00:00:00Z,HOU vs. SAS,120,-3,1610612759,SAS,San Antonio Spurs,SAS @ HOU,123,3,Regular Season
22021,1610612761,TOR,Toronto Raptors,0022101127,2022-03-28T00:00:00Z,TOR vs. BOS,115,3,1610612738,BOS,Boston Celtics,BOS @ TOR,112,-3,Regular Season
22021,1610612766,CHA,Charlotte Hornets,0022101122,2022-03-28T00:00:00Z,CHA vs. DEN,109,-4,1610612743,DEN,Denver Nuggets,DEN @ CHA,113,4,Regular Season
22021,1610612739,CLE,Cleveland Cavaliers,0022101123,2022-03-28T00:00:00Z,CLE vs. ORL,107,6,1610612753,ORL,Orlando Magic,ORL @ CLE,101,-6,Regular Season
22021,1610612748,MIA,Miami Heat,0022101125,2022-03-28T00:00:00Z,MIA vs. SAC,123,23,1610612758,SAC,Sacramento Kings,SAC @ MIA,100,-23,Regular Season
22021,1610612752,NYK,New York Knicks,0022101126,2022-03-28T00:00:00Z,NYK vs. CHI,109,5,1610612741,CHI,Chicago Bulls,CHI @ NYK,104,-5,Regular Season
22021,1610612763,MEM,Memphis Grizzlies,0022101129,2022-03-28T00:00:00Z,MEM vs. GSW,123,28,1610612744,GSW,Golden State Warriors,GSW @ MEM,95,-28,Regular Season
22021,1610612754,IND,Indiana Pacers,0022101124,2022-03-28T00:00:00Z,IND vs. ATL,123,-9,1610612737,ATL,Atlanta Hawks,ATL @ IND,132,9,Regular Season
22021,1610612757,POR,Portland Trail Blazers,0022101130,2022-03-28T00:00:00Z,POR vs. OKC,131,-3,1610612760,OKC,Oklahoma City Thunder,OKC @ POR,134,3,Regular Season
22021,1610612751,BKN,Brooklyn Nets,0022101133,2022-03-29T00:00:00Z,BKN vs. DET,130,7,1610612765,DET,Detroit Pistons,DET @ BKN,123,-7,Regular Season
22021,1610612755,PHI,Philadelphia 76ers,0022101131,2022-03-29T00:00:00Z,PHI vs. MIL,116,-2,1610612749,MIL,Milwaukee Bucks,MIL @ PHI,118,2,Regular Season
22021,1610612764,WAS,Washington Wizards,0022101132,2022-03-29T00:00:00Z,WAS vs. CHI,94,-13,1610612741,CHI,Chicago Bulls,CHI @ WAS,107,13,Regular Season
22021,1610612742,DAL,Dallas Mavericks,0022101134,2022-03-29T00:00:00Z,DAL vs. LAL,128,18,1610612747,LAL,Los Angeles Lakers,LAL @ DAL,110,-18,Regular Season
22021,1610612746,LAC,LA Clippers,0022101135,2022-03-29T00:00:00Z,LAC vs. UTA,121,6,1610612762,UTA,Utah Jazz,UTA @ LAC,115,-6,Regular Season
22021,1610612754,IND,Indiana Pacers,0022101137,2022-03-30T00:00:00Z,IND vs. DEN,118,-7,1610612743,DEN,Denver Nuggets,DEN @ IND,125,7,Regular Season
22021,1610612739,CLE,Cleveland Cavaliers,0022101136,2022-03-30T00:00:00Z,CLE vs. DAL,112,-8,1610612742,DAL,Dallas Mavericks,DAL @ CLE,120,8,Regular Season
22021,1610612745,HOU,Houston Rockets,0022101142,2022-03-30T00:00:00Z,HOU vs. SAC,118,-3,1610612758,SAC,Sacramento Kings,SAC @ HOU,121,3,Regular Season
22021,1610612759,SAS,San Antonio Spurs,0022101144,2022-03-30T00:00:00Z,SAS vs. MEM,111,-1,1610612763,MEM,Memphis Grizzlies,MEM @ SAS,112,1,Regular Season
22021,1610612757,POR,Portland Trail Blazers,0022101146,2022-03-30T00:00:00Z,POR vs. NOP,107,-10,1610612740,NOP,New Orleans Pelicans,NOP @ POR,117,10,Regular Season
22021,1610612744,GSW,Golden State Warriors,0022101145,2022-03-30T00:00:00Z,GSW vs. PHX,103,-4,1610612756,PHX,Phoenix Suns,PHX @ GSW,107,4,Regular Season
22021,1610612760,OKC,Oklahoma City Thunder,0022101143,2022-03-30T00:00:00Z,OKC vs. ATL,118,-18,1610612737,ATL,Atlanta Hawks,ATL @ OKC,136,18,Regular Season
22021,1610612752,NYK,New York Knicks,0022101140,2022-03-30T00:00:00Z,NYK vs. CHA,114,-11,1610612766,CHA,Charlotte Hornets,CHA @ NYK,125,11,Regular Season
22021,1610612738,BOS,Boston Celtics,0022101139,2022-03-30T00:00:00Z,BOS vs. MIA,98,-8,1610612748,MIA,Miami Heat,MIA @ BOS,106,8,Regular Season
22021,1610612761,TOR,Toronto Raptors,0022101141,2022-03-30T00:00:00Z,TOR vs. MIN,125,23,1610612750,MIN,Minnesota Timberwolves,MIN @ TOR,102,-23,Regular Season
22021,1610612764,WAS,Washington Wizards,0022101138,2022-03-30T00:00:00Z,WAS vs. ORL,127,17,1610612753,ORL,Orlando Magic,ORL @ WAS,110,-17,Regular Season
22021,1610612765,DET,Detroit Pistons,0022101147,2022-03-31T00:00:00Z,DET vs. PHI,102,8,1610612755,PHI,Philadelphia 76ers,PHI @ DET,94,-8,Regular Season
22021,1610612751,BKN,Brooklyn Nets,0022101148,2022-03-31T00:00:00Z,BKN vs. MIL,119,-1,1610612749,MIL,Milwaukee Bucks,MIL @ BKN,120,1,Regular Season
22021,1610612741,CHI,Chicago Bulls,0022101149,2022-03-31T00:00:00Z,CHI vs. LAC,135,5,1610612746,LAC,LA Clippers,LAC @ CHI,130,-5,Regular Season
22021,1610612762,UTA,Utah Jazz,0022101150,2022-03-31T00:00:00Z,UTA vs. LAL,122,13,1610612747,LAL,Los Angeles Lakers,LAL @ UTA,109,-13,Regular Season
22021,1610612737,ATL,Atlanta Hawks,0022100452,2022-03-31T00:00:00Z,ATL vs. CLE,131,24,1610612739,CLE,Cleveland Cavaliers,CLE @ ATL,107,-24,Regular Season
22021,1610612747,LAL,Los Angeles Lakers,0022101160,2022-04-01T00:00:00Z,LAL vs. NOP,111,-3,1610612740,NOP,New Orleans Pelicans,NOP @ LAL,114,3,Regular Season
22021,1610612753,ORL,Orlando Magic,0022101151,2022-04-01T00:00:00Z,ORL vs. TOR,89,-13,1610612761,TOR,Toronto Raptors,TOR @ ORL,102,13,Regular Season
22021,1610612760,OKC,Oklahoma City Thunder,0022101157,2022-04-01T00:00:00Z,OKC vs. DET,101,-9,1610612765,DET,Detroit Pistons,DET @ OKC,110,9,Regular Season
22021,1610612743,DEN,Denver Nuggets,0022101159,2022-04-01T00:00:00Z,DEN vs. MIN,130,-6,1610612750,MIN,Minnesota Timberwolves,MIN @ DEN,136,6,Regular Season
22021,1610612759,SAS,San Antonio Spurs,0022101158,2022-04-01T00:00:00Z,SAS vs. POR,130,19,1610612757,POR,Portland Trail Blazers,POR @ SAS,111,-19,Regular Season
22021,1610612763,MEM,Memphis Grizzlies,0022101155,2022-04-01T00:00:00Z,MEM vs. PHX,122,8,1610612756,PHX,Phoenix Suns,PHX @ MEM,114,-8,Regular Season
22021,1610612745,HOU,Houston Rockets,0022101154,2022-04-01T00:00:00Z,HOU vs. SAC,117,-5,1610612758,SAC,Sacramento Kings,SAC @ HOU,122,5,Regular Season
22021,1610612749,MIL,Milwaukee Bucks,0022101156,2022-04-01T00:00:00Z,MIL vs. LAC,119,-34,1610612746,LAC,LA Clippers,LAC @ MIL,153,34,Regular Season
22021,1610612738,BOS,Boston Celtics,0022101153,2022-04-01T00:00:00Z,BOS vs. IND,128,5,1610612754,IND,Indiana Pacers,IND @ BOS,123,-5,Regular Season
22021,1610612764,WAS,Washington Wizards,0022101152,2022-04-01T00:00:00Z,WAS vs. DAL,135,32,1610612742,DAL,Dallas Mavericks,DAL @ WAS,103,-32,Regular Season
22021,1610612737,ATL,Atlanta Hawks,0022101163,2022-04-02T00:00:00Z,ATL vs. BKN,122,7,1610612751,BKN,Brooklyn Nets,BKN @ ATL,115,-7,Regular Season
22021,1610612752,NYK,New York Knicks,0022101162,2022-04-02T00:00:00Z,NYK vs. CLE,101,-18,1610612739,CLE,Cleveland Cavaliers,CLE @ NYK,119,18,Regular Season
22021,1610612741,CHI,Chicago Bulls,0022101164,2022-04-02T00:00:00Z,CHI vs. MIA,109,-18,1610612748,MIA,Miami Heat,MIA @ CHI,127,18,Regular Season
22021,1610612755,PHI,Philadelphia 76ers,0022101161,2022-04-02T00:00:00Z,PHI vs. CHA,144,30,1610612766,CHA,Charlotte Hornets,CHA @ PHI,114,-30,Regular Season
22021,1610612744,GSW,Golden State Warriors,0022101165,2022-04-02T00:00:00Z,GSW vs. UTA,111,4,1610612762,UTA,Utah Jazz,UTA @ GSW,107,-4,Regular Season
22021,1610612739,CLE,Cleveland Cavaliers,0022101170,2022-04-03T00:00:00Z,CLE vs. PHI,108,-4,1610612755,PHI,Philadelphia 76ers,PHI @ CLE,112,4,Regular Season
22021,1610612738,BOS,Boston Celtics,0022101166,2022-04-03T00:00:00Z,BOS vs. WAS,144,42,1610612764,WAS,Washington Wizards,WAS @ BOS,102,-42,Regular Season
22021,1610612749,MIL,Milwaukee Bucks,0022101167,2022-04-03T00:00:00Z,MIL vs. DAL,112,-6,1610612742,DAL,Dallas Mavericks,DAL @ MIL,118,6,Regular Season
22021,1610612760,OKC,Oklahoma City Thunder,0022101174,2022-04-03T00:00:00Z,OKC vs. PHX,117,21,1610612756,PHX,Phoenix Suns,PHX @ OKC,96,-21,Regular Season
22021,1610612745,HOU,Houston Rockets,0022101173,2022-04-03T00:00:00Z,HOU vs. MIN,132,-7,1610612750,MIN,Minnesota Timberwolves,MIN @ HOU,139,7,Regular Season
22021,1610612758,SAC,Sacramento Kings,0022101176,2022-04-03T00:00:00Z,SAC vs. GSW,90,-19,1610612744,GSW,Golden State Warriors,GSW @ SAC,109,19,Regular Season
22021,1610612747,LAL,Los Angeles Lakers,0022101168,2022-04-03T00:00:00Z,LAL vs. DEN,118,-11,1610612743,DEN,Denver Nuggets,DEN @ LAL,129,11,Regular Season
22021,1610612759,SAS,San Antonio Spurs,0022101175,2022-04-03T00:00:00Z,SAS vs. POR,113,21,1610612757,POR,Portland Trail Blazers,POR @ SAS,92,-21,Regular Season
22021,1610612754,IND,Indiana Pacers,0022101169,2022-04-03T00:00:00Z,IND vs. DET,117,-4,1610612765,DET,Detroit Pistons,DET @ IND,121,4,Regular Season
22021,1610612761,TOR,Toronto Raptors,0022101172,2022-04-03T00:00:00Z,TOR vs. MIA,109,-5,1610612748,MIA,Miami Heat,MIA @ TOR,114,5,Regular Season
22021,1610612746,LAC,LA Clippers,0022101177,2022-04-03T00:00:00Z,LAC vs. NOP,119,19,1610612740,NOP,New Orleans Pelicans,NOP @ LAC,100,-19,Regular Season
22021,1610612753,ORL,Orlando Magic,0022101171,2022-04-03T00:00:00Z,ORL vs. NYK,88,-30,1610612752,NYK,New York Knicks,NYK @ ORL,118,30,Regular Season
22021,1610612761,TOR,Toronto Raptors,0022101182,2022-04-05T00:00:00Z,TOR vs. ATL,118,10,1610612737,ATL,Atlanta Hawks,ATL @ TOR,108,-10,Regular Season
22021,1610612756,PHX,Phoenix Suns,0022101189,2022-04-05T00:00:00Z,PHX vs. LAL,121,11,1610612747,LAL,Los Angeles Lakers,LAL @ PHX,110,-11,Regular Season
22021,1610612753,ORL,Orlando Magic,0022101179,2022-04-05T00:00:00Z,ORL vs. CLE,120,5,1610612739,CLE,Cleveland Cavaliers,CLE @ ORL,115,-5,Regular Season
22021,1610612751,BKN,Brooklyn Nets,0022101180,2022-04-05T00:00:00Z,BKN vs. HOU,118,13,1610612745,HOU,Houston Rockets,HOU @ BKN,105,-13,Regular Season
22021,1610612748,MIA,Miami Heat,0022101181,2022-04-05T00:00:00Z,MIA vs. CHA,144,29,1610612766,CHA,Charlotte Hornets,CHA @ MIA,115,-29,Regular Season
22021,1610612760,OKC,Oklahoma City Thunder,0022101185,2022-04-05T00:00:00Z,OKC vs. POR,98,4,1610612757,POR,Portland Trail Blazers,POR @ OKC,94,-4,Regular Season
22021,1610612750,MIN,Minnesota Timberwolves,0022101184,2022-04-05T00:00:00Z,MIN vs. WAS,114,-18,1610612764,WAS,Washington Wizards,WAS @ MIN,132,18,Regular Season
22021,1610612741,CHI,Chicago Bulls,0022101183,2022-04-05T00:00:00Z,CHI vs. MIL,106,-21,1610612749,MIL,Milwaukee Bucks,MIL @ CHI,127,21,Regular Season
22021,1610612743,DEN,Denver Nuggets,0022101186,2022-04-05T00:00:00Z,DEN vs. SAS,97,-19,1610612759,SAS,San Antonio Spurs,SAS @ DEN,116,19,Regular Season
22021,1610612762,UTA,Utah Jazz,0022101187,2022-04-05T00:00:00Z,UTA vs. MEM,121,6,1610612763,MEM,Memphis Grizzlies,MEM @ UTA,115,-6,Regular Season
22021,1610612758,SAC,Sacramento Kings,0022101188,2022-04-05T00:00:00Z,SAC vs. NOP,109,-14,1610612740,NOP,New Orleans Pelicans,NOP @ SAC,123,14,Regular Season
22021,1610612754,IND,Indiana Pacers,0022101178,2022-04-05T00:00:00Z,IND vs. PHI,122,-9,1610612755,PHI,Philadelphia 76ers,PHI @ IND,131,9,Regular Season
22021,1610612746,LAC,LA Clippers,0022101195,2022-04-06T00:00:00Z,LAC vs. PHX,113,4,1610612756,PHX,Phoenix Suns,PHX @ LAC,109,-4,Regular Season
22021,1610612765,DET,Detroit Pistons,0022101190,2022-04-06T00:00:00Z,DET vs. DAL,113,-18,1610612742,DAL,Dallas Mavericks,DAL @ DET,131,18,Regular Season
22021,1610612737,ATL,Atlanta Hawks,0022101192,2022-04-06T00:00:00Z,ATL vs. WAS,118,15,1610612764,WAS,Washington Wizards,WAS @ ATL,103,-15,Regular Season
22021,1610612762,UTA,Utah Jazz,0022101194,2022-04-06T00:00:00Z,UTA vs. OKC,137,36,1610612760,OKC,Oklahoma City Thunder,OKC @ UTA,101,-36,Regular Season
22021,1610612752,NYK,New York Knicks,0022101191,2022-04-06T00:00:00Z,NYK vs. BKN,98,-12,1610612751,BKN,Brooklyn Nets,BKN @ NYK,110,12,Regular Season
22021,1610612741,CHI,Chicago Bulls,0022101193,2022-04-06T00:00:00Z,CHI vs. BOS,94,-23,1610612738,BOS,Boston Celtics,BOS @ CHI,117,23,Regular Season
22021,1610612749,MIL,Milwaukee Bucks,0022101198,2022-04-07T00:00:00Z,MIL vs. BOS,127,6,1610612738,BOS,Boston Celtics,BOS @ MIL,121,-6,Regular Season
22021,1610612761,TOR,Toronto Raptors,0022101197,2022-04-07T00:00:00Z,TOR vs. PHI,119,5,1610612755,PHI,Philadelphia 76ers,PHI @ TOR,114,-5,Regular Season
22021,1610612744,GSW,Golden State Warriors,0022101202,2022-04-07T00:00:00Z,GSW vs. LAL,128,16,1610612747,LAL,Los Angeles Lakers,LAL @ GSW,112,-16,Regular Season
22021,1610612743,DEN,Denver Nuggets,0022101201,2022-04-07T00:00:00Z,DEN vs. MEM,122,13,1610612763,MEM,Memphis Grizzlies,MEM @ DEN,109,-13,Regular Season
22021,1610612750,MIN,Minnesota Timberwolves,0022101199,2022-04-07T00:00:00Z,MIN vs. SAS,127,6,1610612759,SAS,San Antonio Spurs,SAS @ MIN,121,-6,Regular Season
22021,1610612740,NOP,New Orleans Pelicans,0022101200,2022-04-07T00:00:00Z,NOP vs. POR,127,33,1610612757,POR,Portland Trail Blazers,POR @ NOP,94,-33,Regular Season
22021,1610612766,CHA,Charlotte Hornets,0022101196,2022-04-07T00:00:00Z,CHA vs. ORL,128,27,1610612753,ORL,Orlando Magic,ORL @ CHA,101,-27,Regular Season
22021,1610612761,TOR,Toronto Raptors,0022101206,2022-04-08T00:00:00Z,TOR vs. HOU,117,2,1610612745,HOU,Houston Rockets,HOU @ TOR,115,-2,Regular Season
22021,1610612751,BKN,Brooklyn Nets,0022101205,2022-04-08T00:00:00Z,BKN vs. CLE,118,11,1610612739,CLE,Cleveland Cavaliers,CLE @ BKN,107,-11,Regular Season
22021,1610612764,WAS,Washington Wizards,0022101204,2022-04-08T00:00:00Z,WAS vs. NYK,92,-22,1610612752,NYK,New York Knicks,NYK @ WAS,114,22,Regular Season
22021,1610612747,LAL,Los Angeles Lakers,0022101211,2022-04-08T00:00:00Z,LAL vs. OKC,120,19,1610612760,OKC,Oklahoma City Thunder,OKC @ LAL,101,-19,Regular Season
22021,1610612762,UTA,Utah Jazz,0022101210,2022-04-08T00:00:00Z,UTA vs. PHX,105,-6,1610612756,PHX,Phoenix Suns,PHX @ UTA,111,6,Regular Season
22021,1610612742,DAL,Dallas Mavericks,0022101209,2022-04-08T00:00:00Z,DAL vs. POR,128,50,1610612757,POR,Portland Trail Blazers,POR @ DAL,78,-50,Regular Season
22021,1610612765,DET,Detroit Pistons,0022101203,2022-04-08T00:00:00Z,DET vs. MIL,101,-30,1610612749,MIL,Milwaukee Bucks,MIL @ DET,131,30,Regular Season
22021,1610612741,CHI,Chicago Bulls,0022101208,2022-04-08T00:00:00Z,CHI vs. CHA,117,-16,1610612766,CHA,Charlotte Hornets,CHA @ CHI,133,16,Regular Season
22021,1610612748,MIA,Miami Heat,0022101207,2022-04-08T00:00:00Z,MIA vs. ATL,113,4,1610612737,ATL,Atlanta Hawks,ATL @ MIA,109,-4,Regular Season
22021,1610612763,MEM,Memphis Grizzlies,0022101213,2022-04-09T00:00:00Z,MEM vs. NOP,141,27,1610612740,NOP,New Orleans Pelicans,NOP @ MEM,114,-27,Regular Season
22021,1610612755,PHI,Philadelphia 76ers,0022101214,2022-04-09T00:00:00Z,PHI vs. IND,133,13,1610612754,IND,Indiana Pacers,IND @ PHI,120,-13,Regular Season
22021,1610612759,SAS,San Antonio Spurs,0022101215,2022-04-09T00:00:00Z,SAS vs. GSW,94,-6,1610612744,GSW,Golden State Warriors,GSW @ SAS,100,6,Regular Season
22021,1610612746,LAC,LA Clippers,0022101212,2022-04-09T00:00:00Z,LAC vs. SAC,117,19,1610612758,SAC,Sacramento Kings,SAC @ LAC,98,-19,Regular Season
22021,1610612757,POR,Portland Trail Blazers,0022101230,2022-04-10T00:00:00Z,POR vs. UTA,80,-31,1610612762,UTA,Utah Jazz,UTA @ POR,111,31,Regular Season
22021,1610612746,LAC,LA Clippers,0022101222,2022-04-10T00:00:00Z,LAC vs. OKC,138,50,1610612760,OKC,Oklahoma City Thunder,OKC @ LAC,88,-50,Regular Season
22021,1610612742,DAL,Dallas Mavericks,0022101219,2022-04-10T00:00:00Z,DAL vs. SAS,130,10,1610612759,SAS,San Antonio Spurs,SAS @ DAL,120,-10,Regular Season
22021,1610612763,MEM,Memphis Grizzlies,0022101223,2022-04-10T00:00:00Z,MEM vs. BOS,110,-29,1610612738,BOS,Boston Celtics,BOS @ MEM,139,29,Regular Season
22021,1610612756,PHX,Phoenix Suns,0022101229,2022-04-10T00:00:00Z,PHX vs. SAC,109,-7,1610612758,SAC,Sacramento Kings,SAC @ PHX,116,7,Regular Season
22021,1610612750,MIN,Minnesota Timberwolves,0022101224,2022-04-10T00:00:00Z,MIN vs. CHI,120,-4,1610612741,CHI,Chicago Bulls,CHI @ MIN,124,4,Regular Season
22021,1610612755,PHI,Philadelphia 76ers,0022101228,2022-04-10T00:00:00Z,PHI vs. DET,118,12,1610612765,DET,Detroit Pistons,DET @ PHI,106,-12,Regular Season
22021,1610612753,ORL,Orlando Magic,0022101227,2022-04-10T00:00:00Z,ORL vs. MIA,125,14,1610612748,MIA,Miami Heat,MIA @ ORL,111,-14,Regular Season
22021,1610612752,NYK,New York Knicks,0022101226,2022-04-10T00:00:00Z,NYK vs. TOR,105,11,1610612761,TOR,Toronto Raptors,TOR @ NYK,94,-11,Regular Season
22021,1610612751,BKN,Brooklyn Nets,0022101216,2022-04-10T00:00:00Z,BKN vs. IND,134,8,1610612754,IND,Indiana Pacers,IND @ BKN,126,-8,Regular Season
22021,1610612766,CHA,Charlotte Hornets,0022101217,2022-04-10T00:00:00Z,CHA vs. WAS,124,16,1610612764,WAS,Washington Wizards,WAS @ CHA,108,-16,Regular Season
22021,1610612745,HOU,Houston Rockets,0022101221,2022-04-10T00:00:00Z,HOU vs. ATL,114,-16,1610612737,ATL,Atlanta Hawks,ATL @ HOU,130,16,Regular Season
22021,1610612739,CLE,Cleveland Cavaliers,0022101218,2022-04-10T00:00:00Z,CLE vs. MIL,133,18,1610612749,MIL,Milwaukee Bucks,MIL @ CLE,115,-18,Regular Season
22021,1610612740,NOP,New Orleans Pelicans,0022101225,2022-04-10T00:00:00Z,NOP vs. GSW,107,-21,1610612744,GSW,Golden State Warriors,GSW @ NOP,128,21,Regular Season
22021,1610612743,DEN,Denver Nuggets,0022101220,2022-04-10T00:00:00Z,DEN vs. LAL,141,-5,1610612747,LAL,Los Angeles Lakers,LAL @ DEN,146,5,Regular Season
12021,1610612747,LAL,Los Angeles Lakers,0012100001,2021-10-03T00:00:00Z,LAL vs. BKN,97,-26,1610612751,BKN,Brooklyn Nets,BKN @ LAL,123,26,Pre Season
12021,1610612758,SAC,Sacramento Kings,0012100009,2021-10-04T00:00:00Z,SAC vs. PHX,117,11,1610612756,PHX,Phoenix Suns,PHX @ SAC,106,-11,Pre Season
12021,1610612761,TOR,Toronto Raptors,0012100002,2021-10-04T00:00:00Z,TOR vs. PHI,123,16,1610612755,PHI,Philadelphia 76ers,PHI @ TOR,107,-16,Pre Season
12021,1610612738,BOS,Boston Celtics,0012100003,2021-10-04T00:00:00Z,BOS vs. ORL,98,1,1610612753,ORL,Orlando Magic,ORL @ BOS,97,-1,Pre Season
12021,1610612748,MIA,Miami Heat,0012100004,2021-10-04T00:00:00Z,MIA vs. ATL,125,26,1610612737,ATL,Atlanta Hawks,ATL @ MIA,99,-26,Pre Season
12021,1610612760,OKC,Oklahoma City Thunder,0012100006,2021-10-04T00:00:00Z,OKC vs. CHA,97,-16,1610612766,CHA,Charlotte Hornets,CHA @ OKC,113,16,Pre Season
12021,1610612750,MIN,Minnesota Timberwolves,0012100005,2021-10-04T00:00:00Z,MIN vs. NOP,117,3,1610612740,NOP,New Orleans Pelicans,NOP @ MIN,114,-3,Pre Season
12021,1610612759,SAS,San Antonio Spurs,0012100007,2021-10-04T00:00:00Z,SAS vs. UTA,111,26,1610612762,UTA,Utah Jazz,UTA @ SAS,85,-26,Pre Season
12021,1610612757,POR,Portland Trail Blazers,0012100008,2021-10-04T00:00:00Z,POR vs. GSW,107,-14,1610612744,GSW,Golden State Warriors,GSW @ POR,121,14,Pre Season
12021,1610612746,LAC,LA Clippers,0012100010,2021-10-04T00:00:00Z,LAC vs. DEN,103,1,1610612743,DEN,Denver Nuggets,DEN @ LAC,102,-1,Pre Season
12021,1610612745,HOU,Houston Rockets,0012100013,2021-10-05T00:00:00Z,HOU vs. WAS,125,6,1610612764,WAS,Washington Wizards,WAS @ HOU,119,-6,Pre Season
12021,1610612763,MEM,Memphis Grizzlies,0012100014,2021-10-05T00:00:00Z,MEM vs. MIL,87,10,1610612749,MIL,Milwaukee Bucks,MIL @ MEM,77,-10,Pre Season
12021,1610612741,CHI,Chicago Bulls,0012100012,2021-10-05T00:00:00Z,CHI vs. CLE,131,36,1610612739,CLE,Cleveland Cavaliers,CLE @ CHI,95,-36,Pre Season
12021,1610612752,NYK,New York Knicks,0012100011,2021-10-05T00:00:00Z,NYK vs. IND,125,21,1610612754,IND,Indiana Pacers,IND @ NYK,104,-21,Pre Season
12021,1610612737,ATL,Atlanta Hawks,0012100016,2021-10-06T00:00:00Z,ATL vs. CLE,96,-3,1610612739,CLE,Cleveland Cavaliers,CLE @ ATL,99,3,Pre Season
12021,1610612756,PHX,Phoenix Suns,0012100020,2021-10-06T00:00:00Z,PHX vs. LAL,117,12,1610612747,LAL,Los Angeles Lakers,LAL @ PHX,105,-12,Pre Season
12021,1610612744,GSW,Golden State Warriors,0012100019,2021-10-06T00:00:00Z,GSW vs. DEN,118,2,1610612743,DEN,Denver Nuggets,DEN @ GSW,116,-2,Pre Season
12021,1610612742,DAL,Dallas Mavericks,0012100018,2021-10-06T00:00:00Z,DAL vs. UTA,111,10,1610612762,UTA,Utah Jazz,UTA @ DAL,101,-10,Pre Season
12021,1610612740,NOP,New Orleans Pelicans,0012100017,2021-10-06T00:00:00Z,NOP vs. ORL,104,18,1610612753,ORL,Orlando Magic,ORL @ NOP,86,-18,Pre Season
12021,1610612746,LAC,LA Clippers,0012100021,2021-10-06T00:00:00Z,LAC vs. SAC,98,-15,1610612758,SAC,Sacramento Kings,SAC @ LAC,113,15,Pre Season
12021,1610612765,DET,Detroit Pistons,0012100015,2021-10-06T00:00:00Z,DET vs. SAS,115,10,1610612759,SAS,San Antonio Spurs,SAS @ DET,105,-10,Pre Season
12021,1610612755,PHI,Philadelphia 76ers,0012100023,2021-10-07T00:00:00Z,PHI vs. TOR,125,12,1610612761,TOR,Toronto Raptors,TOR @ PHI,113,-12,Pre Season
12021,1610612766,CHA,Charlotte Hornets,0012100022,2021-10-07T00:00:00Z,CHA vs. MEM,98,-30,1610612763,MEM,Memphis Grizzlies,MEM @ CHA,128,30,Pre Season
12021,1610612745,HOU,Houston Rockets,0012100024,2021-10-07T00:00:00Z,HOU vs. MIA,106,-7,1610612748,MIA,Miami Heat,MIA @ HOU,113,7,Pre Season
12021,1610612744,GSW,Golden State Warriors,0012100031,2021-10-08T00:00:00Z,GSW vs. LAL,121,7,1610612747,LAL,Los Angeles Lakers,LAL @ GSW,114,-7,Pre Season
12021,1610612743,DEN,Denver Nuggets,0012100030,2021-10-08T00:00:00Z,DEN vs. MIN,112,-2,1610612750,MIN,Minnesota Timberwolves,MIN @ DEN,114,2,Pre Season
12021,1610612742,DAL,Dallas Mavericks,0012100028,2021-10-08T00:00:00Z,DAL vs. LAC,122,8,1610612746,LAC,LA Clippers,LAC @ DAL,114,-8,Pre Season
12021,1610612741,CHI,Chicago Bulls,0012100027,2021-10-08T00:00:00Z,CHI vs. NOP,121,36,1610612740,NOP,New Orleans Pelicans,NOP @ CHI,85,-36,Pre Season
12021,1610612751,BKN,Brooklyn Nets,0012100026,2021-10-08T00:00:00Z,BKN vs. MIL,119,4,1610612749,MIL,Milwaukee Bucks,MIL @ BKN,115,-4,Pre Season
12021,1610612739,CLE,Cleveland Cavaliers,0012100025,2021-10-08T00:00:00Z,CLE vs. IND,100,-9,1610612754,IND,Indiana Pacers,IND @ CLE,109,9,Pre Season
12021,1610612759,SAS,San Antonio Spurs,0012100029,2021-10-08T00:00:00Z,SAS vs. MIA,105,-4,1610612748,MIA,Miami Heat,MIA @ SAS,109,4,Pre Season
12021,1610612763,MEM,Memphis Grizzlies,0012100034,2021-10-09T00:00:00Z,MEM vs. ATL,87,-4,1610612737,ATL,Atlanta Hawks,ATL @ MEM,91,4,Pre Season
12021,1610612764,WAS,Washington Wizards,0012100033,2021-10-09T00:00:00Z,WAS vs. NYK,99,-18,1610612752,NYK,New York Knicks,NYK @ WAS,117,18,Pre Season
12021,1610612738,BOS,Boston Celtics,0012100032,2021-10-09T00:00:00Z,BOS vs. TOR,113,2,1610612761,TOR,Toronto Raptors,TOR @ BOS,111,-2,Pre Season
12021,1610612747,LAL,Los Angeles Lakers,0012100038,2021-10-10T00:00:00Z,LAL vs. PHX,94,-29,1610612756,PHX,Phoenix Suns,PHX @ LAL,123,29,Pre Season
12021,1610612739,CLE,Cleveland Cavaliers,0012100036,2021-10-10T00:00:00Z,CLE vs. CHI,101,-1,1610612741,CHI,Chicago Bulls,CHI @ CLE,102,1,Pre Season
12021,1610612749,MIL,Milwaukee Bucks,0012100037,2021-10-10T00:00:00Z,MIL vs. OKC,130,20,1610612760,OKC,Oklahoma City Thunder,OKC @ MIL,110,-20,Pre Season
12021,1610612753,ORL,Orlando Magic,0012100035,2021-10-10T00:00:00Z,ORL vs. SAS,100,-1,1610612759,SAS,San Antonio Spurs,SAS @ ORL,101,1,Pre Season
12021,1610612746,LAC,LA Clippers,0012100045,2021-10-11T00:00:00Z,LAC vs. MIN,100,-28,1610612750,MIN,Minnesota Timberwolves,MIN @ LAC,128,28,Pre Season
12021,1610612757,POR,Portland Trail Blazers,0012100044,2021-10-11T00:00:00Z,POR vs. SAC,93,-14,1610612758,SAC,Sacramento Kings,SAC @ POR,107,14,Pre Season
12021,1610612762,UTA,Utah Jazz,0012100043,2021-10-11T00:00:00Z,UTA vs. NOP,127,31,1610612740,NOP,New Orleans Pelicans,NOP @ UTA,96,-31,Pre Season
12021,1610612755,PHI,Philadelphia 76ers,0012100041,2021-10-11T00:00:00Z,PHI vs. BKN,115,11,1610612751,BKN,Brooklyn Nets,BKN @ PHI,104,-11,Pre Season
12021,1610612763,MEM,Memphis Grizzlies,0012100042,2021-10-11T00:00:00Z,MEM vs. DET,127,35,1610612765,DET,Detroit Pistons,DET @ MEM,92,-35,Pre Season
12021,1610612748,MIA,Miami Heat,0012100040,2021-10-11T00:00:00Z,MIA vs. CHA,104,1,1610612766,CHA,Charlotte Hornets,CHA @ MIA,103,-1,Pre Season
12021,1610612761,TOR,Toronto Raptors,0012100039,2021-10-11T00:00:00Z,TOR vs. HOU,107,15,1610612745,HOU,Houston Rockets,HOU @ TOR,92,-15,Pre Season
12021,1610612764,WAS,Washington Wizards,0012100046,2021-10-12T00:00:00Z,WAS vs. TOR,108,-5,1610612761,TOR,Toronto Raptors,TOR @ WAS,113,5,Pre Season
12021,1610612747,LAL,Los Angeles Lakers,0012100047,2021-10-12T00:00:00Z,LAL vs. GSW,99,-12,1610612744,GSW,Golden State Warriors,GSW @ LAL,111,12,Pre Season
12021,1610612756,PHX,Phoenix Suns,0012100054,2021-10-13T00:00:00Z,PHX vs. POR,119,45,1610612757,POR,Portland Trail Blazers,POR @ PHX,74,-45,Pre Season
12021,1610612766,CHA,Charlotte Hornets,0012100048,2021-10-13T00:00:00Z,CHA vs. DAL,59,-68,1610612742,DAL,Dallas Mavericks,DAL @ CHA,127,68,Pre Season
12021,1610612762,UTA,Utah Jazz,0012100053,2021-10-13T00:00:00Z,UTA vs. MIL,124,4,1610612749,MIL,Milwaukee Bucks,MIL @ UTA,120,-4,Pre Season
12021,1610612760,OKC,Oklahoma City Thunder,0012100052,2021-10-13T00:00:00Z,OKC vs. DEN,108,9,1610612743,DEN,Denver Nuggets,DEN @ OKC,99,-9,Pre Season
12021,1610612752,NYK,New York Knicks,0012100051,2021-10-13T00:00:00Z,NYK vs. DET,108,8,1610612765,DET,Detroit Pistons,DET @ NYK,100,-8,Pre Season
12021,1610612753,ORL,Orlando Magic,0012100050,2021-10-13T00:00:00Z,ORL vs. BOS,103,1,1610612738,BOS,Boston Celtics,BOS @ ORL,102,-1,Pre Season
12021,1610612754,IND,Indiana Pacers,0012100049,2021-10-13T00:00:00Z,IND vs. MEM,109,2,1610612763,MEM,Memphis Grizzlies,MEM @ IND,107,-2,Pre Season
12021,1610612737,ATL,Atlanta Hawks,0012100055,2021-10-14T00:00:00Z,ATL vs. MIA,127,35,1610612748,MIA,Miami Heat,MIA @ ATL,92,-35,Pre Season
12021,1610612751,BKN,Brooklyn Nets,0012100056,2021-10-14T00:00:00Z,BKN vs. MIN,107,6,1610612750,MIN,Minnesota Timberwolves,MIN @ BKN,101,-6,Pre Season
12021,1610612760,OKC,Oklahoma City Thunder,0012100057,2021-10-14T00:00:00Z,OKC vs. DEN,107,-6,1610612743,DEN,Denver Nuggets,DEN @ OKC,113,6,Pre Season
12021,1610612758,SAC,Sacramento Kings,0012100058,2021-10-14T00:00:00Z,SAC vs. LAL,116,4,1610612747,LAL,Los Angeles Lakers,LAL @ SAC,112,-4,Pre Season
12021,1610612748,MIA,Miami Heat,0012100059,2021-10-15T00:00:00Z,MIA vs. BOS,121,21,1610612738,BOS,Boston Celtics,BOS @ MIA,100,-21,Pre Season
12021,1610612744,GSW,Golden State Warriors,0012100066,2021-10-15T00:00:00Z,GSW vs. POR,119,22,1610612757,POR,Portland Trail Blazers,POR @ GSW,97,-22,Pre Season
12021,1610612759,SAS,San Antonio Spurs,0012100065,2021-10-15T00:00:00Z,SAS vs. HOU,126,28,1610612745,HOU,Houston Rockets,HOU @ SAS,98,-28,Pre Season
12021,1610612749,MIL,Milwaukee Bucks,0012100064,2021-10-15T00:00:00Z,MIL vs. DAL,103,-11,1610612742,DAL,Dallas Mavericks,DAL @ MIL,114,11,Pre Season
12021,1610612741,CHI,Chicago Bulls,0012100063,2021-10-15T00:00:00Z,CHI vs. MEM,118,13,1610612763,MEM,Memphis Grizzlies,MEM @ CHI,105,-13,Pre Season
12021,1610612752,NYK,New York Knicks,0012100062,2021-10-15T00:00:00Z,NYK vs. WAS,115,2,1610612764,WAS,Washington Wizards,WAS @ NYK,113,-2,Pre Season
12021,1610612765,DET,Detroit Pistons,0012100060,2021-10-15T00:00:00Z,DET vs. PHI,112,4,1610612755,PHI,Philadelphia 76ers,PHI @ DET,108,-4,Pre Season
12021,1610612754,IND,Indiana Pacers,0012100061,2021-10-15T00:00:00Z,IND vs. CLE,94,-16,1610612739,CLE,Cleveland Cavaliers,CLE @ IND,110,16,Pre Season
42021,1610612763,MEM,Memphis Grizzlies,0042100151,2022-04-16T00:00:00Z,MEM vs. MIN,117,-13,1610612750,MIN,Minnesota Timberwolves,MIN @ MEM,130,13,Playoffs
42021,1610612744,GSW,Golden State Warriors,0042100161,2022-04-16T00:00:00Z,GSW vs. DEN,123,16,1610612743,DEN,Denver Nuggets,DEN @ GSW,107,-16,Playoffs
42021,1610612755,PHI,Philadelphia 76ers,0042100131,2022-04-16T00:00:00Z,PHI vs. TOR,131,20,1610612761,TOR,Toronto Raptors,TOR @ PHI,111,-20,Playoffs
42021,1610612742,DAL,Dallas Mavericks,0042100171,2022-04-16T00:00:00Z,DAL vs. UTA,93,-6,1610612762,UTA,Utah Jazz,UTA @ DAL,99,6,Playoffs
42021,1610612756,PHX,Phoenix Suns,0042100141,2022-04-17T00:00:00Z,PHX vs. NOP,110,11,1610612740,NOP,New Orleans Pelicans,NOP @ PHX,99,-11,Playoffs
42021,1610612749,MIL,Milwaukee Bucks,0042100121,2022-04-17T00:00:00Z,MIL vs. CHI,93,7,1610612741,CHI,Chicago Bulls,CHI @ MIL,86,-7,Playoffs
42021,1610612738,BOS,Boston Celtics,0042100111,2022-04-17T00:00:00Z,BOS vs. BKN,115,1,1610612751,BKN,Brooklyn Nets,BKN @ BOS,114,-1,Playoffs
42021,1610612748,MIA,Miami Heat,0042100101,2022-04-17T00:00:00Z,MIA vs. ATL,115,24,1610612737,ATL,Atlanta Hawks,ATL @ MIA,91,-24,Playoffs
42021,1610612742,DAL,Dallas Mavericks,0042100172,2022-04-18T00:00:00Z,DAL vs. UTA,110,6,1610612762,UTA,Utah Jazz,UTA @ DAL,104,-6,Playoffs
42021,1610612744,GSW,Golden State Warriors,0042100162,2022-04-18T00:00:00Z,GSW vs. DEN,126,20,1610612743,DEN,Denver Nuggets,DEN @ GSW,106,-20,Playoffs
42021,1610612755,PHI,Philadelphia 76ers,0042100132,2022-04-18T00:00:00Z,PHI vs. TOR,112,15,1610612761,TOR,Toronto Raptors,TOR @ PHI,97,-15,Playoffs
42021,1610612756,PHX,Phoenix Suns,0042100142,2022-04-19T00:00:00Z,PHX vs. NOP,114,-11,1610612740,NOP,New Orleans Pelicans,NOP @ PHX,125,11,Playoffs
42021,1610612763,MEM,Memphis Grizzlies,0042100152,2022-04-19T00:00:00Z,MEM vs. MIN,124,28,1610612750,MIN,Minnesota Timberwolves,MIN @ MEM,96,-28,Playoffs
42021,1610612748,MIA,Miami Heat,0042100102,2022-04-19T00:00:00Z,MIA vs. ATL,115,10,1610612737,ATL,Atlanta Hawks,ATL @ MIA,105,-10,Playoffs
42021,1610612749,MIL,Milwaukee Bucks,0042100122,2022-04-20T00:00:00Z,MIL vs. CHI,110,-4,1610612741,CHI,Chicago Bulls,CHI @ MIL,114,4,Playoffs
42021,1610612738,BOS,Boston Celtics,0042100112,2022-04-20T00:00:00Z,BOS vs. BKN,114,7,1610612751,BKN,Brooklyn Nets,BKN @ BOS,107,-7,Playoffs
42021,1610612761,TOR,Toronto Raptors,0042100133,2022-04-20T00:00:00Z,TOR vs. PHI,101,-3,1610612755,PHI,Philadelphia 76ers,PHI @ TOR,104,3,Playoffs
42021,1610612750,MIN,Minnesota Timberwolves,0042100153,2022-04-21T00:00:00Z,MIN vs. MEM,95,-9,1610612763,MEM,Memphis Grizzlies,MEM @ MIN,104,9,Playoffs
42021,1610612762,UTA,Utah Jazz,0042100173,2022-04-21T00:00:00Z,UTA vs. DAL,118,-8,1610612742,DAL,Dallas Mavericks,DAL @ UTA,126,8,Playoffs
42021,1610612743,DEN,Denver Nuggets,0042100163,2022-04-21T00:00:00Z,DEN vs. GSW,113,-5,1610612744,GSW,Golden State Warriors,GSW @ DEN,118,5,Playoffs
42021,1610612737,ATL,Atlanta Hawks,0042100103,2022-04-22T00:00:00Z,ATL vs. MIA,111,1,1610612748,MIA,Miami Heat,MIA @ ATL,110,-1,Playoffs
42021,1610612740,NOP,New Orleans Pelicans,0042100143,2022-04-22T00:00:00Z,NOP vs. PHX,111,-3,1610612756,PHX,Phoenix Suns,PHX @ NOP,114,3,Playoffs
42021,1610612741,CHI,Chicago Bulls,0042100123,2022-04-22T00:00:00Z,CHI vs. MIL,81,-30,1610612749,MIL,Milwaukee Bucks,MIL @ CHI,111,30,Playoffs
42021,1610612761,TOR,Toronto Raptors,0042100134,2022-04-23T00:00:00Z,TOR vs. PHI,110,8,1610612755,PHI,Philadelphia 76ers,PHI @ TOR,102,-8,Playoffs
42021,1610612762,UTA,Utah Jazz,0042100174,2022-04-23T00:00:00Z,UTA vs. DAL,100,1,1610612742,DAL,Dallas Mavericks,DAL @ UTA,99,-1,Playoffs
42021,1610612751,BKN,Brooklyn Nets,0042100113,2022-04-23T00:00:00Z,BKN vs. BOS,103,-6,1610612738,BOS,Boston Celtics,BOS @ BKN,109,6,Playoffs
42021,1610612750,MIN,Minnesota Timberwolves,0042100154,2022-04-23T00:00:00Z,MIN vs. MEM,119,1,1610612763,MEM,Memphis Grizzlies,MEM @ MIN,118,-1,Playoffs
42021,1610612737,ATL,Atlanta Hawks,0042100104,2022-04-24T00:00:00Z,ATL vs. MIA,86,-24,1610612748,MIA,Miami Heat,MIA @ ATL,110,24,Playoffs
42021,1610612740,NOP,New Orleans Pelicans,0042100144,2022-04-24T00:00:00Z,NOP vs. PHX,118,15,1610612756,PHX,Phoenix Suns,PHX @ NOP,103,-15,Playoffs
42021,1610612743,DEN,Denver Nuggets,0042100164,2022-04-24T00:00:00Z,DEN vs. GSW,126,5,1610612744,GSW,Golden State Warriors,GSW @ DEN,121,-5,Playoffs
42021,1610612741,CHI,Chicago Bulls,0042100124,2022-04-24T00:00:00Z,CHI vs. MIL,95,-24,1610612749,MIL,Milwaukee Bucks,MIL @ CHI,119,24,Playoffs
42021,1610612751,BKN,Brooklyn Nets,0042100114,2022-04-25T00:00:00Z,BKN vs. BOS,112,-4,1610612738,BOS,Boston Celtics,BOS @ BKN,116,4,Playoffs
42021,1610612755,PHI,Philadelphia 76ers,0042100135,2022-04-25T00:00:00Z,PHI vs. TOR,88,-15,1610612761,TOR,Toronto Raptors,TOR @ PHI,103,15,Playoffs
42021,1610612742,DAL,Dallas Mavericks,0042100175,2022-04-25T00:00:00Z,DAL vs. UTA,102,25,1610612762,UTA,Utah Jazz,UTA @ DAL,77,-25,Playoffs
42021,1610612763,MEM,Memphis Grizzlies,0042100155,2022-04-26T00:00:00Z,MEM vs. MIN,111,2,1610612750,MIN,Minnesota Timberwolves,MIN @ MEM,109,-2,Playoffs
42021,1610612756,PHX,Phoenix Suns,0042100145,2022-04-26T00:00:00Z,PHX vs. NOP,112,15,1610612740,NOP,New Orleans Pelicans,NOP @ PHX,97,-15,Playoffs
42021,1610612748,MIA,Miami Heat,0042100105,2022-04-26T00:00:00Z,MIA vs. ATL,97,3,1610612737,ATL,Atlanta Hawks,ATL @ MIA,94,-3,Playoffs
42021,1610612749,MIL,Milwaukee Bucks,0042100125,2022-04-27T00:00:00Z,MIL vs. CHI,116,16,1610612741,CHI,Chicago Bulls,CHI @ MIL,100,-16,Playoffs
42021,1610612744,GSW,Golden State Warriors,0042100165,2022-04-27T00:00:00Z,GSW vs. DEN,102,4,1610612743,DEN,Denver Nuggets,DEN @ GSW,98,-4,Playoffs
42021,1610612762,UTA,Utah Jazz,0042100176,2022-04-28T00:00:00Z,UTA vs. DAL,96,-2,1610612742,DAL,Dallas Mavericks,DAL @ UTA,98,2,Playoffs
42021,1610612761,TOR,Toronto Raptors,0042100136,2022-04-28T00:00:00Z,TOR vs. PHI,97,-35,1610612755,PHI,Philadelphia 76ers,PHI @ TOR,132,35,Playoffs
42021,1610612740,NOP,New Orleans Pelicans,0042100146,2022-04-28T00:00:00Z,NOP vs. PHX,109,-6,1610612756,PHX,Phoenix Suns,PHX @ NOP,115,6,Playoffs
42021,1610612750,MIN,Minnesota Timberwolves,0042100156,2022-04-29T00:00:00Z,MIN vs. MEM,106,-8,1610612763,MEM,Memphis Grizzlies,MEM @ MIN,114,8,Playoffs
42021,1610612763,MEM,Memphis Grizzlies,0042100231,2022-05-01T00:00:00Z,MEM vs. GSW,116,-1,1610612744,GSW,Golden State Warriors,GSW @ MEM,117,1,Playoffs
42021,1610612738,BOS,Boston Celtics,0042100211,2022-05-01T00:00:00Z,BOS vs. MIL,89,-12,1610612749,MIL,Milwaukee Bucks,MIL @ BOS,101,12,Playoffs
42021,1610612748,MIA,Miami Heat,0042100201,2022-05-02T00:00:00Z,MIA vs. PHI,106,14,1610612755,PHI,Philadelphia 76ers,PHI @ MIA,92,-14,Playoffs
42021,1610612756,PHX,Phoenix Suns,0042100221,2022-05-02T00:00:00Z,PHX vs. DAL,121,7,1610612742,DAL,Dallas Mavericks,DAL @ PHX,114,-7,Playoffs
42021,1610612738,BOS,Boston Celtics,0042100212,2022-05-03T00:00:00Z,BOS vs. MIL,109,23,1610612749,MIL,Milwaukee Bucks,MIL @ BOS,86,-23,Playoffs
42021,1610612763,MEM,Memphis Grizzlies,0042100232,2022-05-03T00:00:00Z,MEM vs. GSW,106,5,1610612744,GSW,Golden State Warriors,GSW @ MEM,101,-5,Playoffs
42021,1610612748,MIA,Miami Heat,0042100202,2022-05-04T00:00:00Z,MIA vs. PHI,119,16,1610612755,PHI,Philadelphia 76ers,PHI @ MIA,103,-16,Playoffs
42021,1610612756,PHX,Phoenix Suns,0042100222,2022-05-04T00:00:00Z,PHX vs. DAL,129,20,1610612742,DAL,Dallas Mavericks,DAL @ PHX,109,-20,Playoffs
42021,1610612742,DAL,Dallas Mavericks,0042100223,2022-05-06T00:00:00Z,DAL vs. PHX,103,9,1610612756,PHX,Phoenix Suns,PHX @ DAL,94,-9,Playoffs
42021,1610612755,PHI,Philadelphia 76ers,0042100203,2022-05-06T00:00:00Z,PHI vs. MIA,99,20,1610612748,MIA,Miami Heat,MIA @ PHI,79,-20,Playoffs
42021,1610612749,MIL,Milwaukee Bucks,0042100213,2022-05-07T00:00:00Z,MIL vs. BOS,103,2,1610612738,BOS,Boston Celtics,BOS @ MIL,101,-2,Playoffs
42021,1610612744,GSW,Golden State Warriors,0042100233,2022-05-07T00:00:00Z,GSW vs. MEM,142,30,1610612763,MEM,Memphis Grizzlies,MEM @ GSW,112,-30,Playoffs
42021,1610612742,DAL,Dallas Mavericks,0042100224,2022-05-08T00:00:00Z,DAL vs. PHX,111,10,1610612756,PHX,Phoenix Suns,PHX @ DAL,101,-10,Playoffs
42021,1610612755,PHI,Philadelphia 76ers,0042100204,2022-05-08T00:00:00Z,PHI vs. MIA,116,8,1610612748,MIA,Miami Heat,MIA @ PHI,108,-8,Playoffs
42021,1610612749,MIL,Milwaukee Bucks,0042100214,2022-05-09T00:00:00Z,MIL vs. BOS,108,-8,1610612738,BOS,Boston Celtics,BOS @ MIL,116,8,Playoffs
42021,1610612744,GSW,Golden State Warriors,0042100234,2022-05-09T00:00:00Z,GSW vs. MEM,101,3,1610612763,MEM,Memphis Grizzlies,MEM @ GSW,98,-3,Playoffs
42021,1610612756,PHX,Phoenix Suns,0042100225,2022-05-10T00:00:00Z,PHX vs. DAL,110,30,1610612742,DAL,Dallas Mavericks,DAL @ PHX,80,-30,Playoffs
42021,1610612748,MIA,Miami Heat,0042100205,2022-05-10T00:00:00Z,MIA vs. PHI,120,35,1610612755,PHI,Philadelphia 76ers,PHI @ MIA,85,-35,Playoffs
42021,1610612738,BOS,Boston Celtics,0042100215,2022-05-11T00:00:00Z,BOS vs. MIL,107,-3,1610612749,MIL,Milwaukee Bucks,MIL @ BOS,110,3,Playoffs
42021,1610612763,MEM,Memphis Grizzlies,0042100235,2022-05-11T00:00:00Z,MEM vs. GSW,134,39,1610612744,GSW,Golden State Warriors,GSW @ MEM,95,-39,Playoffs
42021,1610612755,PHI,Philadelphia 76ers,0042100206,2022-05-12T00:00:00Z,PHI vs. MIA,90,-9,1610612748,MIA,Miami Heat,MIA @ PHI,99,9,Playoffs
42021,1610612742,DAL,Dallas Mavericks,0042100226,2022-05-12T00:00:00Z,DAL vs. PHX,113,27,1610612756,PHX,Phoenix Suns,PHX @ DAL,86,-27,Playoffs
42021,1610612744,GSW,Golden State Warriors,0042100236,2022-05-13T00:00:00Z,GSW vs. MEM,110,14,1610612763,MEM,Memphis Grizzlies,MEM @ GSW,96,-14,Playoffs
42021,1610612749,MIL,Milwaukee Bucks,0042100216,2022-05-13T00:00:00Z,MIL vs. BOS,95,-13,1610612738,BOS,Boston Celtics,BOS @ MIL,108,13,Playoffs
42021,1610612756,PHX,Phoenix Suns,0042100227,2022-05-15T00:00:00Z,PHX vs. DAL,90,-33,1610612742,DAL,Dallas Mavericks,DAL @ PHX,123,33,Playoffs
42021,1610612738,BOS,Boston Celtics,0042100217,2022-05-15T00:00:00Z,BOS vs. MIL,109,28,1610612749,MIL,Milwaukee Bucks,MIL @ BOS,81,-28,Playoffs
42021,1610612748,MIA,Miami Heat,0042100301,2022-05-17T00:00:00Z,MIA vs. BOS,118,11,1610612738,BOS,Boston Celtics,BOS @ MIA,107,-11,Playoffs
42021,1610612744,GSW,Golden State Warriors,0042100311,2022-05-18T00:00:00Z,GSW vs. DAL,112,25,1610612742,DAL,Dallas Mavericks,DAL @ GSW,87,-25,Playoffs
42021,1610612748,MIA,Miami Heat,0042100302,2022-05-19T00:00:00Z,MIA vs. BOS,102,-25,1610612738,BOS,Boston Celtics,BOS @ MIA,127,25,Playoffs
42021,1610612744,GSW,Golden State Warriors,0042100312,2022-05-20T00:00:00Z,GSW vs. DAL,126,9,1610612742,DAL,Dallas Mavericks,DAL @ GSW,117,-9,Playoffs
42021,1610612738,BOS,Boston Celtics,0042100303,2022-05-21T00:00:00Z,BOS vs. MIA,103,-6,1610612748,MIA,Miami Heat,MIA @ BOS,109,6,Playoffs
42021,1610612742,DAL,Dallas Mavericks,0042100313,2022-05-22T00:00:00Z,DAL vs. GSW,100,-9,1610612744,GSW,Golden State Warriors,GSW @ DAL,109,9,Playoffs
42021,1610612738,BOS,Boston Celtics,0042100304,2022-05-23T00:00:00Z,BOS vs. MIA,102,20,1610612748,MIA,Miami Heat,MIA @ BOS,82,-20,Playoffs
42021,1610612742,DAL,Dallas Mavericks,0042100314,2022-05-24T00:00:00Z,DAL vs. GSW,119,10,1610612744,GSW,Golden State Warriors,GSW @ DAL,109,-10,Playoffs
42021,1610612748,MIA,Miami Heat,0042100305,2022-05-25T00:00:00Z,MIA vs. BOS,80,-13,1610612738,BOS,Boston Celtics,BOS @ MIA,93,13,Playoffs
42021,1610612744,GSW,Golden State Warriors,0042100315,2022-05-26T00:00:00Z,GSW vs. DAL,120,10,1610612742,DAL,Dallas Mavericks,DAL @ GSW,110,-10,Playoffs
42021,1610612738,BOS,Boston Celtics,0042100306,2022-05-27T00:00:00Z,BOS vs. MIA,103,-8,1610612748,MIA,Miami Heat,MIA @ BOS,111,8,Playoffs
42021,1610612748,MIA,Miami Heat,0042100307,2022-05-29T00:00:00Z,MIA vs. BOS,96,-4,1610612738,BOS,Boston Celtics,BOS @ MIA,100,4,Playoffs
42021,1610612744,GSW,Golden State Warriors,0042100401,2022-06-02T00:00:00Z,GSW vs. BOS,108,-12,1610612738,BOS,Boston Celtics,BOS @ GSW,120,12,Playoffs
42021,1610612744,GSW,Golden State Warriors,0042100402,2022-06-05T00:00:00Z,GSW vs. BOS,107,19,1610612738,BOS,Boston Celtics,BOS @ GSW,88,-19,Playoffs
42021,1610612738,BOS,Boston Celtics,0042100403,2022-06-08T00:00:00Z,BOS vs. GSW,116,16,1610612744,GSW,Golden State Warriors,GSW @ BOS,100,-16,Playoffs
42021,1610612738,BOS,Boston Celtics,0042100404,2022-06-10T00:00:00Z,BOS vs. GSW,97,-10,1610612744,GSW,Golden State Warriors,GSW @ BOS,107,10,Playoffs
42021,1610612744,GSW,Golden State Warriors,0042100405,2022-06-13T00:00:00Z,GSW vs. BOS,104,10,1610612738,BOS,Boston Celtics,BOS @ GSW,94,-10,Playoffs
42021,1610612738,BOS,Boston Celtics,0042100406,2022-06-16T00:00:00Z,BOS vs. GSW,90,-13,1610612744,GSW,Golden State Warriors,GSW @ BOS,103,13,Playoffs
32021,1610616834,LBN,Team LeBron,0032100001,2022-02-20T00:00:00Z,LBN vs. DRT,163,3,1610616833,DRT,Team Durant,DRT @ LBN,160,-3,All Star
22022,1610612738,BOS,Boston Celtics,0022200001,2022-10-18T00:00:00Z,BOS vs. PHI,126,9,1610612755,PHI,Philadelphia 76ers,PHI @ BOS,117,-9,Regular Season
22022,1610612744,GSW,Golden State Warriors,0022200002,2022-10-18T00:00:00Z,GSW vs. LAL,123,14,1610612747,LAL,Los Angeles Lakers,LAL @ GSW,109,-14,Regular Season
22022,1610612765,DET,Detroit Pistons,0022200003,2022-10-19T00:00:00Z,DET vs. ORL,113,4,1610612753,ORL,Orlando Magic,ORL @ DET,109,-4,Regular Season
22022,1610612762,UTA,Utah Jazz,0022200012,2022-10-19T00:00:00Z,UTA vs. DEN,123,21,1610612743,DEN,Denver Nuggets,DEN @ UTA,102,-21,Regular Season
22022,1610612751,BKN,Brooklyn Nets,0022200006,2022-10-19T00:00:00Z,BKN vs. NOP,108,-22,1610612740,NOP,New Orleans Pelicans,NOP @ BKN,130,22,Regular Season
22022,1610612754,IND,Indiana Pacers,0022200004,2022-10-19T00:00:00Z,IND vs. WAS,107,-7,1610612764,WAS,Washington Wizards,WAS @ IND,114,7,Regular Season
22022,1610612758,SAC,Sacramento Kings,0022200014,2022-10-19T00:00:00Z,SAC vs. POR,108,-7,1610612757,POR,Portland Trail Blazers,POR @ SAC,115,7,Regular Season
22022,1610612756,PHX,Phoenix Suns,0022200013,2022-10-19T00:00:00Z,PHX vs. DAL,107,2,1610612742,DAL,Dallas Mavericks,DAL @ PHX,105,-2,Regular Season
22022,1610612759,SAS,San Antonio Spurs,0022200011,2022-10-19T00:00:00Z,SAS vs. CHA,102,-27,1610612766,CHA,Charlotte Hornets,CHA @ SAS,129,27,Regular Season
22022,1610612750,MIN,Minnesota Timberwolves,0022200010,2022-10-19T00:00:00Z,MIN vs. OKC,115,7,1610612760,OKC,Oklahoma City Thunder,OKC @ MIN,108,-7,Regular Season
22022,1610612761,TOR,Toronto Raptors,0022200008,2022-10-19T00:00:00Z,TOR vs. CLE,108,3,1610612739,CLE,Cleveland Cavaliers,CLE @ TOR,105,-3,Regular Season
22022,1610612763,MEM,Memphis Grizzlies,0022200009,2022-10-19T00:00:00Z,MEM vs. NYK,115,3,1610612752,NYK,New York Knicks,NYK @ MEM,112,-3,Regular Season
22022,1610612748,MIA,Miami Heat,0022200007,2022-10-19T00:00:00Z,MIA vs. CHI,108,-8,1610612741,CHI,Chicago Bulls,CHI @ MIA,116,8,Regular Season
22022,1610612737,ATL,Atlanta Hawks,0022200005,2022-10-19T00:00:00Z,ATL vs. HOU,117,10,1610612745,HOU,Houston Rockets,HOU @ ATL,107,-10,Regular Season
22022,1610612755,PHI,Philadelphia 76ers,0022200015,2022-10-20T00:00:00Z,PHI vs. MIL,88,-2,1610612749,MIL,Milwaukee Bucks,MIL @ PHI,90,2,Regular Season
22022,1610612747,LAL,Los Angeles Lakers,0022200016,2022-10-20T00:00:00Z,LAL vs. LAC,97,-6,1610612746,LAC,LA Clippers,LAC @ LAL,103,6,Regular Season
22022,1610612745,HOU,Houston Rockets,0022200024,2022-10-21T00:00:00Z,HOU vs. MEM,122,-7,1610612763,MEM,Memphis Grizzlies,MEM @ HOU,129,7,Regular Season
22022,1610612751,BKN,Brooklyn Nets,0022200021,2022-10-21T00:00:00Z,BKN vs. TOR,109,4,1610612761,TOR,Toronto Raptors,TOR @ BKN,105,-4,Regular Season
22022,1610612757,POR,Portland Trail Blazers,0022200027,2022-10-21T00:00:00Z,POR vs. PHX,113,2,1610612756,PHX,Phoenix Suns,PHX @ POR,111,-2,Regular Season
22022,1610612750,MIN,Minnesota Timberwolves,0022200025,2022-10-21T00:00:00Z,MIN vs. UTA,126,-6,1610612762,UTA,Utah Jazz,UTA @ MIN,132,6,Regular Season
22022,1610612737,ATL,Atlanta Hawks,0022200020,2022-10-21T00:00:00Z,ATL vs. ORL,108,10,1610612753,ORL,Orlando Magic,ORL @ ATL,98,-10,Regular Season
22022,1610612744,GSW,Golden State Warriors,0022200026,2022-10-21T00:00:00Z,GSW vs. DEN,123,-5,1610612743,DEN,Denver Nuggets,DEN @ GSW,128,5,Regular Season
22022,1610612754,IND,Indiana Pacers,0022200018,2022-10-21T00:00:00Z,IND vs. SAS,134,-3,1610612759,SAS,San Antonio Spurs,SAS @ IND,137,3,Regular Season
22022,1610612766,CHA,Charlotte Hornets,0022200017,2022-10-21T00:00:00Z,CHA vs. NOP,112,-12,1610612740,NOP,New Orleans Pelicans,NOP @ CHA,124,12,Regular Season
22022,1610612752,NYK,New York Knicks,0022200023,2022-10-21T00:00:00Z,NYK vs. DET,130,24,1610612765,DET,Detroit Pistons,DET @ NYK,106,-24,Regular Season
22022,1610612748,MIA,Miami Heat,0022200022,2022-10-21T00:00:00Z,MIA vs. BOS,104,-7,1610612738,BOS,Boston Celtics,BOS @ MIA,111,7,Regular Season
22022,1610612764,WAS,Washington Wizards,0022200019,2022-10-21T00:00:00Z,WAS vs. CHI,102,2,1610612741,CHI,Chicago Bulls,CHI @ WAS,100,-2,Regular Season
22022,1610612742,DAL,Dallas Mavericks,0022200034,2022-10-22T00:00:00Z,DAL vs. MEM,137,41,1610612763,MEM,Memphis Grizzlies,MEM @ DAL,96,-41,Regular Season
22022,1610612741,CHI,Chicago Bulls,0022200032,2022-10-22T00:00:00Z,CHI vs. CLE,96,-32,1610612739,CLE,Cleveland Cavaliers,CLE @ CHI,128,32,Regular Season
22022,1610612755,PHI,Philadelphia 76ers,0022200028,2022-10-22T00:00:00Z,PHI vs. SAS,105,-9,1610612759,SAS,San Antonio Spurs,SAS @ PHI,114,9,Regular Season
22022,1610612749,MIL,Milwaukee Bucks,0022200033,2022-10-22T00:00:00Z,MIL vs. HOU,125,20,1610612745,HOU,Houston Rockets,HOU @ MIL,105,-20,Regular Season
22022,1610612753,ORL,Orlando Magic,0022200030,2022-10-22T00:00:00Z,ORL vs. BOS,120,-6,1610612738,BOS,Boston Celtics,BOS @ ORL,126,6,Regular Season
22022,1610612754,IND,Indiana Pacers,0022200029,2022-10-22T00:00:00Z,IND vs. DET,124,9,1610612765,DET,Detroit Pistons,DET @ IND,115,-9,Regular Season
22022,1610612758,SAC,Sacramento Kings,0022200036,2022-10-22T00:00:00Z,SAC vs. LAC,109,-2,1610612746,LAC,LA Clippers,LAC @ SAC,111,2,Regular Season
22022,1610612743,DEN,Denver Nuggets,0022200035,2022-10-22T00:00:00Z,DEN vs. OKC,122,5,1610612760,OKC,Oklahoma City Thunder,OKC @ DEN,117,-5,Regular Season
22022,1610612748,MIA,Miami Heat,0022200031,2022-10-22T00:00:00Z,MIA vs. TOR,112,3,1610612761,TOR,Toronto Raptors,TOR @ MIA,109,-3,Regular Season
22022,1610612760,OKC,Oklahoma City Thunder,0022200041,2022-10-23T00:00:00Z,OKC vs. MIN,106,-10,1610612750,MIN,Minnesota Timberwolves,MIN @ OKC,116,10,Regular Season
22022,1610612746,LAC,LA Clippers,0022200043,2022-10-23T00:00:00Z,LAC vs. PHX,95,-17,1610612756,PHX,Phoenix Suns,PHX @ LAC,112,17,Regular Season
22022,1610612747,LAL,Los Angeles Lakers,0022200037,2022-10-23T00:00:00Z,LAL vs. POR,104,-2,1610612757,POR,Portland Trail Blazers,POR @ LAL,106,2,Regular Season
22022,1610612737,ATL,Atlanta Hawks,0022200038,2022-10-23T00:00:00Z,ATL vs. CHA,109,-17,1610612766,CHA,Charlotte Hornets,CHA @ ATL,126,17,Regular Season
22022,1610612740,NOP,New Orleans Pelicans,0022200040,2022-10-23T00:00:00Z,NOP vs. UTA,121,-1,1610612762,UTA,Utah Jazz,UTA @ NOP,122,1,Regular Season
22022,1610612744,GSW,Golden State Warriors,0022200042,2022-10-23T00:00:00Z,GSW vs. SAC,130,5,1610612758,SAC,Sacramento Kings,SAC @ GSW,125,-5,Regular Season
22022,1610612739,CLE,Cleveland Cavaliers,0022200039,2022-10-23T00:00:00Z,CLE vs. WAS,117,10,1610612764,WAS,Washington Wizards,WAS @ CLE,107,-10,Regular Season
22022,1610612755,PHI,Philadelphia 76ers,0022200044,2022-10-24T00:00:00Z,PHI vs. IND,120,14,1610612754,IND,Indiana Pacers,IND @ PHI,106,-14,Regular Season
22022,1610612752,NYK,New York Knicks,0022200046,2022-10-24T00:00:00Z,NYK vs. ORL,115,13,1610612753,ORL,Orlando Magic,ORL @ NYK,102,-13,Regular Season
22022,1610612748,MIA,Miami Heat,0022200045,2022-10-24T00:00:00Z,MIA vs. TOR,90,-8,1610612761,TOR,Toronto Raptors,TOR @ MIA,98,8,Regular Season
22022,1610612741,CHI,Chicago Bulls,0022200047,2022-10-24T00:00:00Z,CHI vs. BOS,120,18,1610612738,BOS,Boston Celtics,BOS @ CHI,102,-18,Regular Season
22022,1610612763,MEM,Memphis Grizzlies,0022200049,2022-10-24T00:00:00Z,MEM vs. BKN,134,10,1610612751,BKN,Brooklyn Nets,BKN @ MEM,124,-10,Regular Season
22022,1610612750,MIN,Minnesota Timberwolves,0022200050,2022-10-24T00:00:00Z,MIN vs. SAS,106,-9,1610612759,SAS,San Antonio Spurs,SAS @ MIN,115,9,Regular Season
22022,1610612757,POR,Portland Trail Blazers,0022200051,2022-10-24T00:00:00Z,POR vs. DEN,135,25,1610612743,DEN,Denver Nuggets,DEN @ POR,110,-25,Regular Season
22022,1610612745,HOU,Houston Rockets,0022200048,2022-10-24T00:00:00Z,HOU vs. UTA,114,6,1610612762,UTA,Utah Jazz,UTA @ HOU,108,-6,Regular Season
22022,1610612740,NOP,New Orleans Pelicans,0022200053,2022-10-25T00:00:00Z,NOP vs. DAL,113,2,1610612742,DAL,Dallas Mavericks,DAL @ NOP,111,-2,Regular Season
22022,1610612756,PHX,Phoenix Suns,0022200055,2022-10-25T00:00:00Z,PHX vs. GSW,134,29,1610612744,GSW,Golden State Warriors,GSW @ PHX,105,-29,Regular Season
22022,1610612764,WAS,Washington Wizards,0022200052,2022-10-25T00:00:00Z,WAS vs. DET,120,21,1610612765,DET,Detroit Pistons,DET @ WAS,99,-21,Regular Season
22022,1610612760,OKC,Oklahoma City Thunder,0022200054,2022-10-25T00:00:00Z,OKC vs. LAC,108,14,1610612746,LAC,LA Clippers,LAC @ OKC,94,-14,Regular Season
22022,1610612752,NYK,New York Knicks,0022200058,2022-10-26T00:00:00Z,NYK vs. CHA,134,3,1610612766,CHA,Charlotte Hornets,CHA @ NYK,131,-3,Regular Season
22022,1610612761,TOR,Toronto Raptors,0022200059,2022-10-26T00:00:00Z,TOR vs. PHI,119,10,1610612755,PHI,Philadelphia 76ers,PHI @ TOR,109,-10,Regular Season
22022,1610612762,UTA,Utah Jazz,0022200063,2022-10-26T00:00:00Z,UTA vs. HOU,109,8,1610612745,HOU,Houston Rockets,HOU @ UTA,101,-8,Regular Season
22022,1610612757,POR,Portland Trail Blazers,0022200065,2022-10-26T00:00:00Z,POR vs. MIA,98,-21,1610612748,MIA,Miami Heat,MIA @ POR,119,21,Regular Season
22022,1610612743,DEN,Denver Nuggets,0022200064,2022-10-26T00:00:00Z,DEN vs. LAL,110,11,1610612747,LAL,Los Angeles Lakers,LAL @ DEN,99,-11,Regular Season
22022,1610612739,CLE,Cleveland Cavaliers,0022200056,2022-10-26T00:00:00Z,CLE vs. ORL,103,11,1610612753,ORL,Orlando Magic,ORL @ CLE,92,-11,Regular Season
22022,1610612750,MIN,Minnesota Timberwolves,0022200062,2022-10-26T00:00:00Z,MIN vs. SAS,134,12,1610612759,SAS,San Antonio Spurs,SAS @ MIN,122,-12,Regular Season
22022,1610612749,MIL,Milwaukee Bucks,0022200060,2022-10-26T00:00:00Z,MIL vs. BKN,110,11,1610612751,BKN,Brooklyn Nets,BKN @ MIL,99,-11,Regular Season
22022,1610612741,CHI,Chicago Bulls,0022200061,2022-10-26T00:00:00Z,CHI vs. IND,124,15,1610612754,IND,Indiana Pacers,IND @ CHI,109,-15,Regular Season
22022,1610612765,DET,Detroit Pistons,0022200057,2022-10-26T00:00:00Z,DET vs. ATL,113,-5,1610612737,ATL,Atlanta Hawks,ATL @ DET,118,5,Regular Season
22022,1610612751,BKN,Brooklyn Nets,0022200066,2022-10-27T00:00:00Z,BKN vs. DAL,125,-4,1610612742,DAL,Dallas Mavericks,DAL @ BKN,129,4,Regular Season
22022,1610612758,SAC,Sacramento Kings,0022200069,2022-10-27T00:00:00Z,SAC vs. MEM,110,-15,1610612763,MEM,Memphis Grizzlies,MEM @ SAC,125,15,Regular Season
22022,1610612744,GSW,Golden State Warriors,0022200068,2022-10-27T00:00:00Z,GSW vs. MIA,123,13,1610612748,MIA,Miami Heat,MIA @ GSW,110,-13,Regular Season
22022,1610612760,OKC,Oklahoma City Thunder,0022200067,2022-10-27T00:00:00Z,OKC vs. LAC,118,8,1610612746,LAC,LA Clippers,LAC @ OKC,110,-8,Regular Season
22022,1610612750,MIN,Minnesota Timberwolves,0022200076,2022-10-28T00:00:00Z,MIN vs. LAL,111,9,1610612747,LAL,Los Angeles Lakers,LAL @ MIN,102,-9,Regular Season
22022,1610612759,SAS,San Antonio Spurs,0022200077,2022-10-28T00:00:00Z,SAS vs. CHI,129,5,1610612741,CHI,Chicago Bulls,CHI @ SAS,124,-5,Regular Season
22022,1610612743,DEN,Denver Nuggets,0022200078,2022-10-28T00:00:00Z,DEN vs. UTA,117,16,1610612762,UTA,Utah Jazz,UTA @ DEN,101,-16,Regular Season
22022,1610612753,ORL,Orlando Magic,0022200071,2022-10-28T00:00:00Z,ORL vs. CHA,113,20,1610612766,CHA,Charlotte Hornets,CHA @ ORL,93,-20,Regular Season
22022,1610612738,BOS,Boston Celtics,0022200072,2022-10-28T00:00:00Z,BOS vs. CLE,123,-9,1610612739,CLE,Cleveland Cavaliers,CLE @ BOS,132,9,Regular Season
22022,1610612764,WAS,Washington Wizards,0022200074,2022-10-28T00:00:00Z,WAS vs. IND,117,-10,1610612754,IND,Indiana Pacers,IND @ WAS,127,10,Regular Season
22022,1610612756,PHX,Phoenix Suns,0022200079,2022-10-28T00:00:00Z,PHX vs. NOP,124,13,1610612740,NOP,New Orleans Pelicans,NOP @ PHX,111,-13,Regular Season
22022,1610612757,POR,Portland Trail Blazers,0022200080,2022-10-28T00:00:00Z,POR vs. HOU,125,14,1610612745,HOU,Houston Rockets,HOU @ POR,111,-14,Regular Season
22022,1610612765,DET,Detroit Pistons,0022200070,2022-10-28T00:00:00Z,DET vs. ATL,112,-24,1610612737,ATL,Atlanta Hawks,ATL @ DET,136,24,Regular Season
22022,1610612761,TOR,Toronto Raptors,0022200073,2022-10-28T00:00:00Z,TOR vs. PHI,90,-22,1610612755,PHI,Philadelphia 76ers,PHI @ TOR,112,22,Regular Season
22022,1610612749,MIL,Milwaukee Bucks,0022200075,2022-10-28T00:00:00Z,MIL vs. NYK,119,11,1610612752,NYK,New York Knicks,NYK @ MIL,108,-11,Regular Season
22022,1610612766,CHA,Charlotte Hornets,0022200082,2022-10-29T00:00:00Z,CHA vs. GSW,120,7,1610612744,GSW,Golden State Warriors,GSW @ CHA,113,-7,Regular Season
22022,1610612749,MIL,Milwaukee Bucks,0022200085,2022-10-29T00:00:00Z,MIL vs. ATL,123,8,1610612737,ATL,Atlanta Hawks,ATL @ MIL,115,-8,Regular Season
22022,1610612758,SAC,Sacramento Kings,0022200081,2022-10-29T00:00:00Z,SAC vs. MIA,119,6,1610612748,MIA,Miami Heat,MIA @ SAC,113,-6,Regular Season
22022,1610612741,CHI,Chicago Bulls,0022200084,2022-10-29T00:00:00Z,CHI vs. PHI,109,-5,1610612755,PHI,Philadelphia 76ers,PHI @ CHI,114,5,Regular Season
22022,1610612762,UTA,Utah Jazz,0022200087,2022-10-29T00:00:00Z,UTA vs. MEM,124,1,1610612763,MEM,Memphis Grizzlies,MEM @ UTA,123,-1,Regular Season
22022,1610612742,DAL,Dallas Mavericks,0022200086,2022-10-29T00:00:00Z,DAL vs. OKC,111,-6,1610612760,OKC,Oklahoma City Thunder,OKC @ DAL,117,6,Regular Season
22022,1610612751,BKN,Brooklyn Nets,0022200083,2022-10-29T00:00:00Z,BKN vs. IND,116,-9,1610612754,IND,Indiana Pacers,IND @ BKN,125,9,Regular Season
22022,1610612739,CLE,Cleveland Cavaliers,0022200090,2022-10-30T00:00:00Z,CLE vs. NYK,121,13,1610612752,NYK,New York Knicks,NYK @ CLE,108,-13,Regular Season
22022,1610612765,DET,Detroit Pistons,0022200091,2022-10-30T00:00:00Z,DET vs. GSW,128,14,1610612744,GSW,Golden State Warriors,GSW @ DET,114,-14,Regular Season
22022,1610612756,PHX,Phoenix Suns,0022200094,2022-10-30T00:00:00Z,PHX vs. HOU,124,15,1610612745,HOU,Houston Rockets,HOU @ PHX,109,-15,Regular Season
22022,1610612738,BOS,Boston Celtics,0022200089,2022-10-30T00:00:00Z,BOS vs. WAS,112,18,1610612764,WAS,Washington Wizards,WAS @ BOS,94,-18,Regular Season
22022,1610612747,LAL,Los Angeles Lakers,0022200095,2022-10-30T00:00:00Z,LAL vs. DEN,121,11,1610612743,DEN,Denver Nuggets,DEN @ LAL,110,-11,Regular Season
22022,1610612742,DAL,Dallas Mavericks,0022200093,2022-10-30T00:00:00Z,DAL vs. ORL,114,9,1610612753,ORL,Orlando Magic,ORL @ DAL,105,-9,Regular Season
22022,1610612746,LAC,LA Clippers,0022200088,2022-10-30T00:00:00Z,LAC vs. NOP,91,-21,1610612740,NOP,New Orleans Pelicans,NOP @ LAC,112,21,Regular Season
22022,1610612759,SAS,San Antonio Spurs,0022200092,2022-10-30T00:00:00Z,SAS vs. MIN,107,9,1610612750,MIN,Minnesota Timberwolves,MIN @ SAS,98,-9,Regular Season
22022,1610612761,TOR,Toronto Raptors,0022200099,2022-10-31T00:00:00Z,TOR vs. ATL,139,30,1610612737,ATL,Atlanta Hawks,ATL @ TOR,109,-30,Regular Season
22022,1610612751,BKN,Brooklyn Nets,0022200098,2022-10-31T00:00:00Z,BKN vs. IND,116,7,1610612754,IND,Indiana Pacers,IND @ BKN,109,-7,Regular Season
22022,1610612762,UTA,Utah Jazz,0022200101,2022-10-31T00:00:00Z,UTA vs. MEM,121,16,1610612763,MEM,Memphis Grizzlies,MEM @ UTA,105,-16,Regular Season
22022,1610612749,MIL,Milwaukee Bucks,0022200100,2022-10-31T00:00:00Z,MIL vs. DET,110,2,1610612765,DET,Detroit Pistons,DET @ MIL,108,-2,Regular Season
22022,1610612746,LAC,LA Clippers,0022200102,2022-10-31T00:00:00Z,LAC vs. HOU,95,2,1610612745,HOU,Houston Rockets,HOU @ LAC,93,-2,Regular Season
22022,1610612764,WAS,Washington Wizards,0022200097,2022-10-31T00:00:00Z,WAS vs. PHI,111,-7,1610612755,PHI,Philadelphia 76ers,PHI @ WAS,118,7,Regular Season
22022,1610612766,CHA,Charlotte Hornets,0022200096,2022-10-31T00:00:00Z,CHA vs. SAC,108,-7,1610612758,SAC,Sacramento Kings,SAC @ CHA,115,7,Regular Season
22022,1610612756,PHX,Phoenix Suns,0022200106,2022-11-01T00:00:00Z,PHX vs. MIN,116,9,1610612750,MIN,Minnesota Timberwolves,MIN @ PHX,107,-9,Regular Season
22022,1610612760,OKC,Oklahoma City Thunder,0022200105,2022-11-01T00:00:00Z,OKC vs. ORL,116,8,1610612753,ORL,Orlando Magic,ORL @ OKC,108,-8,Regular Season
22022,1610612751,BKN,Brooklyn Nets,0022200103,2022-11-01T00:00:00Z,BKN vs. CHI,99,-9,1610612741,CHI,Chicago Bulls,CHI @ BKN,108,9,Regular Season
22022,1610612748,MIA,Miami Heat,0022200104,2022-11-01T00:00:00Z,MIA vs. GSW,116,7,1610612744,GSW,Golden State Warriors,GSW @ MIA,109,-7,Regular Season
22022,1610612755,PHI,Philadelphia 76ers,0022200108,2022-11-02T00:00:00Z,PHI vs. WAS,111,-10,1610612764,WAS,Washington Wizards,WAS @ PHI,121,10,Regular Season
22022,1610612747,LAL,Los Angeles Lakers,0022200117,2022-11-02T00:00:00Z,LAL vs. NOP,120,3,1610612740,NOP,New Orleans Pelicans,NOP @ LAL,117,-3,Regular Season
22022,1610612745,HOU,Houston Rockets,0022200112,2022-11-02T00:00:00Z,HOU vs. LAC,101,-8,1610612746,LAC,LA Clippers,LAC @ HOU,109,8,Regular Season
22022,1610612757,POR,Portland Trail Blazers,0022200116,2022-11-02T00:00:00Z,POR vs. MEM,106,-5,1610612763,MEM,Memphis Grizzlies,MEM @ POR,111,5,Regular Season
22022,1610612752,NYK,New York Knicks,0022200110,2022-11-02T00:00:00Z,NYK vs. ATL,99,-13,1610612737,ATL,Atlanta Hawks,ATL @ NYK,112,13,Regular Season
22022,1610612742,DAL,Dallas Mavericks,0022200115,2022-11-02T00:00:00Z,DAL vs. UTA,103,3,1610612762,UTA,Utah Jazz,UTA @ DAL,100,-3,Regular Season
22022,1610612741,CHI,Chicago Bulls,0022200111,2022-11-02T00:00:00Z,CHI vs. CHA,106,18,1610612766,CHA,Charlotte Hornets,CHA @ CHI,88,-18,Regular Season
22022,1610612739,CLE,Cleveland Cavaliers,0022200107,2022-11-02T00:00:00Z,CLE vs. BOS,114,1,1610612738,BOS,Boston Celtics,BOS @ CLE,113,-1,Regular Season
22022,1610612749,MIL,Milwaukee Bucks,0022200113,2022-11-02T00:00:00Z,MIL vs. DET,116,25,1610612765,DET,Detroit Pistons,DET @ MIL,91,-25,Regular Season
22022,1610612748,MIA,Miami Heat,0022200109,2022-11-02T00:00:00Z,MIA vs. SAC,110,3,1610612758,SAC,Sacramento Kings,SAC @ MIA,107,-3,Regular Season
22022,1610612759,SAS,San Antonio Spurs,0022200114,2022-11-02T00:00:00Z,SAS vs. TOR,100,-43,1610612761,TOR,Toronto Raptors,TOR @ SAS,143,43,Regular Season
22022,1610612760,OKC,Oklahoma City Thunder,0022200119,2022-11-03T00:00:00Z,OKC vs. DEN,110,-12,1610612743,DEN,Denver Nuggets,DEN @ OKC,122,12,Regular Season
22022,1610612753,ORL,Orlando Magic,0022200118,2022-11-03T00:00:00Z,ORL vs. GSW,130,1,1610612744,GSW,Golden State Warriors,GSW @ ORL,129,-1,Regular Season
22022,1610612764,WAS,Washington Wizards,0022200123,2022-11-04T00:00:00Z,WAS vs. BKN,86,-42,1610612751,BKN,Brooklyn Nets,BKN @ WAS,128,42,Regular Season
22022,1610612759,SAS,San Antonio Spurs,0022200126,2022-11-04T00:00:00Z,SAS vs. LAC,106,-7,1610612746,LAC,LA Clippers,LAC @ SAS,113,7,Regular Season
22022,1610612747,LAL,Los Angeles Lakers,0022200131,2022-11-04T00:00:00Z,LAL vs. UTA,116,-14,1610612762,UTA,Utah Jazz,UTA @ LAL,130,14,Regular Season
22022,1610612738,BOS,Boston Celtics,0022200124,2022-11-04T00:00:00Z,BOS vs. CHI,123,4,1610612741,CHI,Chicago Bulls,CHI @ BOS,119,-4,Regular Season
22022,1610612750,MIN,Minnesota Timberwolves,0022200129,2022-11-04T00:00:00Z,MIN vs. MIL,102,-13,1610612749,MIL,Milwaukee Bucks,MIL @ MIN,115,13,Regular Season
22022,1610612763,MEM,Memphis Grizzlies,0022200125,2022-11-04T00:00:00Z,MEM vs. CHA,130,31,1610612766,CHA,Charlotte Hornets,CHA @ MEM,99,-31,Regular Season
22022,1610612756,PHX,Phoenix Suns,0022200130,2022-11-04T00:00:00Z,PHX vs. POR,106,-2,1610612757,POR,Portland Trail Blazers,POR @ PHX,108,2,Regular Season
22022,1610612740,NOP,New Orleans Pelicans,0022200128,2022-11-04T00:00:00Z,NOP vs. GSW,114,9,1610612744,GSW,Golden State Warriors,GSW @ NOP,105,-9,Regular Season
22022,1610612742,DAL,Dallas Mavericks,0022200127,2022-11-04T00:00:00Z,DAL vs. TOR,111,1,1610612761,TOR,Toronto Raptors,TOR @ DAL,110,-1,Regular Season
22022,1610612754,IND,Indiana Pacers,0022200121,2022-11-04T00:00:00Z,IND vs. MIA,101,2,1610612748,MIA,Miami Heat,MIA @ IND,99,-2,Regular Season
22022,1610612755,PHI,Philadelphia 76ers,0022200122,2022-11-04T00:00:00Z,PHI vs. NYK,104,-2,1610612752,NYK,New York Knicks,NYK @ PHI,106,2,Regular Season
22022,1610612765,DET,Detroit Pistons,0022200120,2022-11-04T00:00:00Z,DET vs. CLE,88,-24,1610612739,CLE,Cleveland Cavaliers,CLE @ DET,112,24,Regular Season
22022,1610612750,MIN,Minnesota Timberwolves,0022200137,2022-11-05T00:00:00Z,MIN vs. HOU,129,12,1610612745,HOU,Houston Rockets,HOU @ MIN,117,-12,Regular Season
22022,1610612737,ATL,Atlanta Hawks,0022200134,2022-11-05T00:00:00Z,ATL vs. NOP,124,3,1610612740,NOP,New Orleans Pelicans,NOP @ ATL,121,-3,Regular Season
22022,1610612749,MIL,Milwaukee Bucks,0022200136,2022-11-05T00:00:00Z,MIL vs. OKC,108,14,1610612760,OKC,Oklahoma City Thunder,OKC @ MIL,94,-14,Regular Season
22022,1610612752,NYK,New York Knicks,0022200135,2022-11-05T00:00:00Z,NYK vs. BOS,118,-15,1610612738,BOS,Boston Celtics,BOS @ NYK,133,15,Regular Season
22022,1610612753,ORL,Orlando Magic,0022200132,2022-11-05T00:00:00Z,ORL vs. SAC,123,-3,1610612758,SAC,Sacramento Kings,SAC @ ORL,126,3,Regular Season
22022,1610612766,CHA,Charlotte Hornets,0022200133,2022-11-05T00:00:00Z,CHA vs. BKN,94,-4,1610612751,BKN,Brooklyn Nets,BKN @ CHA,98,4,Regular Season
22022,1610612743,DEN,Denver Nuggets,0022200138,2022-11-05T00:00:00Z,DEN vs. SAS,126,25,1610612759,SAS,San Antonio Spurs,SAS @ DEN,101,-25,Regular Season
22022,1610612756,PHX,Phoenix Suns,0022200139,2022-11-05T00:00:00Z,PHX vs. POR,102,20,1610612757,POR,Portland Trail Blazers,POR @ PHX,82,-20,Regular Season
22022,1610612746,LAC,LA Clippers,0022200143,2022-11-06T00:00:00Z,LAC vs. UTA,102,-8,1610612762,UTA,Utah Jazz,UTA @ LAC,110,8,Regular Season
22022,1610612761,TOR,Toronto Raptors,0022200141,2022-11-06T00:00:00Z,TOR vs. CHI,113,9,1610612741,CHI,Chicago Bulls,CHI @ TOR,104,-9,Regular Season
22022,1610612747,LAL,Los Angeles Lakers,0022200140,2022-11-06T00:00:00Z,LAL vs. CLE,100,-14,1610612739,CLE,Cleveland Cavaliers,CLE @ LAL,114,14,Regular Season
22022,1610612763,MEM,Memphis Grizzlies,0022200142,2022-11-06T00:00:00Z,MEM vs. WAS,103,6,1610612764,WAS,Washington Wizards,WAS @ MEM,97,-6,Regular Season
22022,1610612742,DAL,Dallas Mavericks,0022200155,2022-11-07T00:00:00Z,DAL vs. BKN,96,2,1610612751,BKN,Brooklyn Nets,BKN @ DAL,94,-2,Regular Season
22022,1610612759,SAS,San Antonio Spurs,0022200154,2022-11-07T00:00:00Z,SAS vs. DEN,109,-6,1610612743,DEN,Denver Nuggets,DEN @ SAS,115,6,Regular Season
22022,1610612744,GSW,Golden State Warriors,0022200156,2022-11-07T00:00:00Z,GSW vs. SAC,116,3,1610612758,SAC,Sacramento Kings,SAC @ GSW,113,-3,Regular Season
22022,1610612755,PHI,Philadelphia 76ers,0022200148,2022-11-07T00:00:00Z,PHI vs. PHX,100,12,1610612756,PHX,Phoenix Suns,PHX @ PHI,88,-12,Regular Season
22022,1610612750,MIN,Minnesota Timberwolves,0022200153,2022-11-07T00:00:00Z,MIN vs. NYK,107,-13,1610612752,NYK,New York Knicks,NYK @ MIN,120,13,Regular Season
22022,1610612748,MIA,Miami Heat,0022200150,2022-11-07T00:00:00Z,MIA vs. POR,107,-3,1610612757,POR,Portland Trail Blazers,POR @ MIA,110,3,Regular Season
22022,1610612766,CHA,Charlotte Hornets,0022200144,2022-11-07T00:00:00Z,CHA vs. WAS,100,-8,1610612764,WAS,Washington Wizards,WAS @ CHA,108,8,Regular Season
22022,1610612754,IND,Indiana Pacers,0022200147,2022-11-07T00:00:00Z,IND vs. NOP,129,7,1610612740,NOP,New Orleans Pelicans,NOP @ IND,122,-7,Regular Season
22022,1610612762,UTA,Utah Jazz,0022200157,2022-11-07T00:00:00Z,UTA vs. LAL,139,23,1610612747,LAL,Los Angeles Lakers,LAL @ UTA,116,-23,Regular Season
22022,1610612753,ORL,Orlando Magic,0022200145,2022-11-07T00:00:00Z,ORL vs. HOU,127,-7,1610612745,HOU,Houston Rockets,HOU @ ORL,134,7,Regular Season
22022,1610612763,MEM,Memphis Grizzlies,0022200152,2022-11-07T00:00:00Z,MEM vs. BOS,106,-3,1610612738,BOS,Boston Celtics,BOS @ MEM,109,3,Regular Season
22022,1610612737,ATL,Atlanta Hawks,0022200149,2022-11-07T00:00:00Z,ATL vs. MIL,117,19,1610612749,MIL,Milwaukee Bucks,MIL @ ATL,98,-19,Regular Season
22022,1610612741,CHI,Chicago Bulls,0022200151,2022-11-07T00:00:00Z,CHI vs. TOR,111,14,1610612761,TOR,Toronto Raptors,TOR @ CHI,97,-14,Regular Season
22022,1610612765,DET,Detroit Pistons,0022200146,2022-11-07T00:00:00Z,DET vs. OKC,112,9,1610612760,OKC,Oklahoma City Thunder,OKC @ DET,103,-9,Regular Season
22022,1610612746,LAC,LA Clippers,0022200158,2022-11-07T00:00:00Z,LAC vs. CLE,119,2,1610612739,CLE,Cleveland Cavaliers,CLE @ LAC,117,-2,Regular Season
22022,1610612737,ATL,Atlanta Hawks,0022200162,2022-11-09T00:00:00Z,ATL vs. UTA,119,-6,1610612762,UTA,Utah Jazz,UTA @ ATL,125,6,Regular Season
22022,1610612746,LAC,LA Clippers,0022200170,2022-11-09T00:00:00Z,LAC vs. LAL,114,13,1610612747,LAL,Los Angeles Lakers,LAL @ LAC,101,-13,Regular Season
22022,1610612741,CHI,Chicago Bulls,0022200166,2022-11-09T00:00:00Z,CHI vs. NOP,111,-4,1610612740,NOP,New Orleans Pelicans,NOP @ CHI,115,4,Regular Season
22022,1610612753,ORL,Orlando Magic,0022200161,2022-11-09T00:00:00Z,ORL vs. DAL,94,7,1610612742,DAL,Dallas Mavericks,DAL @ ORL,87,-7,Regular Season
22022,1610612758,SAC,Sacramento Kings,0022200171,2022-11-09T00:00:00Z,SAC vs. CLE,127,7,1610612739,CLE,Cleveland Cavaliers,CLE @ SAC,120,-7,Regular Season
22022,1610612766,CHA,Charlotte Hornets,0022200159,2022-11-09T00:00:00Z,CHA vs. POR,95,-10,1610612757,POR,Portland Trail Blazers,POR @ CHA,105,10,Regular Season
22022,1610612760,OKC,Oklahoma City Thunder,0022200168,2022-11-09T00:00:00Z,OKC vs. MIL,132,-4,1610612749,MIL,Milwaukee Bucks,MIL @ OKC,136,4,Regular Season
22022,1610612759,SAS,San Antonio Spurs,0022200169,2022-11-09T00:00:00Z,SAS vs. MEM,122,-2,1610612763,MEM,Memphis Grizzlies,MEM @ SAS,124,2,Regular Season
22022,1610612750,MIN,Minnesota Timberwolves,0022200167,2022-11-09T00:00:00Z,MIN vs. PHX,117,-12,1610612756,PHX,Phoenix Suns,PHX @ MIN,129,12,Regular Season
22022,1610612738,BOS,Boston Celtics,0022200163,2022-11-09T00:00:00Z,BOS vs. DET,128,16,1610612765,DET,Detroit Pistons,DET @ BOS,112,-16,Regular Season
22022,1610612761,TOR,Toronto Raptors,0022200165,2022-11-09T00:00:00Z,TOR vs. HOU,116,7,1610612745,HOU,Houston Rockets,HOU @ TOR,109,-7,Regular Season
22022,1610612751,BKN,Brooklyn Nets,0022200164,2022-11-09T00:00:00Z,BKN vs. NYK,112,27,1610612752,NYK,New York Knicks,NYK @ BKN,85,-27,Regular Season
22022,1610612754,IND,Indiana Pacers,0022200160,2022-11-09T00:00:00Z,IND vs. DEN,119,-3,1610612743,DEN,Denver Nuggets,DEN @ IND,122,3,Regular Season
22022,1610612764,WAS,Washington Wizards,0022200172,2022-11-10T00:00:00Z,WAS vs. DAL,113,8,1610612742,DAL,Dallas Mavericks,DAL @ WAS,105,-8,Regular Season
22022,1610612737,ATL,Atlanta Hawks,0022200173,2022-11-10T00:00:00Z,ATL vs. PHI,104,9,1610612755,PHI,Philadelphia 76ers,PHI @ ATL,95,-9,Regular Season
22022,1610612740,NOP,New Orleans Pelicans,0022200175,2022-11-10T00:00:00Z,NOP vs. POR,95,-11,1610612757,POR,Portland Trail Blazers,POR @ NOP,106,11,Regular Season
22022,1610612748,MIA,Miami Heat,0022200174,2022-11-10T00:00:00Z,MIA vs. CHA,117,5,1610612766,CHA,Charlotte Hornets,CHA @ MIA,112,-5,Regular Season
22022,1610612753,ORL,Orlando Magic,0022200177,2022-11-11T00:00:00Z,ORL vs. PHX,114,17,1610612756,PHX,Phoenix Suns,PHX @ ORL,97,-17,Regular Season
22022,1610612744,GSW,Golden State Warriors,0022200182,2022-11-11T00:00:00Z,GSW vs. CLE,106,5,1610612739,CLE,Cleveland Cavaliers,CLE @ GSW,101,-5,Regular Season
22022,1610612752,NYK,New York Knicks,0022200178,2022-11-11T00:00:00Z,NYK vs. DET,121,9,1610612765,DET,Detroit Pistons,DET @ NYK,112,-9,Regular Season
22022,1610612738,BOS,Boston Celtics,0022200176,2022-11-11T00:00:00Z,BOS vs. DEN,131,19,1610612743,DEN,Denver Nuggets,DEN @ BOS,112,-19,Regular Season
22022,1610612760,OKC,Oklahoma City Thunder,0022200179,2022-11-11T00:00:00Z,OKC vs. TOR,132,19,1610612761,TOR,Toronto Raptors,TOR @ OKC,113,-19,Regular Season
22022,1610612759,SAS,San Antonio Spurs,0022200180,2022-11-11T00:00:00Z,SAS vs. MIL,111,18,1610612749,MIL,Milwaukee Bucks,MIL @ SAS,93,-18,Regular Season
22022,1610612747,LAL,Los Angeles Lakers,0022200183,2022-11-11T00:00:00Z,LAL vs. SAC,114,-6,1610612758,SAC,Sacramento Kings,SAC @ LAL,120,6,Regular Season
22022,1610612763,MEM,Memphis Grizzlies,0022200181,2022-11-11T00:00:00Z,MEM vs. MIN,114,11,1610612750,MIN,Minnesota Timberwolves,MIN @ MEM,103,-11,Regular Season
22022,1610612765,DET,Detroit Pistons,0022200186,2022-11-12T00:00:00Z,DET vs. BOS,108,-9,1610612738,BOS,Boston Celtics,BOS @ DET,117,9,Regular Season
22022,1610612754,IND,Indiana Pacers,0022200187,2022-11-12T00:00:00Z,IND vs. TOR,118,14,1610612761,TOR,Toronto Raptors,TOR @ IND,104,-14,Regular Season
22022,1610612764,WAS,Washington Wizards,0022200185,2022-11-12T00:00:00Z,WAS vs. UTA,121,9,1610612762,UTA,Utah Jazz,UTA @ WAS,112,-9,Regular Season
22022,1610612742,DAL,Dallas Mavericks,0022200190,2022-11-12T00:00:00Z,DAL vs. POR,117,5,1610612757,POR,Portland Trail Blazers,POR @ DAL,112,-5,Regular Season
22022,1610612740,NOP,New Orleans Pelicans,0022200191,2022-11-12T00:00:00Z,NOP vs. HOU,119,13,1610612745,HOU,Houston Rockets,HOU @ NOP,106,-13,Regular Season
22022,1610612748,MIA,Miami Heat,0022200189,2022-11-12T00:00:00Z,MIA vs. CHA,132,17,1610612766,CHA,Charlotte Hornets,CHA @ MIA,115,-17,Regular Season
22022,1610612746,LAC,LA Clippers,0022200184,2022-11-12T00:00:00Z,LAC vs. BKN,95,-15,1610612751,BKN,Brooklyn Nets,BKN @ LAC,110,15,Regular Season
22022,1610612755,PHI,Philadelphia 76ers,0022200188,2022-11-12T00:00:00Z,PHI vs. ATL,121,12,1610612737,ATL,Atlanta Hawks,ATL @ PHI,109,-12,Regular Season
22022,1610612758,SAC,Sacramento Kings,0022200197,2022-11-13T00:00:00Z,SAC vs. GSW,122,7,1610612744,GSW,Golden State Warriors,GSW @ SAC,115,-7,Regular Season
22022,1610612741,CHI,Chicago Bulls,0022200196,2022-11-13T00:00:00Z,CHI vs. DEN,103,-23,1610612743,DEN,Denver Nuggets,DEN @ CHI,126,23,Regular Season
22022,1610612739,CLE,Cleveland Cavaliers,0022200193,2022-11-13T00:00:00Z,CLE vs. MIN,124,-5,1610612750,MIN,Minnesota Timberwolves,MIN @ CLE,129,5,Regular Season
22022,1610612747,LAL,Los Angeles Lakers,0022200198,2022-11-13T00:00:00Z,LAL vs. BKN,116,13,1610612751,BKN,Brooklyn Nets,BKN @ LAL,103,-13,Regular Season
22022,1610612752,NYK,New York Knicks,0022200192,2022-11-13T00:00:00Z,NYK vs. OKC,135,-10,1610612760,OKC,Oklahoma City Thunder,OKC @ NYK,145,10,Regular Season
22022,1610612755,PHI,Philadelphia 76ers,0022200195,2022-11-13T00:00:00Z,PHI vs. UTA,105,7,1610612762,UTA,Utah Jazz,UTA @ PHI,98,-7,Regular Season
22022,1610612764,WAS,Washington Wizards,0022200194,2022-11-13T00:00:00Z,WAS vs. MEM,102,10,1610612763,MEM,Memphis Grizzlies,MEM @ WAS,92,-10,Regular Season
22022,1610612753,ORL,Orlando Magic,0022200200,2022-11-14T00:00:00Z,ORL vs. CHA,105,-7,1610612766,CHA,Charlotte Hornets,CHA @ ORL,112,7,Regular Season
22022,1610612744,GSW,Golden State Warriors,0022200205,2022-11-14T00:00:00Z,GSW vs. SAS,132,37,1610612759,SAS,San Antonio Spurs,SAS @ GSW,95,-37,Regular Season
22022,1610612745,HOU,Houston Rockets,0022200203,2022-11-14T00:00:00Z,HOU vs. LAC,106,-16,1610612746,LAC,LA Clippers,LAC @ HOU,122,16,Regular Season
22022,1610612738,BOS,Boston Celtics,0022200201,2022-11-14T00:00:00Z,BOS vs. OKC,126,4,1610612760,OKC,Oklahoma City Thunder,OKC @ BOS,122,-4,Regular Season
22022,1610612765,DET,Detroit Pistons,0022200199,2022-11-14T00:00:00Z,DET vs. TOR,111,-4,1610612761,TOR,Toronto Raptors,TOR @ DET,115,4,Regular Season
22022,1610612748,MIA,Miami Heat,0022200202,2022-11-14T00:00:00Z,MIA vs. PHX,113,1,1610612756,PHX,Phoenix Suns,PHX @ MIA,112,-1,Regular Season
22022,1610612749,MIL,Milwaukee Bucks,0022200204,2022-11-14T00:00:00Z,MIL vs. ATL,106,-15,1610612737,ATL,Atlanta Hawks,ATL @ MIL,121,15,Regular Season
22022,1610612740,NOP,New Orleans Pelicans,0022200206,2022-11-15T00:00:00Z,NOP vs. MEM,113,11,1610612763,MEM,Memphis Grizzlies,MEM @ NOP,102,-11,Regular Season
22022,1610612742,DAL,Dallas Mavericks,0022200207,2022-11-15T00:00:00Z,DAL vs. LAC,103,2,1610612746,LAC,LA Clippers,LAC @ DAL,101,-2,Regular Season
22022,1610612758,SAC,Sacramento Kings,0022200210,2022-11-15T00:00:00Z,SAC vs. BKN,153,32,1610612751,BKN,Brooklyn Nets,BKN @ SAC,121,-32,Regular Season
22022,1610612757,POR,Portland Trail Blazers,0022200209,2022-11-15T00:00:00Z,POR vs. SAS,117,7,1610612759,SAS,San Antonio Spurs,SAS @ POR,110,-7,Regular Season
22022,1610612762,UTA,Utah Jazz,0022200208,2022-11-15T00:00:00Z,UTA vs. NYK,111,-7,1610612752,NYK,New York Knicks,NYK @ UTA,118,7,Regular Season
22022,1610612764,WAS,Washington Wizards,0022200213,2022-11-16T00:00:00Z,WAS vs. OKC,120,-1,1610612760,OKC,Oklahoma City Thunder,OKC @ WAS,121,1,Regular Season
22022,1610612766,CHA,Charlotte Hornets,0022200211,2022-11-16T00:00:00Z,CHA vs. IND,113,-12,1610612754,IND,Indiana Pacers,IND @ CHA,125,12,Regular Season
22022,1610612753,ORL,Orlando Magic,0022200212,2022-11-16T00:00:00Z,ORL vs. MIN,108,-18,1610612750,MIN,Minnesota Timberwolves,MIN @ ORL,126,18,Regular Season
22022,1610612737,ATL,Atlanta Hawks,0022200214,2022-11-16T00:00:00Z,ATL vs. BOS,101,-25,1610612738,BOS,Boston Celtics,BOS @ ATL,126,25,Regular Season
22022,1610612756,PHX,Phoenix Suns,0022200220,2022-11-16T00:00:00Z,PHX vs. GSW,130,11,1610612744,GSW,Golden State Warriors,GSW @ PHX,119,-11,Regular Season
22022,1610612743,DEN,Denver Nuggets,0022200219,2022-11-16T00:00:00Z,DEN vs. NYK,103,-3,1610612752,NYK,New York Knicks,NYK @ DEN,106,3,Regular Season
22022,1610612742,DAL,Dallas Mavericks,0022200218,2022-11-16T00:00:00Z,DAL vs. HOU,92,-9,1610612745,HOU,Houston Rockets,HOU @ DAL,101,9,Regular Season
22022,1610612740,NOP,New Orleans Pelicans,0022200217,2022-11-16T00:00:00Z,NOP vs. CHI,124,14,1610612741,CHI,Chicago Bulls,CHI @ NOP,110,-14,Regular Season
22022,1610612749,MIL,Milwaukee Bucks,0022200216,2022-11-16T00:00:00Z,MIL vs. CLE,113,15,1610612739,CLE,Cleveland Cavaliers,CLE @ MIL,98,-15,Regular Season
22022,1610612761,TOR,Toronto Raptors,0022200215,2022-11-16T00:00:00Z,TOR vs. MIA,112,8,1610612748,MIA,Miami Heat,MIA @ TOR,104,-8,Regular Season
22022,1610612757,POR,Portland Trail Blazers,0022200221,2022-11-17T00:00:00Z,POR vs. BKN,107,-2,1610612751,BKN,Brooklyn Nets,BKN @ POR,109,2,Regular Season
22022,1610612758,SAC,Sacramento Kings,0022200222,2022-11-17T00:00:00Z,SAC vs. SAS,130,18,1610612759,SAS,San Antonio Spurs,SAS @ SAC,112,-18,Regular Season
22022,1610612746,LAC,LA Clippers,0022200223,2022-11-17T00:00:00Z,LAC vs. DET,96,5,1610612765,DET,Detroit Pistons,DET @ LAC,91,-5,Regular Season
22022,1610612755,PHI,Philadelphia 76ers,0022200226,2022-11-18T00:00:00Z,PHI vs. MIL,110,8,1610612749,MIL,Milwaukee Bucks,MIL @ PHI,102,-8,Regular Season
22022,1610612740,NOP,New Orleans Pelicans,0022200231,2022-11-18T00:00:00Z,NOP vs. BOS,109,-8,1610612738,BOS,Boston Celtics,BOS @ NOP,117,8,Regular Season
22022,1610612763,MEM,Memphis Grizzlies,0022200229,2022-11-18T00:00:00Z,MEM vs. OKC,121,11,1610612760,OKC,Oklahoma City Thunder,OKC @ MEM,110,-11,Regular Season
22022,1610612741,CHI,Chicago Bulls,0022200227,2022-11-18T00:00:00Z,CHI vs. ORL,107,-1,1610612753,ORL,Orlando Magic,ORL @ CHI,108,1,Regular Season
22022,1610612745,HOU,Houston Rockets,0022200228,2022-11-18T00:00:00Z,HOU vs. IND,91,-8,1610612754,IND,Indiana Pacers,IND @ HOU,99,8,Regular Season
22022,1610612742,DAL,Dallas Mavericks,0022200230,2022-11-18T00:00:00Z,DAL vs. DEN,127,28,1610612743,DEN,Denver Nuggets,DEN @ DAL,99,-28,Regular Season
22022,1610612762,UTA,Utah Jazz,0022200232,2022-11-18T00:00:00Z,UTA vs. PHX,134,1,1610612756,PHX,Phoenix Suns,PHX @ UTA,133,-1,Regular Season
22022,1610612744,GSW,Golden State Warriors,0022200233,2022-11-18T00:00:00Z,GSW vs. NYK,111,10,1610612752,NYK,New York Knicks,NYK @ GSW,101,-10,Regular Season
22022,1610612747,LAL,Los Angeles Lakers,0022200234,2022-11-18T00:00:00Z,LAL vs. DET,128,7,1610612765,DET,Detroit Pistons,DET @ LAL,121,-7,Regular Season
22022,1610612764,WAS,Washington Wizards,0022200224,2022-11-18T00:00:00Z,WAS vs. MIA,107,1,1610612748,MIA,Miami Heat,MIA @ WAS,106,-1,Regular Season
22022,1610612739,CLE,Cleveland Cavaliers,0022200225,2022-11-18T00:00:00Z,CLE vs. CHA,132,10,1610612766,CHA,Charlotte Hornets,CHA @ CLE,122,-10,Regular Season
22022,1610612754,IND,Indiana Pacers,0022200236,2022-11-19T00:00:00Z,IND vs. ORL,114,1,1610612753,ORL,Orlando Magic,ORL @ IND,113,-1,Regular Season
22022,1610612737,ATL,Atlanta Hawks,0022200235,2022-11-19T00:00:00Z,ATL vs. TOR,124,2,1610612761,TOR,Toronto Raptors,TOR @ ATL,122,-2,Regular Season
22022,1610612755,PHI,Philadelphia 76ers,0022200237,2022-11-19T00:00:00Z,PHI vs. MIN,109,-3,1610612750,MIN,Minnesota Timberwolves,MIN @ PHI,112,3,Regular Season
22022,1610612757,POR,Portland Trail Blazers,0022200238,2022-11-19T00:00:00Z,POR vs. UTA,113,-5,1610612762,UTA,Utah Jazz,UTA @ POR,118,5,Regular Season
22022,1610612746,LAC,LA Clippers,0022200239,2022-11-19T00:00:00Z,LAC vs. SAS,119,22,1610612759,SAS,San Antonio Spurs,SAS @ LAC,97,-22,Regular Season
22022,1610612751,BKN,Brooklyn Nets,0022200243,2022-11-20T00:00:00Z,BKN vs. MEM,127,12,1610612763,MEM,Memphis Grizzlies,MEM @ BKN,115,-12,Regular Season
22022,1610612745,HOU,Houston Rockets,0022200245,2022-11-20T00:00:00Z,HOU vs. GSW,120,-7,1610612744,GSW,Golden State Warriors,GSW @ HOU,127,7,Regular Season
22022,1610612764,WAS,Washington Wizards,0022200241,2022-11-20T00:00:00Z,WAS vs. CHA,106,4,1610612766,CHA,Charlotte Hornets,CHA @ WAS,102,-4,Regular Season
22022,1610612742,DAL,Dallas Mavericks,0022200246,2022-11-20T00:00:00Z,DAL vs. DEN,97,-1,1610612743,DEN,Denver Nuggets,DEN @ DAL,98,1,Regular Season
22022,1610612747,LAL,Los Angeles Lakers,0022200247,2022-11-20T00:00:00Z,LAL vs. SAS,123,31,1610612759,SAS,San Antonio Spurs,SAS @ LAL,92,-31,Regular Season
22022,1610612758,SAC,Sacramento Kings,0022200242,2022-11-20T00:00:00Z,SAC vs. DET,137,8,1610612765,DET,Detroit Pistons,DET @ SAC,129,-8,Regular Season
22022,1610612756,PHX,Phoenix Suns,0022200240,2022-11-20T00:00:00Z,PHX vs. NYK,116,21,1610612752,NYK,New York Knicks,NYK @ PHX,95,-21,Regular Season
22022,1610612739,CLE,Cleveland Cavaliers,0022200244,2022-11-20T00:00:00Z,CLE vs. MIA,113,26,1610612748,MIA,Miami Heat,MIA @ CLE,87,-26,Regular Season
22022,1610612739,CLE,Cleveland Cavaliers,0022200248,2022-11-21T00:00:00Z,CLE vs. ATL,114,12,1610612737,ATL,Atlanta Hawks,ATL @ CLE,102,-12,Regular Season
22022,1610612754,IND,Indiana Pacers,0022200249,2022-11-21T00:00:00Z,IND vs. ORL,123,21,1610612753,ORL,Orlando Magic,ORL @ IND,102,-21,Regular Season
22022,1610612740,NOP,New Orleans Pelicans,0022200253,2022-11-21T00:00:00Z,NOP vs. GSW,128,45,1610612744,GSW,Golden State Warriors,GSW @ NOP,83,-45,Regular Season
22022,1610612750,MIN,Minnesota Timberwolves,0022200252,2022-11-21T00:00:00Z,MIN vs. MIA,105,4,1610612748,MIA,Miami Heat,MIA @ MIN,101,-4,Regular Season
22022,1610612760,OKC,Oklahoma City Thunder,0022200254,2022-11-21T00:00:00Z,OKC vs. NYK,119,-10,1610612752,NYK,New York Knicks,NYK @ OKC,129,10,Regular Season
22022,1610612749,MIL,Milwaukee Bucks,0022200251,2022-11-21T00:00:00Z,MIL vs. POR,119,8,1610612757,POR,Portland Trail Blazers,POR @ MIL,111,-8,Regular Season
22022,1610612746,LAC,LA Clippers,0022200255,2022-11-21T00:00:00Z,LAC vs. UTA,121,7,1610612762,UTA,Utah Jazz,UTA @ LAC,114,-7,Regular Season
22022,1610612741,CHI,Chicago Bulls,0022200250,2022-11-21T00:00:00Z,CHI vs. BOS,121,14,1610612738,BOS,Boston Celtics,BOS @ CHI,107,-14,Regular Season
22022,1610612763,MEM,Memphis Grizzlies,0022200257,2022-11-22T00:00:00Z,MEM vs. SAC,109,-4,1610612758,SAC,Sacramento Kings,SAC @ MEM,113,4,Regular Season
22022,1610612743,DEN,Denver Nuggets,0022200258,2022-11-22T00:00:00Z,DEN vs. DET,108,-2,1610612765,DET,Detroit Pistons,DET @ DEN,110,2,Regular Season
22022,1610612756,PHX,Phoenix Suns,0022200259,2022-11-22T00:00:00Z,PHX vs. LAL,115,10,1610612747,LAL,Los Angeles Lakers,LAL @ PHX,105,-10,Regular Season
22022,1610612755,PHI,Philadelphia 76ers,0022200256,2022-11-22T00:00:00Z,PHI vs. BKN,115,9,1610612751,BKN,Brooklyn Nets,BKN @ PHI,106,-9,Regular Season
22022,1610612759,SAS,San Antonio Spurs,0022200269,2022-11-23T00:00:00Z,SAS vs. NOP,110,-19,1610612740,NOP,New Orleans Pelicans,NOP @ SAS,129,19,Regular Season
22022,1610612739,CLE,Cleveland Cavaliers,0022200261,2022-11-23T00:00:00Z,CLE vs. POR,114,18,1610612757,POR,Portland Trail Blazers,POR @ CLE,96,-18,Regular Season
22022,1610612749,MIL,Milwaukee Bucks,0022200267,2022-11-23T00:00:00Z,MIL vs. CHI,113,-5,1610612741,CHI,Chicago Bulls,CHI @ MIL,118,5,Regular Season
22022,1610612766,CHA,Charlotte Hornets,0022200260,2022-11-23T00:00:00Z,CHA vs. PHI,107,6,1610612755,PHI,Philadelphia 76ers,PHI @ CHA,101,-6,Regular Season
22022,1610612761,TOR,Toronto Raptors,0022200266,2022-11-23T00:00:00Z,TOR vs. BKN,98,-14,1610612751,BKN,Brooklyn Nets,BKN @ TOR,112,14,Regular Season
22022,1610612754,IND,Indiana Pacers,0022200262,2022-11-23T00:00:00Z,IND vs. MIN,101,-14,1610612750,MIN,Minnesota Timberwolves,MIN @ IND,115,14,Regular Season
22022,1610612760,OKC,Oklahoma City Thunder,0022200268,2022-11-23T00:00:00Z,OKC vs. DEN,126,-5,1610612743,DEN,Denver Nuggets,DEN @ OKC,131,5,Regular Season
22022,1610612737,ATL,Atlanta Hawks,0022200263,2022-11-23T00:00:00Z,ATL vs. SAC,115,9,1610612758,SAC,Sacramento Kings,SAC @ ATL,106,-9,Regular Season
22022,1610612738,BOS,Boston Celtics,0022200264,2022-11-23T00:00:00Z,BOS vs. DAL,125,13,1610612742,DAL,Dallas Mavericks,DAL @ BOS,112,-13,Regular Season
22022,1610612762,UTA,Utah Jazz,0022200270,2022-11-23T00:00:00Z,UTA vs. DET,116,-9,1610612765,DET,Detroit Pistons,DET @ UTA,125,9,Regular Season
22022,1610612748,MIA,Miami Heat,0022200265,2022-11-23T00:00:00Z,MIA vs. WAS,113,8,1610612764,WAS,Washington Wizards,WAS @ MIA,105,-8,Regular Season
22022,1610612744,GSW,Golden State Warriors,0022200271,2022-11-23T00:00:00Z,GSW vs. LAC,124,17,1610612746,LAC,LA Clippers,LAC @ GSW,107,-17,Regular Season
22022,1610612745,HOU,Houston Rockets,0022200278,2022-11-25T00:00:00Z,HOU vs. ATL,128,6,1610612737,ATL,Atlanta Hawks,ATL @ HOU,122,-6,Regular Season
22022,1610612746,LAC,LA Clippers,0022200285,2022-11-25T00:00:00Z,LAC vs. DEN,104,-10,1610612743,DEN,Denver Nuggets,DEN @ LAC,114,10,Regular Season
22022,1610612754,IND,Indiana Pacers,0022200276,2022-11-25T00:00:00Z,IND vs. BKN,128,11,1610612751,BKN,Brooklyn Nets,BKN @ IND,117,-11,Regular Season
22022,1610612759,SAS,San Antonio Spurs,0022200282,2022-11-25T00:00:00Z,SAS vs. LAL,94,-11,1610612747,LAL,Los Angeles Lakers,LAL @ SAS,105,11,Regular Season
22022,1610612766,CHA,Charlotte Hornets,0022200272,2022-11-25T00:00:00Z,CHA vs. MIN,110,2,1610612750,MIN,Minnesota Timberwolves,MIN @ CHA,108,-2,Regular Season
22022,1610612752,NYK,New York Knicks,0022200274,2022-11-25T00:00:00Z,NYK vs. POR,129,-3,1610612757,POR,Portland Trail Blazers,POR @ NYK,132,3,Regular Season
22022,1610612763,MEM,Memphis Grizzlies,0022200279,2022-11-25T00:00:00Z,MEM vs. NOP,132,21,1610612740,NOP,New Orleans Pelicans,NOP @ MEM,111,-21,Regular Season
22022,1610612738,BOS,Boston Celtics,0022200275,2022-11-25T00:00:00Z,BOS vs. SAC,122,18,1610612758,SAC,Sacramento Kings,SAC @ BOS,104,-18,Regular Season
22022,1610612749,MIL,Milwaukee Bucks,0022200280,2022-11-25T00:00:00Z,MIL vs. CLE,117,15,1610612739,CLE,Cleveland Cavaliers,CLE @ MIL,102,-15,Regular Season
22022,1610612760,OKC,Oklahoma City Thunder,0022200281,2022-11-25T00:00:00Z,OKC vs. CHI,123,4,1610612741,CHI,Chicago Bulls,CHI @ OKC,119,-4,Regular Season
22022,1610612753,ORL,Orlando Magic,0022200273,2022-11-25T00:00:00Z,ORL vs. PHI,99,-8,1610612755,PHI,Philadelphia 76ers,PHI @ ORL,107,8,Regular Season
22022,1610612756,PHX,Phoenix Suns,0022200283,2022-11-25T00:00:00Z,PHX vs. DET,108,6,1610612765,DET,Detroit Pistons,DET @ PHX,102,-6,Regular Season
22022,1610612748,MIA,Miami Heat,0022200277,2022-11-25T00:00:00Z,MIA vs. WAS,110,3,1610612764,WAS,Washington Wizards,WAS @ MIA,107,-3,Regular Season
22022,1610612744,GSW,Golden State Warriors,0022200284,2022-11-25T00:00:00Z,GSW vs. UTA,129,11,1610612762,UTA,Utah Jazz,UTA @ GSW,118,-11,Regular Season
22022,1610612761,TOR,Toronto Raptors,0022200286,2022-11-26T00:00:00Z,TOR vs. DAL,105,5,1610612742,DAL,Dallas Mavericks,DAL @ TOR,100,-5,Regular Season
22022,1610612756,PHX,Phoenix Suns,0022200289,2022-11-26T00:00:00Z,PHX vs. UTA,113,1,1610612762,UTA,Utah Jazz,UTA @ PHX,112,-1,Regular Season
22022,1610612759,SAS,San Antonio Spurs,0022200288,2022-11-26T00:00:00Z,SAS vs. LAL,138,-5,1610612747,LAL,Los Angeles Lakers,LAL @ SAS,143,5,Regular Season
22022,1610612745,HOU,Houston Rockets,0022200287,2022-11-26T00:00:00Z,HOU vs. OKC,118,13,1610612760,OKC,Oklahoma City Thunder,OKC @ HOU,105,-13,Regular Season
22022,1610612753,ORL,Orlando Magic,0022200297,2022-11-27T00:00:00Z,ORL vs. PHI,103,-30,1610612755,PHI,Philadelphia 76ers,PHI @ ORL,133,30,Regular Season
22022,1610612749,MIL,Milwaukee Bucks,0022200298,2022-11-27T00:00:00Z,MIL vs. DAL,124,9,1610612742,DAL,Dallas Mavericks,DAL @ MIL,115,-9,Regular Season
22022,1610612752,NYK,New York Knicks,0022200296,2022-11-27T00:00:00Z,NYK vs. MEM,123,-4,1610612763,MEM,Memphis Grizzlies,MEM @ NYK,127,4,Regular Season
22022,1610612738,BOS,Boston Celtics,0022200294,2022-11-27T00:00:00Z,BOS vs. WAS,130,9,1610612764,WAS,Washington Wizards,WAS @ BOS,121,-9,Regular Season
22022,1610612737,ATL,Atlanta Hawks,0022200293,2022-11-27T00:00:00Z,ATL vs. MIA,98,-8,1610612748,MIA,Miami Heat,MIA @ ATL,106,8,Regular Season
22022,1610612746,LAC,LA Clippers,0022200292,2022-11-27T00:00:00Z,LAC vs. IND,114,14,1610612754,IND,Indiana Pacers,IND @ LAC,100,-14,Regular Season
22022,1610612750,MIN,Minnesota Timberwolves,0022200291,2022-11-27T00:00:00Z,MIN vs. GSW,114,-23,1610612744,GSW,Golden State Warriors,GSW @ MIN,137,23,Regular Season
22022,1610612751,BKN,Brooklyn Nets,0022200290,2022-11-27T00:00:00Z,BKN vs. POR,111,14,1610612757,POR,Portland Trail Blazers,POR @ BKN,97,-14,Regular Season
22022,1610612765,DET,Detroit Pistons,0022200295,2022-11-27T00:00:00Z,DET vs. CLE,94,-8,1610612739,CLE,Cleveland Cavaliers,CLE @ DET,102,8,Regular Season
22022,1610612743,DEN,Denver Nuggets,0022200305,2022-11-28T00:00:00Z,DEN vs. HOU,129,16,1610612745,HOU,Houston Rockets,HOU @ DEN,113,-16,Regular Season
22022,1610612755,PHI,Philadelphia 76ers,0022200299,2022-11-28T00:00:00Z,PHI vs. ATL,104,3,1610612737,ATL,Atlanta Hawks,ATL @ PHI,101,-3,Regular Season
22022,1610612764,WAS,Washington Wizards,0022200300,2022-11-28T00:00:00Z,WAS vs. MIN,142,15,1610612750,MIN,Minnesota Timberwolves,MIN @ WAS,127,-15,Regular Season
22022,1610612738,BOS,Boston Celtics,0022200301,2022-11-28T00:00:00Z,BOS vs. CHA,140,35,1610612766,CHA,Charlotte Hornets,CHA @ BOS,105,-35,Regular Season
22022,1610612761,TOR,Toronto Raptors,0022200303,2022-11-28T00:00:00Z,TOR vs. CLE,100,12,1610612739,CLE,Cleveland Cavaliers,CLE @ TOR,88,-12,Regular Season
22022,1610612762,UTA,Utah Jazz,0022200306,2022-11-28T00:00:00Z,UTA vs. CHI,107,-7,1610612741,CHI,Chicago Bulls,CHI @ UTA,114,7,Regular Season
22022,1610612758,SAC,Sacramento Kings,0022200307,2022-11-28T00:00:00Z,SAC vs. PHX,117,-5,1610612756,PHX,Phoenix Suns,PHX @ SAC,122,5,Regular Season
22022,1610612751,BKN,Brooklyn Nets,0022200302,2022-11-28T00:00:00Z,BKN vs. ORL,109,7,1610612753,ORL,Orlando Magic,ORL @ BKN,102,-7,Regular Season
22022,1610612747,LAL,Los Angeles Lakers,0022200308,2022-11-28T00:00:00Z,LAL vs. IND,115,-1,1610612754,IND,Indiana Pacers,IND @ LAL,116,1,Regular Season
22022,1610612740,NOP,New Orleans Pelicans,0022200304,2022-11-28T00:00:00Z,NOP vs. OKC,105,4,1610612760,OKC,Oklahoma City Thunder,OKC @ NOP,101,-4,Regular Season
22022,1610612765,DET,Detroit Pistons,0022200309,2022-11-29T00:00:00Z,DET vs. NYK,110,-30,1610612752,NYK,New York Knicks,NYK @ DET,140,30,Regular Season
22022,1610612742,DAL,Dallas Mavericks,0022200310,2022-11-29T00:00:00Z,DAL vs. GSW,116,3,1610612744,GSW,Golden State Warriors,GSW @ DAL,113,-3,Regular Season
22022,1610612757,POR,Portland Trail Blazers,0022200311,2022-11-29T00:00:00Z,POR vs. LAC,112,-6,1610612746,LAC,LA Clippers,LAC @ POR,118,6,Regular Season
22022,1610612738,BOS,Boston Celtics,0022200314,2022-11-30T00:00:00Z,BOS vs. MIA,134,13,1610612748,MIA,Miami Heat,MIA @ BOS,121,-13,Regular Season
22022,1610612740,NOP,New Orleans Pelicans,0022200318,2022-11-30T00:00:00Z,NOP vs. TOR,126,18,1610612761,TOR,Toronto Raptors,TOR @ NOP,108,-18,Regular Season
22022,1610612758,SAC,Sacramento Kings,0022200323,2022-11-30T00:00:00Z,SAC vs. IND,137,23,1610612754,IND,Indiana Pacers,IND @ SAC,114,-23,Regular Season
22022,1610612753,ORL,Orlando Magic,0022200313,2022-11-30T00:00:00Z,ORL vs. ATL,108,-17,1610612737,ATL,Atlanta Hawks,ATL @ ORL,125,17,Regular Season
22022,1610612756,PHX,Phoenix Suns,0022200321,2022-11-30T00:00:00Z,PHX vs. CHI,132,19,1610612741,CHI,Chicago Bulls,CHI @ PHX,113,-19,Regular Season
22022,1610612751,BKN,Brooklyn Nets,0022200315,2022-11-30T00:00:00Z,BKN vs. WAS,113,6,1610612764,WAS,Washington Wizards,WAS @ BKN,107,-6,Regular Season
22022,1610612762,UTA,Utah Jazz,0022200322,2022-11-30T00:00:00Z,UTA vs. LAC,125,13,1610612746,LAC,LA Clippers,LAC @ UTA,112,-13,Regular Season
22022,1610612747,LAL,Los Angeles Lakers,0022200324,2022-11-30T00:00:00Z,LAL vs. POR,128,19,1610612757,POR,Portland Trail Blazers,POR @ LAL,109,-19,Regular Season
22022,1610612743,DEN,Denver Nuggets,0022200320,2022-11-30T00:00:00Z,DEN vs. HOU,120,20,1610612745,HOU,Houston Rockets,HOU @ DEN,100,-20,Regular Season
22022,1610612760,OKC,Oklahoma City Thunder,0022200319,2022-11-30T00:00:00Z,OKC vs. SAS,119,8,1610612759,SAS,San Antonio Spurs,SAS @ OKC,111,-8,Regular Season
22022,1610612750,MIN,Minnesota Timberwolves,0022200317,2022-11-30T00:00:00Z,MIN vs. MEM,109,8,1610612763,MEM,Memphis Grizzlies,MEM @ MIN,101,-8,Regular Season
22022,1610612739,CLE,Cleveland Cavaliers,0022200312,2022-11-30T00:00:00Z,CLE vs. PHI,113,28,1610612755,PHI,Philadelphia 76ers,PHI @ CLE,85,-28,Regular Season
22022,1610612752,NYK,New York Knicks,0022200316,2022-11-30T00:00:00Z,NYK vs. MIL,103,-6,1610612749,MIL,Milwaukee Bucks,MIL @ NYK,109,6,Regular Season
22022,1610612765,DET,Detroit Pistons,0022200325,2022-12-01T00:00:00Z,DET vs. DAL,131,6,1610612742,DAL,Dallas Mavericks,DAL @ DET,125,-6,Regular Season
22022,1610612756,PHX,Phoenix Suns,0022200334,2022-12-02T00:00:00Z,PHX vs. HOU,121,-1,1610612745,HOU,Houston Rockets,HOU @ PHX,122,1,Regular Season
22022,1610612762,UTA,Utah Jazz,0022200335,2022-12-02T00:00:00Z,UTA vs. IND,139,20,1610612754,IND,Indiana Pacers,IND @ UTA,119,-20,Regular Season
22022,1610612763,MEM,Memphis Grizzlies,0022200332,2022-12-02T00:00:00Z,MEM vs. PHI,117,8,1610612755,PHI,Philadelphia 76ers,PHI @ MEM,109,-8,Regular Season
22022,1610612738,BOS,Boston Celtics,0022200328,2022-12-02T00:00:00Z,BOS vs. MIA,116,-4,1610612748,MIA,Miami Heat,MIA @ BOS,120,4,Regular Season
22022,1610612744,GSW,Golden State Warriors,0022200336,2022-12-02T00:00:00Z,GSW vs. CHI,119,8,1610612741,CHI,Chicago Bulls,CHI @ GSW,111,-8,Regular Season
22022,1610612751,BKN,Brooklyn Nets,0022200329,2022-12-02T00:00:00Z,BKN vs. TOR,114,9,1610612761,TOR,Toronto Raptors,TOR @ BKN,105,-9,Regular Season
22022,1610612739,CLE,Cleveland Cavaliers,0022200330,2022-12-02T00:00:00Z,CLE vs. ORL,107,11,1610612753,ORL,Orlando Magic,ORL @ CLE,96,-11,Regular Season
22022,1610612737,ATL,Atlanta Hawks,0022200327,2022-12-02T00:00:00Z,ATL vs. DEN,117,8,1610612743,DEN,Denver Nuggets,DEN @ ATL,109,-8,Regular Season
22022,1610612766,CHA,Charlotte Hornets,0022200326,2022-12-02T00:00:00Z,CHA vs. WAS,117,1,1610612764,WAS,Washington Wizards,WAS @ CHA,116,-1,Regular Season
22022,1610612759,SAS,San Antonio Spurs,0022200333,2022-12-02T00:00:00Z,SAS vs. NOP,99,-18,1610612740,NOP,New Orleans Pelicans,NOP @ SAS,117,18,Regular Season
22022,1610612749,MIL,Milwaukee Bucks,0022200331,2022-12-02T00:00:00Z,MIL vs. LAL,129,-4,1610612747,LAL,Los Angeles Lakers,LAL @ MIL,133,4,Regular Season
22022,1610612746,LAC,LA Clippers,0022200338,2022-12-03T00:00:00Z,LAC vs. SAC,96,-27,1610612758,SAC,Sacramento Kings,SAC @ LAC,123,27,Regular Season
22022,1610612761,TOR,Toronto Raptors,0022200340,2022-12-03T00:00:00Z,TOR vs. ORL,121,13,1610612753,ORL,Orlando Magic,ORL @ TOR,108,-13,Regular Season
22022,1610612744,GSW,Golden State Warriors,0022200342,2022-12-03T00:00:00Z,GSW vs. HOU,120,19,1610612745,HOU,Houston Rockets,HOU @ GSW,101,-19,Regular Season
22022,1610612750,MIN,Minnesota Timberwolves,0022200341,2022-12-03T00:00:00Z,MIN vs. OKC,128,-7,1610612760,OKC,Oklahoma City Thunder,OKC @ MIN,135,7,Regular Season
22022,1610612762,UTA,Utah Jazz,0022200343,2022-12-03T00:00:00Z,UTA vs. POR,111,-5,1610612757,POR,Portland Trail Blazers,POR @ UTA,116,5,Regular Season
22022,1610612766,CHA,Charlotte Hornets,0022200339,2022-12-03T00:00:00Z,CHA vs. MIL,96,-9,1610612749,MIL,Milwaukee Bucks,MIL @ CHA,105,9,Regular Season
22022,1610612752,NYK,New York Knicks,0022200337,2022-12-03T00:00:00Z,NYK vs. DAL,100,-21,1610612742,DAL,Dallas Mavericks,DAL @ NYK,121,21,Regular Season
22022,1610612751,BKN,Brooklyn Nets,0022200346,2022-12-04T00:00:00Z,BKN vs. BOS,92,-11,1610612738,BOS,Boston Celtics,BOS @ BKN,103,11,Regular Season
22022,1610612752,NYK,New York Knicks,0022200348,2022-12-04T00:00:00Z,NYK vs. CLE,92,11,1610612739,CLE,Cleveland Cavaliers,CLE @ NYK,81,-11,Regular Season
22022,1610612740,NOP,New Orleans Pelicans,0022200344,2022-12-04T00:00:00Z,NOP vs. DEN,121,15,1610612743,DEN,Denver Nuggets,DEN @ NOP,106,-15,Regular Season
22022,1610612764,WAS,Washington Wizards,0022200349,2022-12-04T00:00:00Z,WAS vs. LAL,119,-11,1610612747,LAL,Los Angeles Lakers,LAL @ WAS,130,11,Regular Season
22022,1610612765,DET,Detroit Pistons,0022200347,2022-12-04T00:00:00Z,DET vs. MEM,112,-10,1610612763,MEM,Memphis Grizzlies,MEM @ DET,122,10,Regular Season
22022,1610612759,SAS,San Antonio Spurs,0022200345,2022-12-04T00:00:00Z,SAS vs. PHX,95,-38,1610612756,PHX,Phoenix Suns,PHX @ SAS,133,38,Regular Season
22022,1610612757,POR,Portland Trail Blazers,0022200351,2022-12-04T00:00:00Z,POR vs. IND,116,16,1610612754,IND,Indiana Pacers,IND @ POR,100,-16,Regular Season
22022,1610612758,SAC,Sacramento Kings,0022200350,2022-12-04T00:00:00Z,SAC vs. CHI,110,9,1610612741,CHI,Chicago Bulls,CHI @ SAC,101,-9,Regular Season
22022,1610612753,ORL,Orlando Magic,0022200353,2022-12-05T00:00:00Z,ORL vs. MIL,102,-7,1610612749,MIL,Milwaukee Bucks,MIL @ ORL,109,7,Regular Season
22022,1610612742,DAL,Dallas Mavericks,0022200358,2022-12-05T00:00:00Z,DAL vs. PHX,130,19,1610612756,PHX,Phoenix Suns,PHX @ DAL,111,-19,Regular Season
22022,1610612766,CHA,Charlotte Hornets,0022200352,2022-12-05T00:00:00Z,CHA vs. LAC,117,-2,1610612746,LAC,LA Clippers,LAC @ CHA,119,2,Regular Season
22022,1610612744,GSW,Golden State Warriors,0022200359,2022-12-05T00:00:00Z,GSW vs. IND,104,-8,1610612754,IND,Indiana Pacers,IND @ GSW,112,8,Regular Season
22022,1610612745,HOU,Houston Rockets,0022200356,2022-12-05T00:00:00Z,HOU vs. PHI,132,9,1610612755,PHI,Philadelphia 76ers,PHI @ HOU,123,-9,Regular Season
22022,1610612763,MEM,Memphis Grizzlies,0022200357,2022-12-05T00:00:00Z,MEM vs. MIA,101,8,1610612748,MIA,Miami Heat,MIA @ MEM,93,-8,Regular Season
22022,1610612737,ATL,Atlanta Hawks,0022200354,2022-12-05T00:00:00Z,ATL vs. OKC,114,-7,1610612760,OKC,Oklahoma City Thunder,OKC @ ATL,121,7,Regular Season
22022,1610612761,TOR,Toronto Raptors,0022200355,2022-12-05T00:00:00Z,TOR vs. BOS,110,-6,1610612738,BOS,Boston Celtics,BOS @ TOR,116,6,Regular Season
22022,1610612748,MIA,Miami Heat,0022200361,2022-12-06T00:00:00Z,MIA vs. DET,96,-20,1610612765,DET,Detroit Pistons,DET @ MIA,116,20,Regular Season
22022,1610612739,CLE,Cleveland Cavaliers,0022200360,2022-12-06T00:00:00Z,CLE vs. LAL,116,14,1610612747,LAL,Los Angeles Lakers,LAL @ CLE,102,-14,Regular Season
22022,1610612743,DEN,Denver Nuggets,0022200362,2022-12-06T00:00:00Z,DEN vs. DAL,115,-1,1610612742,DAL,Dallas Mavericks,DAL @ DEN,116,1,Regular Season
22022,1610612752,NYK,New York Knicks,0022200365,2022-12-07T00:00:00Z,NYK vs. ATL,113,24,1610612737,ATL,Atlanta Hawks,ATL @ NYK,89,-24,Regular Season
22022,1610612751,BKN,Brooklyn Nets,0022200364,2022-12-07T00:00:00Z,BKN vs. CHA,122,6,1610612766,CHA,Charlotte Hornets,CHA @ BKN,116,-6,Regular Season
22022,1610612753,ORL,Orlando Magic,0022200363,2022-12-07T00:00:00Z,ORL vs. LAC,116,5,1610612746,LAC,LA Clippers,LAC @ ORL,111,-5,Regular Season
22022,1610612761,TOR,Toronto Raptors,0022200366,2022-12-07T00:00:00Z,TOR vs. LAL,126,13,1610612747,LAL,Los Angeles Lakers,LAL @ TOR,113,-13,Regular Season
22022,1610612749,MIL,Milwaukee Bucks,0022200369,2022-12-07T00:00:00Z,MIL vs. SAC,126,13,1610612758,SAC,Sacramento Kings,SAC @ MIL,113,-13,Regular Season
22022,1610612763,MEM,Memphis Grizzlies,0022200368,2022-12-07T00:00:00Z,MEM vs. OKC,123,21,1610612760,OKC,Oklahoma City Thunder,OKC @ MEM,102,-21,Regular Season
22022,1610612750,MIN,Minnesota Timberwolves,0022200370,2022-12-07T00:00:00Z,MIN vs. IND,121,6,1610612754,IND,Indiana Pacers,IND @ MIN,115,-6,Regular Season
22022,1610612741,CHI,Chicago Bulls,0022200367,2022-12-07T00:00:00Z,CHI vs. WAS,115,4,1610612764,WAS,Washington Wizards,WAS @ CHI,111,-4,Regular Season
22022,1610612740,NOP,New Orleans Pelicans,0022200371,2022-12-07T00:00:00Z,NOP vs. DET,104,6,1610612765,DET,Detroit Pistons,DET @ NOP,98,-6,Regular Season
22022,1610612762,UTA,Utah Jazz,0022200372,2022-12-07T00:00:00Z,UTA vs. GSW,124,1,1610612744,GSW,Golden State Warriors,GSW @ UTA,123,-1,Regular Season
22022,1610612756,PHX,Phoenix Suns,0022200373,2022-12-07T00:00:00Z,PHX vs. BOS,98,-27,1610612738,BOS,Boston Celtics,BOS @ PHX,125,27,Regular Season
22022,1610612759,SAS,San Antonio Spurs,0022200375,2022-12-08T00:00:00Z,SAS vs. HOU,118,9,1610612745,HOU,Houston Rockets,HOU @ SAS,109,-9,Regular Season
22022,1610612748,MIA,Miami Heat,0022200374,2022-12-08T00:00:00Z,MIA vs. LAC,115,5,1610612746,LAC,LA Clippers,LAC @ MIA,110,-5,Regular Season
22022,1610612757,POR,Portland Trail Blazers,0022200376,2022-12-08T00:00:00Z,POR vs. DEN,120,-1,1610612743,DEN,Denver Nuggets,DEN @ POR,121,1,Regular Season
22022,1610612762,UTA,Utah Jazz,0022200385,2022-12-09T00:00:00Z,UTA vs. MIN,108,-10,1610612750,MIN,Minnesota Timberwolves,MIN @ UTA,118,10,Regular Season
22022,1610612739,CLE,Cleveland Cavaliers,0022200381,2022-12-09T00:00:00Z,CLE vs. SAC,95,-11,1610612758,SAC,Sacramento Kings,SAC @ CLE,106,11,Regular Season
22022,1610612742,DAL,Dallas Mavericks,0022200386,2022-12-09T00:00:00Z,DAL vs. MIL,105,-1,1610612749,MIL,Milwaukee Bucks,MIL @ DAL,106,1,Regular Season
22022,1610612753,ORL,Orlando Magic,0022200379,2022-12-09T00:00:00Z,ORL vs. TOR,113,4,1610612761,TOR,Toronto Raptors,TOR @ ORL,109,-4,Regular Season
22022,1610612754,IND,Indiana Pacers,0022200378,2022-12-09T00:00:00Z,IND vs. WAS,121,10,1610612764,WAS,Washington Wizards,WAS @ IND,111,-10,Regular Season
22022,1610612740,NOP,New Orleans Pelicans,0022200384,2022-12-09T00:00:00Z,NOP vs. PHX,128,11,1610612756,PHX,Phoenix Suns,PHX @ NOP,117,-11,Regular Season
22022,1610612751,BKN,Brooklyn Nets,0022200380,2022-12-09T00:00:00Z,BKN vs. ATL,120,4,1610612737,ATL,Atlanta Hawks,ATL @ BKN,116,-4,Regular Season
22022,1610612755,PHI,Philadelphia 76ers,0022200382,2022-12-09T00:00:00Z,PHI vs. LAL,133,11,1610612747,LAL,Los Angeles Lakers,LAL @ PHI,122,-11,Regular Season
22022,1610612763,MEM,Memphis Grizzlies,0022200383,2022-12-09T00:00:00Z,MEM vs. DET,114,11,1610612765,DET,Detroit Pistons,DET @ MEM,103,-11,Regular Season
22022,1610612766,CHA,Charlotte Hornets,0022200377,2022-12-09T00:00:00Z,CHA vs. NYK,102,-19,1610612752,NYK,New York Knicks,NYK @ CHA,121,19,Regular Season
22022,1610612757,POR,Portland Trail Blazers,0022200394,2022-12-10T00:00:00Z,POR vs. MIN,124,6,1610612750,MIN,Minnesota Timberwolves,MIN @ POR,118,-6,Regular Season
22022,1610612741,CHI,Chicago Bulls,0022200391,2022-12-10T00:00:00Z,CHI vs. DAL,144,29,1610612742,DAL,Dallas Mavericks,DAL @ CHI,115,-29,Regular Season
22022,1610612754,IND,Indiana Pacers,0022200388,2022-12-10T00:00:00Z,IND vs. BKN,133,-3,1610612751,BKN,Brooklyn Nets,BKN @ IND,136,3,Regular Season
22022,1610612744,GSW,Golden State Warriors,0022200392,2022-12-10T00:00:00Z,GSW vs. BOS,123,16,1610612738,BOS,Boston Celtics,BOS @ GSW,107,-16,Regular Season
22022,1610612739,CLE,Cleveland Cavaliers,0022200390,2022-12-10T00:00:00Z,CLE vs. OKC,110,8,1610612760,OKC,Oklahoma City Thunder,OKC @ CLE,102,-8,Regular Season
22022,1610612743,DEN,Denver Nuggets,0022200393,2022-12-10T00:00:00Z,DEN vs. UTA,115,5,1610612762,UTA,Utah Jazz,UTA @ DEN,110,-5,Regular Season
22022,1610612748,MIA,Miami Heat,0022200387,2022-12-10T00:00:00Z,MIA vs. SAS,111,-4,1610612759,SAS,San Antonio Spurs,SAS @ MIA,115,4,Regular Season
22022,1610612764,WAS,Washington Wizards,0022200389,2022-12-10T00:00:00Z,WAS vs. LAC,107,-7,1610612746,LAC,LA Clippers,LAC @ WAS,114,7,Regular Season
22022,1610612765,DET,Detroit Pistons,0022200396,2022-12-11T00:00:00Z,DET vs. LAL,117,-7,1610612747,LAL,Los Angeles Lakers,LAL @ DET,124,7,Regular Season
22022,1610612755,PHI,Philadelphia 76ers,0022200399,2022-12-11T00:00:00Z,PHI vs. CHA,131,18,1610612766,CHA,Charlotte Hornets,CHA @ PHI,113,-18,Regular Season
22022,1610612740,NOP,New Orleans Pelicans,0022200395,2022-12-11T00:00:00Z,NOP vs. PHX,129,5,1610612756,PHX,Phoenix Suns,PHX @ NOP,124,-5,Regular Season
22022,1610612753,ORL,Orlando Magic,0022200398,2022-12-11T00:00:00Z,ORL vs. TOR,111,12,1610612761,TOR,Toronto Raptors,TOR @ ORL,99,-12,Regular Season
22022,1610612752,NYK,New York Knicks,0022200397,2022-12-11T00:00:00Z,NYK vs. SAC,112,13,1610612758,SAC,Sacramento Kings,SAC @ NYK,99,-13,Regular Season
22022,1610612737,ATL,Atlanta Hawks,0022200400,2022-12-11T00:00:00Z,ATL vs. CHI,123,1,1610612741,CHI,Chicago Bulls,CHI @ ATL,122,-1,Regular Season
22022,1610612745,HOU,Houston Rockets,0022200401,2022-12-11T00:00:00Z,HOU vs. MIL,97,5,1610612749,MIL,Milwaukee Bucks,MIL @ HOU,92,-5,Regular Season
22022,1610612754,IND,Indiana Pacers,0022200402,2022-12-12T00:00:00Z,IND vs. MIA,82,-5,1610612748,MIA,Miami Heat,MIA @ IND,87,5,Regular Season
22022,1610612763,MEM,Memphis Grizzlies,0022200404,2022-12-12T00:00:00Z,MEM vs. ATL,128,25,1610612737,ATL,Atlanta Hawks,ATL @ MEM,103,-25,Regular Season
22022,1610612759,SAS,San Antonio Spurs,0022200406,2022-12-12T00:00:00Z,SAS vs. CLE,112,1,1610612739,CLE,Cleveland Cavaliers,CLE @ SAS,111,-1,Regular Season
22022,1610612742,DAL,Dallas Mavericks,0022200405,2022-12-12T00:00:00Z,DAL vs. OKC,121,7,1610612760,OKC,Oklahoma City Thunder,OKC @ DAL,114,-7,Regular Season
22022,1610612757,POR,Portland Trail Blazers,0022200407,2022-12-12T00:00:00Z,POR vs. MIN,133,21,1610612750,MIN,Minnesota Timberwolves,MIN @ POR,112,-21,Regular Season
22022,1610612746,LAC,LA Clippers,0022200408,2022-12-12T00:00:00Z,LAC vs. BOS,113,20,1610612738,BOS,Boston Celtics,BOS @ LAC,93,-20,Regular Season
22022,1610612764,WAS,Washington Wizards,0022200403,2022-12-12T00:00:00Z,WAS vs. BKN,100,-12,1610612751,BKN,Brooklyn Nets,BKN @ WAS,112,12,Regular Season
22022,1610612747,LAL,Los Angeles Lakers,0022200413,2022-12-13T00:00:00Z,LAL vs. BOS,118,-4,1610612738,BOS,Boston Celtics,BOS @ LAL,122,4,Regular Season
22022,1610612762,UTA,Utah Jazz,0022200412,2022-12-13T00:00:00Z,UTA vs. NOP,121,21,1610612740,NOP,New Orleans Pelicans,NOP @ UTA,100,-21,Regular Season
22022,1610612755,PHI,Philadelphia 76ers,0022200409,2022-12-13T00:00:00Z,PHI vs. SAC,123,20,1610612758,SAC,Sacramento Kings,SAC @ PHI,103,-20,Regular Season
22022,1610612745,HOU,Houston Rockets,0022200411,2022-12-13T00:00:00Z,HOU vs. PHX,111,14,1610612756,PHX,Phoenix Suns,PHX @ HOU,97,-14,Regular Season
22022,1610612749,MIL,Milwaukee Bucks,0022200410,2022-12-13T00:00:00Z,MIL vs. GSW,128,17,1610612744,GSW,Golden State Warriors,GSW @ MIL,111,-17,Regular Season
22022,1610612746,LAC,LA Clippers,0022200423,2022-12-14T00:00:00Z,LAC vs. MIN,99,11,1610612750,MIN,Minnesota Timberwolves,MIN @ LAC,88,-11,Regular Season
22022,1610612742,DAL,Dallas Mavericks,0022200421,2022-12-14T00:00:00Z,DAL vs. CLE,90,-15,1610612739,CLE,Cleveland Cavaliers,CLE @ DAL,105,15,Regular Season
22022,1610612741,CHI,Chicago Bulls,0022200418,2022-12-14T00:00:00Z,CHI vs. NYK,120,-8,1610612752,NYK,New York Knicks,NYK @ CHI,128,8,Regular Season
22022,1610612760,OKC,Oklahoma City Thunder,0022200419,2022-12-14T00:00:00Z,OKC vs. MIA,108,-2,1610612748,MIA,Miami Heat,MIA @ OKC,110,2,Regular Season
22022,1610612759,SAS,San Antonio Spurs,0022200420,2022-12-14T00:00:00Z,SAS vs. POR,112,-16,1610612757,POR,Portland Trail Blazers,POR @ SAS,128,16,Regular Season
22022,1610612761,TOR,Toronto Raptors,0022200417,2022-12-14T00:00:00Z,TOR vs. SAC,123,-1,1610612758,SAC,Sacramento Kings,SAC @ TOR,124,1,Regular Season
22022,1610612766,CHA,Charlotte Hornets,0022200414,2022-12-14T00:00:00Z,CHA vs. DET,134,-7,1610612765,DET,Detroit Pistons,DET @ CHA,141,7,Regular Season
22022,1610612743,DEN,Denver Nuggets,0022200422,2022-12-14T00:00:00Z,DEN vs. WAS,141,13,1610612764,WAS,Washington Wizards,WAS @ DEN,128,-13,Regular Season
22022,1610612754,IND,Indiana Pacers,0022200415,2022-12-14T00:00:00Z,IND vs. GSW,125,6,1610612744,GSW,Golden State Warriors,GSW @ IND,119,-6,Regular Season
22022,1610612753,ORL,Orlando Magic,0022200416,2022-12-14T00:00:00Z,ORL vs. ATL,135,11,1610612737,ATL,Atlanta Hawks,ATL @ ORL,124,-11,Regular Season
22022,1610612762,UTA,Utah Jazz,0022200426,2022-12-15T00:00:00Z,UTA vs. NOP,132,3,1610612740,NOP,New Orleans Pelicans,NOP @ UTA,129,-3,Regular Season
22022,1610612745,HOU,Houston Rockets,0022200424,2022-12-15T00:00:00Z,HOU vs. MIA,108,-3,1610612748,MIA,Miami Heat,MIA @ HOU,111,3,Regular Season
22022,1610612746,LAC,LA Clippers,0022200427,2022-12-15T00:00:00Z,LAC vs. PHX,95,-16,1610612756,PHX,Phoenix Suns,PHX @ LAC,111,16,Regular Season
22022,1610612763,MEM,Memphis Grizzlies,0022200425,2022-12-15T00:00:00Z,MEM vs. MIL,142,41,1610612749,MIL,Milwaukee Bucks,MIL @ MEM,101,-41,Regular Season
22022,1610612766,CHA,Charlotte Hornets,0022200428,2022-12-16T00:00:00Z,CHA vs. ATL,106,-19,1610612737,ATL,Atlanta Hawks,ATL @ CHA,125,19,Regular Season
22022,1610612742,DAL,Dallas Mavericks,0022200436,2022-12-16T00:00:00Z,DAL vs. POR,130,20,1610612757,POR,Portland Trail Blazers,POR @ DAL,110,-20,Regular Season
22022,1610612739,CLE,Cleveland Cavaliers,0022200431,2022-12-16T00:00:00Z,CLE vs. IND,118,6,1610612754,IND,Indiana Pacers,IND @ CLE,112,-6,Regular Season
22022,1610612765,DET,Detroit Pistons,0022200429,2022-12-16T00:00:00Z,DET vs. SAC,113,-9,1610612758,SAC,Sacramento Kings,SAC @ DET,122,9,Regular Season
22022,1610612760,OKC,Oklahoma City Thunder,0022200435,2022-12-16T00:00:00Z,OKC vs. MIN,110,-2,1610612750,MIN,Minnesota Timberwolves,MIN @ OKC,112,2,Regular Season
22022,1610612741,CHI,Chicago Bulls,0022200434,2022-12-16T00:00:00Z,CHI vs. NYK,91,-23,1610612752,NYK,New York Knicks,NYK @ CHI,114,23,Regular Season
22022,1610612747,LAL,Los Angeles Lakers,0022200437,2022-12-16T00:00:00Z,LAL vs. DEN,126,18,1610612743,DEN,Denver Nuggets,DEN @ LAL,108,-18,Regular Season
22022,1610612738,BOS,Boston Celtics,0022200430,2022-12-16T00:00:00Z,BOS vs. ORL,109,-8,1610612753,ORL,Orlando Magic,ORL @ BOS,117,8,Regular Season
22022,1610612761,TOR,Toronto Raptors,0022200433,2022-12-16T00:00:00Z,TOR vs. BKN,116,-3,1610612751,BKN,Brooklyn Nets,BKN @ TOR,119,3,Regular Season
22022,1610612755,PHI,Philadelphia 76ers,0022200432,2022-12-16T00:00:00Z,PHI vs. GSW,118,12,1610612744,GSW,Golden State Warriors,GSW @ PHI,106,-12,Regular Season
22022,1610612760,OKC,Oklahoma City Thunder,0022200443,2022-12-17T00:00:00Z,OKC vs. MEM,115,6,1610612763,MEM,Memphis Grizzlies,MEM @ OKC,109,-6,Regular Season
22022,1610612756,PHX,Phoenix Suns,0022200444,2022-12-17T00:00:00Z,PHX vs. NOP,118,4,1610612740,NOP,New Orleans Pelicans,NOP @ PHX,114,-4,Regular Season
22022,1610612746,LAC,LA Clippers,0022200438,2022-12-17T00:00:00Z,LAC vs. WAS,102,9,1610612764,WAS,Washington Wizards,WAS @ LAC,93,-9,Regular Season
22022,1610612759,SAS,San Antonio Spurs,0022200439,2022-12-17T00:00:00Z,SAS vs. MIA,101,-10,1610612748,MIA,Miami Heat,MIA @ SAS,111,10,Regular Season
22022,1610612745,HOU,Houston Rockets,0022200441,2022-12-17T00:00:00Z,HOU vs. POR,95,-12,1610612757,POR,Portland Trail Blazers,POR @ HOU,107,12,Regular Season
22022,1610612739,CLE,Cleveland Cavaliers,0022200440,2022-12-17T00:00:00Z,CLE vs. DAL,100,1,1610612742,DAL,Dallas Mavericks,DAL @ CLE,99,-1,Regular Season
22022,1610612749,MIL,Milwaukee Bucks,0022200442,2022-12-17T00:00:00Z,MIL vs. UTA,123,26,1610612762,UTA,Utah Jazz,UTA @ MIL,97,-26,Regular Season
22022,1610612754,IND,Indiana Pacers,0022200446,2022-12-18T00:00:00Z,IND vs. NYK,106,-3,1610612752,NYK,New York Knicks,NYK @ IND,109,3,Regular Season
22022,1610612750,MIN,Minnesota Timberwolves,0022200449,2022-12-18T00:00:00Z,MIN vs. CHI,150,24,1610612741,CHI,Chicago Bulls,CHI @ MIN,126,-24,Regular Season
22022,1610612765,DET,Detroit Pistons,0022200447,2022-12-18T00:00:00Z,DET vs. BKN,121,-3,1610612751,BKN,Brooklyn Nets,BKN @ DET,124,3,Regular Season
22022,1610612761,TOR,Toronto Raptors,0022200448,2022-12-18T00:00:00Z,TOR vs. GSW,110,-16,1610612744,GSW,Golden State Warriors,GSW @ TOR,126,16,Regular Season
22022,1610612747,LAL,Los Angeles Lakers,0022200451,2022-12-18T00:00:00Z,LAL vs. WAS,119,2,1610612764,WAS,Washington Wizards,WAS @ LAL,117,-2,Regular Season
22022,1610612738,BOS,Boston Celtics,0022200445,2022-12-18T00:00:00Z,BOS vs. ORL,92,-3,1610612753,ORL,Orlando Magic,ORL @ BOS,95,3,Regular Season
22022,1610612743,DEN,Denver Nuggets,0022200450,2022-12-18T00:00:00Z,DEN vs. CHA,119,4,1610612766,CHA,Charlotte Hornets,CHA @ DEN,115,-4,Regular Season
22022,1610612755,PHI,Philadelphia 76ers,0022200453,2022-12-19T00:00:00Z,PHI vs. TOR,104,3,1610612761,TOR,Toronto Raptors,TOR @ PHI,101,-3,Regular Season
22022,1610612756,PHX,Phoenix Suns,0022200459,2022-12-19T00:00:00Z,PHX vs. LAL,130,26,1610612747,LAL,Los Angeles Lakers,LAL @ PHX,104,-26,Regular Season
22022,1610612737,ATL,Atlanta Hawks,0022200454,2022-12-19T00:00:00Z,ATL vs. ORL,126,1,1610612753,ORL,Orlando Magic,ORL @ ATL,125,-1,Regular Season
22022,1610612745,HOU,Houston Rockets,0022200455,2022-12-19T00:00:00Z,HOU vs. SAS,105,-19,1610612759,SAS,San Antonio Spurs,SAS @ HOU,124,19,Regular Season
22022,1610612750,MIN,Minnesota Timberwolves,0022200456,2022-12-19T00:00:00Z,MIN vs. DAL,116,10,1610612742,DAL,Dallas Mavericks,DAL @ MIN,106,-10,Regular Season
22022,1610612760,OKC,Oklahoma City Thunder,0022200458,2022-12-19T00:00:00Z,OKC vs. POR,123,2,1610612757,POR,Portland Trail Blazers,POR @ OKC,121,-2,Regular Season
22022,1610612740,NOP,New Orleans Pelicans,0022200457,2022-12-19T00:00:00Z,NOP vs. MIL,119,-9,1610612749,MIL,Milwaukee Bucks,MIL @ NOP,128,9,Regular Season
22022,1610612739,CLE,Cleveland Cavaliers,0022200452,2022-12-19T00:00:00Z,CLE vs. UTA,122,23,1610612762,UTA,Utah Jazz,UTA @ CLE,99,-23,Regular Season
22022,1610612758,SAC,Sacramento Kings,0022200460,2022-12-19T00:00:00Z,SAC vs. CHA,119,-6,1610612766,CHA,Charlotte Hornets,CHA @ SAC,125,6,Regular Season
22022,1610612752,NYK,New York Knicks,0022200463,2022-12-20T00:00:00Z,NYK vs. GSW,132,38,1610612744,GSW,Golden State Warriors,GSW @ NYK,94,-38,Regular Season
22022,1610612748,MIA,Miami Heat,0022200462,2022-12-20T00:00:00Z,MIA vs. CHI,103,-10,1610612741,CHI,Chicago Bulls,CHI @ MIA,113,10,Regular Season
22022,1610612756,PHX,Phoenix Suns,0022200464,2022-12-20T00:00:00Z,PHX vs. WAS,110,-3,1610612764,WAS,Washington Wizards,WAS @ PHX,113,3,Regular Season
22022,1610612743,DEN,Denver Nuggets,0022200465,2022-12-20T00:00:00Z,DEN vs. MEM,105,14,1610612763,MEM,Memphis Grizzlies,MEM @ DEN,91,-14,Regular Season
22022,1610612765,DET,Detroit Pistons,0022200461,2022-12-20T00:00:00Z,DET vs. UTA,111,-15,1610612762,UTA,Utah Jazz,UTA @ DET,126,15,Regular Season
22022,1610612739,CLE,Cleveland Cavaliers,0022200466,2022-12-21T00:00:00Z,CLE vs. MIL,114,8,1610612749,MIL,Milwaukee Bucks,MIL @ CLE,106,-8,Regular Season
22022,1610612752,NYK,New York Knicks,0022200471,2022-12-21T00:00:00Z,NYK vs. TOR,106,-7,1610612761,TOR,Toronto Raptors,TOR @ NYK,113,7,Regular Season
22022,1610612746,LAC,LA Clippers,0022200476,2022-12-21T00:00:00Z,LAC vs. CHA,126,21,1610612766,CHA,Charlotte Hornets,CHA @ LAC,105,-21,Regular Season
22022,1610612758,SAC,Sacramento Kings,0022200475,2022-12-21T00:00:00Z,SAC vs. LAL,134,14,1610612747,LAL,Los Angeles Lakers,LAL @ SAC,120,-14,Regular Season
22022,1610612738,BOS,Boston Celtics,0022200469,2022-12-21T00:00:00Z,BOS vs. IND,112,-5,1610612754,IND,Indiana Pacers,IND @ BOS,117,5,Regular Season
22022,1610612760,OKC,Oklahoma City Thunder,0022200474,2022-12-21T00:00:00Z,OKC vs. POR,101,3,1610612757,POR,Portland Trail Blazers,POR @ OKC,98,-3,Regular Season
22022,1610612745,HOU,Houston Rockets,0022200472,2022-12-21T00:00:00Z,HOU vs. ORL,110,-6,1610612753,ORL,Orlando Magic,ORL @ HOU,116,6,Regular Season
22022,1610612737,ATL,Atlanta Hawks,0022200468,2022-12-21T00:00:00Z,ATL vs. CHI,108,-2,1610612741,CHI,Chicago Bulls,CHI @ ATL,110,2,Regular Season
22022,1610612750,MIN,Minnesota Timberwolves,0022200473,2022-12-21T00:00:00Z,MIN vs. DAL,99,-5,1610612742,DAL,Dallas Mavericks,DAL @ MIN,104,5,Regular Season
22022,1610612751,BKN,Brooklyn Nets,0022200470,2022-12-21T00:00:00Z,BKN vs. GSW,143,30,1610612744,GSW,Golden State Warriors,GSW @ BKN,113,-30,Regular Season
22022,1610612755,PHI,Philadelphia 76ers,0022200467,2022-12-21T00:00:00Z,PHI vs. DET,113,20,1610612765,DET,Detroit Pistons,DET @ PHI,93,-20,Regular Season
22022,1610612740,NOP,New Orleans Pelicans,0022200477,2022-12-22T00:00:00Z,NOP vs. SAS,126,9,1610612759,SAS,San Antonio Spurs,SAS @ NOP,117,-9,Regular Season
22022,1610612762,UTA,Utah Jazz,0022200478,2022-12-22T00:00:00Z,UTA vs. WAS,120,8,1610612764,WAS,Washington Wizards,WAS @ UTA,112,-8,Regular Season
22022,1610612739,CLE,Cleveland Cavaliers,0022200484,2022-12-23T00:00:00Z,CLE vs. TOR,107,-11,1610612761,TOR,Toronto Raptors,TOR @ CLE,118,11,Regular Season
22022,1610612747,LAL,Los Angeles Lakers,0022200492,2022-12-23T00:00:00Z,LAL vs. CHA,130,-4,1610612766,CHA,Charlotte Hornets,CHA @ LAL,134,4,Regular Season
22022,1610612756,PHX,Phoenix Suns,0022200490,2022-12-23T00:00:00Z,PHX vs. MEM,100,-25,1610612763,MEM,Memphis Grizzlies,MEM @ PHX,125,25,Regular Season
22022,1610612758,SAC,Sacramento Kings,0022200491,2022-12-23T00:00:00Z,SAC vs. WAS,111,-14,1610612764,WAS,Washington Wizards,WAS @ SAC,125,14,Regular Season
22022,1610612752,NYK,New York Knicks,0022200485,2022-12-23T00:00:00Z,NYK vs. CHI,117,-1,1610612741,CHI,Chicago Bulls,CHI @ NYK,118,1,Regular Season
22022,1610612743,DEN,Denver Nuggets,0022200489,2022-12-23T00:00:00Z,DEN vs. POR,120,13,1610612757,POR,Portland Trail Blazers,POR @ DEN,107,-13,Regular Season
22022,1610612760,OKC,Oklahoma City Thunder,0022200488,2022-12-23T00:00:00Z,OKC vs. NOP,125,-3,1610612740,NOP,New Orleans Pelicans,NOP @ OKC,128,3,Regular Season
22022,1610612745,HOU,Houston Rockets,0022200487,2022-12-23T00:00:00Z,HOU vs. DAL,106,-6,1610612742,DAL,Dallas Mavericks,DAL @ HOU,112,6,Regular Season
22022,1610612748,MIA,Miami Heat,0022200486,2022-12-23T00:00:00Z,MIA vs. IND,108,-3,1610612754,IND,Indiana Pacers,IND @ MIA,111,3,Regular Season
22022,1610612737,ATL,Atlanta Hawks,0022200481,2022-12-23T00:00:00Z,ATL vs. DET,130,25,1610612765,DET,Detroit Pistons,DET @ ATL,105,-25,Regular Season
22022,1610612751,BKN,Brooklyn Nets,0022200483,2022-12-23T00:00:00Z,BKN vs. MIL,118,18,1610612749,MIL,Milwaukee Bucks,MIL @ BKN,100,-18,Regular Season
22022,1610612738,BOS,Boston Celtics,0022200482,2022-12-23T00:00:00Z,BOS vs. MIN,121,12,1610612750,MIN,Minnesota Timberwolves,MIN @ BOS,109,-12,Regular Season
22022,1610612755,PHI,Philadelphia 76ers,0022200480,2022-12-23T00:00:00Z,PHI vs. LAC,119,5,1610612746,LAC,LA Clippers,LAC @ PHI,114,-5,Regular Season
22022,1610612753,ORL,Orlando Magic,0022200479,2022-12-23T00:00:00Z,ORL vs. SAS,133,20,1610612759,SAS,San Antonio Spurs,SAS @ ORL,113,-20,Regular Season
22022,1610612752,NYK,New York Knicks,0022200493,2022-12-25T00:00:00Z,NYK vs. PHI,112,-7,1610612755,PHI,Philadelphia 76ers,PHI @ NYK,119,7,Regular Season
22022,1610612742,DAL,Dallas Mavericks,0022200494,2022-12-25T00:00:00Z,DAL vs. LAL,124,9,1610612747,LAL,Los Angeles Lakers,LAL @ DAL,115,-9,Regular Season
22022,1610612738,BOS,Boston Celtics,0022200495,2022-12-25T00:00:00Z,BOS vs. MIL,139,21,1610612749,MIL,Milwaukee Bucks,MIL @ BOS,118,-21,Regular Season
22022,1610612744,GSW,Golden State Warriors,0022200496,2022-12-25T00:00:00Z,GSW vs. MEM,123,14,1610612763,MEM,Memphis Grizzlies,MEM @ GSW,109,-14,Regular Season
22022,1610612743,DEN,Denver Nuggets,0022200497,2022-12-25T00:00:00Z,DEN vs. PHX,128,3,1610612756,PHX,Phoenix Suns,PHX @ DEN,125,-3,Regular Season
22022,1610612757,POR,Portland Trail Blazers,0022200504,2022-12-26T00:00:00Z,POR vs. CHA,124,11,1610612766,CHA,Charlotte Hornets,CHA @ POR,113,-11,Regular Season
22022,1610612739,CLE,Cleveland Cavaliers,0022200498,2022-12-26T00:00:00Z,CLE vs. BKN,117,-8,1610612751,BKN,Brooklyn Nets,BKN @ CLE,125,8,Regular Season
22022,1610612759,SAS,San Antonio Spurs,0022200503,2022-12-26T00:00:00Z,SAS vs. UTA,126,4,1610612762,UTA,Utah Jazz,UTA @ SAS,122,-4,Regular Season
22022,1610612748,MIA,Miami Heat,0022200500,2022-12-26T00:00:00Z,MIA vs. MIN,113,3,1610612750,MIN,Minnesota Timberwolves,MIN @ MIA,110,-3,Regular Season
22022,1610612765,DET,Detroit Pistons,0022200499,2022-12-26T00:00:00Z,DET vs. LAC,131,-11,1610612746,LAC,LA Clippers,LAC @ DET,142,11,Regular Season
22022,1610612741,CHI,Chicago Bulls,0022200501,2022-12-26T00:00:00Z,CHI vs. HOU,118,-15,1610612745,HOU,Houston Rockets,HOU @ CHI,133,15,Regular Season
22022,1610612740,NOP,New Orleans Pelicans,0022200502,2022-12-26T00:00:00Z,NOP vs. IND,113,20,1610612754,IND,Indiana Pacers,IND @ NOP,93,-20,Regular Season
22022,1610612760,OKC,Oklahoma City Thunder,0022200511,2022-12-27T00:00:00Z,OKC vs. SAS,130,16,1610612759,SAS,San Antonio Spurs,SAS @ OKC,114,-16,Regular Season
22022,1610612761,TOR,Toronto Raptors,0022200509,2022-12-27T00:00:00Z,TOR vs. LAC,113,-11,1610612746,LAC,LA Clippers,LAC @ TOR,124,11,Regular Season
22022,1610612754,IND,Indiana Pacers,0022200508,2022-12-27T00:00:00Z,IND vs. ATL,129,15,1610612737,ATL,Atlanta Hawks,ATL @ IND,114,-15,Regular Season
22022,1610612744,GSW,Golden State Warriors,0022200513,2022-12-27T00:00:00Z,GSW vs. CHA,110,5,1610612766,CHA,Charlotte Hornets,CHA @ GSW,105,-5,Regular Season
22022,1610612758,SAC,Sacramento Kings,0022200514,2022-12-27T00:00:00Z,SAC vs. DEN,106,-7,1610612743,DEN,Denver Nuggets,DEN @ SAC,113,7,Regular Season
22022,1610612763,MEM,Memphis Grizzlies,0022200510,2022-12-27T00:00:00Z,MEM vs. PHX,108,-17,1610612756,PHX,Phoenix Suns,PHX @ MEM,125,17,Regular Season
22022,1610612753,ORL,Orlando Magic,0022200505,2022-12-27T00:00:00Z,ORL vs. LAL,110,-19,1610612747,LAL,Los Angeles Lakers,LAL @ ORL,129,19,Regular Season
22022,1610612738,BOS,Boston Celtics,0022200507,2022-12-27T00:00:00Z,BOS vs. HOU,126,24,1610612745,HOU,Houston Rockets,HOU @ BOS,102,-24,Regular Season
22022,1610612764,WAS,Washington Wizards,0022200506,2022-12-27T00:00:00Z,WAS vs. PHI,116,5,1610612755,PHI,Philadelphia 76ers,PHI @ WAS,111,-5,Regular Season
22022,1610612742,DAL,Dallas Mavericks,0022200512,2022-12-27T00:00:00Z,DAL vs. NYK,126,5,1610612752,NYK,New York Knicks,NYK @ DAL,121,-5,Regular Season
22022,1610612758,SAC,Sacramento Kings,0022200522,2022-12-28T00:00:00Z,SAC vs. DEN,127,1,1610612743,DEN,Denver Nuggets,DEN @ SAC,126,-1,Regular Season
22022,1610612741,CHI,Chicago Bulls,0022200519,2022-12-28T00:00:00Z,CHI vs. MIL,119,6,1610612749,MIL,Milwaukee Bucks,MIL @ CHI,113,-6,Regular Season
22022,1610612740,NOP,New Orleans Pelicans,0022200520,2022-12-28T00:00:00Z,NOP vs. MIN,119,1,1610612750,MIN,Minnesota Timberwolves,MIN @ NOP,118,-1,Regular Season
22022,1610612737,ATL,Atlanta Hawks,0022200517,2022-12-28T00:00:00Z,ATL vs. BKN,107,-1,1610612751,BKN,Brooklyn Nets,BKN @ ATL,108,1,Regular Season
22022,1610612765,DET,Detroit Pistons,0022200515,2022-12-28T00:00:00Z,DET vs. ORL,121,20,1610612753,ORL,Orlando Magic,ORL @ DET,101,-20,Regular Season
22022,1610612764,WAS,Washington Wizards,0022200516,2022-12-28T00:00:00Z,WAS vs. PHX,127,25,1610612756,PHX,Phoenix Suns,PHX @ WAS,102,-25,Regular Season
22022,1610612744,GSW,Golden State Warriors,0022200521,2022-12-28T00:00:00Z,GSW vs. UTA,112,5,1610612762,UTA,Utah Jazz,UTA @ GSW,107,-5,Regular Season
22022,1610612748,MIA,Miami Heat,0022200518,2022-12-28T00:00:00Z,MIA vs. LAL,112,14,1610612747,LAL,Los Angeles Lakers,LAL @ MIA,98,-14,Regular Season
22022,1610612754,IND,Indiana Pacers,0022200524,2022-12-29T00:00:00Z,IND vs. CLE,135,9,1610612739,CLE,Cleveland Cavaliers,CLE @ IND,126,-9,Regular Season
22022,1610612761,TOR,Toronto Raptors,0022200526,2022-12-29T00:00:00Z,TOR vs. MEM,106,-13,1610612763,MEM,Memphis Grizzlies,MEM @ TOR,119,13,Regular Season
22022,1610612738,BOS,Boston Celtics,0022200525,2022-12-29T00:00:00Z,BOS vs. LAC,116,6,1610612746,LAC,LA Clippers,LAC @ BOS,110,-6,Regular Season
22022,1610612759,SAS,San Antonio Spurs,0022200527,2022-12-29T00:00:00Z,SAS vs. NYK,122,7,1610612752,NYK,New York Knicks,NYK @ SAS,115,-7,Regular Season
22022,1610612766,CHA,Charlotte Hornets,0022200523,2022-12-29T00:00:00Z,CHA vs. OKC,121,8,1610612760,OKC,Oklahoma City Thunder,OKC @ CHA,113,-8,Regular Season
22022,1610612742,DAL,Dallas Mavericks,0022200528,2022-12-29T00:00:00Z,DAL vs. HOU,129,15,1610612745,HOU,Houston Rockets,HOU @ DAL,114,-15,Regular Season
22022,1610612758,SAC,Sacramento Kings,0022200537,2022-12-30T00:00:00Z,SAC vs. UTA,126,1,1610612762,UTA,Utah Jazz,UTA @ SAC,125,-1,Regular Season
22022,1610612743,DEN,Denver Nuggets,0022200535,2022-12-30T00:00:00Z,DEN vs. MIA,124,5,1610612748,MIA,Miami Heat,MIA @ DEN,119,-5,Regular Season
22022,1610612749,MIL,Milwaukee Bucks,0022200533,2022-12-30T00:00:00Z,MIL vs. MIN,123,9,1610612750,MIN,Minnesota Timberwolves,MIN @ MIL,114,-9,Regular Season
22022,1610612744,GSW,Golden State Warriors,0022200536,2022-12-30T00:00:00Z,GSW vs. POR,118,6,1610612757,POR,Portland Trail Blazers,POR @ GSW,112,-6,Regular Season
22022,1610612740,NOP,New Orleans Pelicans,0022200534,2022-12-30T00:00:00Z,NOP vs. PHI,127,11,1610612755,PHI,Philadelphia 76ers,PHI @ NOP,116,-11,Regular Season
22022,1610612753,ORL,Orlando Magic,0022200529,2022-12-30T00:00:00Z,ORL vs. WAS,100,-19,1610612764,WAS,Washington Wizards,WAS @ ORL,119,19,Regular Season
22022,1610612741,CHI,Chicago Bulls,0022200532,2022-12-30T00:00:00Z,CHI vs. DET,132,14,1610612765,DET,Detroit Pistons,DET @ CHI,118,-14,Regular Season
22022,1610612761,TOR,Toronto Raptors,0022200531,2022-12-30T00:00:00Z,TOR vs. PHX,113,9,1610612756,PHX,Phoenix Suns,PHX @ TOR,104,-9,Regular Season
22022,1610612737,ATL,Atlanta Hawks,0022200530,2022-12-30T00:00:00Z,ATL vs. LAL,121,-9,1610612747,LAL,Los Angeles Lakers,LAL @ ATL,130,9,Regular Season
22022,1610612754,IND,Indiana Pacers,0022200538,2022-12-31T00:00:00Z,IND vs. LAC,131,1,1610612746,LAC,LA Clippers,LAC @ IND,130,-1,Regular Season
22022,1610612759,SAS,San Antonio Spurs,0022200542,2022-12-31T00:00:00Z,SAS vs. DAL,125,-1,1610612742,DAL,Dallas Mavericks,DAL @ SAS,126,1,Regular Season
22022,1610612741,CHI,Chicago Bulls,0022200540,2022-12-31T00:00:00Z,CHI vs. CLE,102,-1,1610612739,CLE,Cleveland Cavaliers,CLE @ CHI,103,1,Regular Season
22022,1610612762,UTA,Utah Jazz,0022200546,2022-12-31T00:00:00Z,UTA vs. MIA,123,-3,1610612748,MIA,Miami Heat,MIA @ UTA,126,3,Regular Season
22022,1610612745,HOU,Houston Rockets,0022200541,2022-12-31T00:00:00Z,HOU vs. NYK,88,-20,1610612752,NYK,New York Knicks,NYK @ HOU,108,20,Regular Season
22022,1610612760,OKC,Oklahoma City Thunder,0022200545,2022-12-31T00:00:00Z,OKC vs. PHI,96,-19,1610612755,PHI,Philadelphia 76ers,PHI @ OKC,115,19,Regular Season
22022,1610612750,MIN,Minnesota Timberwolves,0022200544,2022-12-31T00:00:00Z,MIN vs. DET,104,-12,1610612765,DET,Detroit Pistons,DET @ MIN,116,12,Regular Season
22022,1610612763,MEM,Memphis Grizzlies,0022200543,2022-12-31T00:00:00Z,MEM vs. NOP,116,15,1610612740,NOP,New Orleans Pelicans,NOP @ MEM,101,-15,Regular Season
22022,1610612766,CHA,Charlotte Hornets,0022200539,2022-12-31T00:00:00Z,CHA vs. BKN,106,-17,1610612751,BKN,Brooklyn Nets,BKN @ CHA,123,17,Regular Season
22022,1610612763,MEM,Memphis Grizzlies,0022200547,2023-01-01T00:00:00Z,MEM vs. SAC,118,10,1610612758,SAC,Sacramento Kings,SAC @ MEM,108,-10,Regular Season
22022,1610612743,DEN,Denver Nuggets,0022200549,2023-01-01T00:00:00Z,DEN vs. BOS,123,12,1610612738,BOS,Boston Celtics,BOS @ DEN,111,-12,Regular Season
22022,1610612749,MIL,Milwaukee Bucks,0022200548,2023-01-01T00:00:00Z,MIL vs. WAS,95,-23,1610612764,WAS,Washington Wizards,WAS @ MIL,118,23,Regular Season
22022,1610612744,GSW,Golden State Warriors,0022200558,2023-01-02T00:00:00Z,GSW vs. ATL,143,2,1610612737,ATL,Atlanta Hawks,ATL @ GSW,141,-2,Regular Season
22022,1610612745,HOU,Houston Rockets,0022200556,2023-01-02T00:00:00Z,HOU vs. DAL,106,-5,1610612742,DAL,Dallas Mavericks,DAL @ HOU,111,5,Regular Season
22022,1610612746,LAC,LA Clippers,0022200560,2023-01-02T00:00:00Z,LAC vs. MIA,100,-10,1610612748,MIA,Miami Heat,MIA @ LAC,110,10,Regular Season
22022,1610612751,BKN,Brooklyn Nets,0022200555,2023-01-02T00:00:00Z,BKN vs. SAS,139,36,1610612759,SAS,San Antonio Spurs,SAS @ BKN,103,-36,Regular Season
22022,1610612739,CLE,Cleveland Cavaliers,0022200552,2023-01-02T00:00:00Z,CLE vs. CHI,145,11,1610612741,CHI,Chicago Bulls,CHI @ CLE,134,-11,Regular Season
22022,1610612750,MIN,Minnesota Timberwolves,0022200557,2023-01-02T00:00:00Z,MIN vs. DEN,124,13,1610612743,DEN,Denver Nuggets,DEN @ MIN,111,-13,Regular Season
22022,1610612757,POR,Portland Trail Blazers,0022200559,2023-01-02T00:00:00Z,POR vs. DET,135,29,1610612765,DET,Detroit Pistons,DET @ POR,106,-29,Regular Season
22022,1610612752,NYK,New York Knicks,0022200550,2023-01-02T00:00:00Z,NYK vs. PHX,102,19,1610612756,PHX,Phoenix Suns,PHX @ NYK,83,-19,Regular Season
22022,1610612754,IND,Indiana Pacers,0022200553,2023-01-02T00:00:00Z,IND vs. TOR,122,8,1610612761,TOR,Toronto Raptors,TOR @ IND,114,-8,Regular Season
22022,1610612766,CHA,Charlotte Hornets,0022200551,2023-01-02T00:00:00Z,CHA vs. LAL,115,-6,1610612747,LAL,Los Angeles Lakers,LAL @ CHA,121,6,Regular Season
22022,1610612755,PHI,Philadelphia 76ers,0022200554,2023-01-02T00:00:00Z,PHI vs. NOP,120,9,1610612740,NOP,New Orleans Pelicans,NOP @ PHI,111,-9,Regular Season
22022,1610612760,OKC,Oklahoma City Thunder,0022200562,2023-01-03T00:00:00Z,OKC vs. BOS,150,33,1610612738,BOS,Boston Celtics,BOS @ OKC,117,-33,Regular Season
22022,1610612749,MIL,Milwaukee Bucks,0022200561,2023-01-03T00:00:00Z,MIL vs. WAS,123,10,1610612764,WAS,Washington Wizards,WAS @ MIL,113,-10,Regular Season
22022,1610612762,UTA,Utah Jazz,0022200563,2023-01-03T00:00:00Z,UTA vs. SAC,115,-2,1610612758,SAC,Sacramento Kings,SAC @ UTA,117,2,Regular Season
22022,1610612753,ORL,Orlando Magic,0022200566,2023-01-04T00:00:00Z,ORL vs. OKC,126,11,1610612760,OKC,Oklahoma City Thunder,OKC @ ORL,115,-11,Regular Season
22022,1610612739,CLE,Cleveland Cavaliers,0022200565,2023-01-04T00:00:00Z,CLE vs. PHX,90,2,1610612756,PHX,Phoenix Suns,PHX @ CLE,88,-2,Regular Season
22022,1610612755,PHI,Philadelphia 76ers,0022200567,2023-01-04T00:00:00Z,PHI vs. IND,129,3,1610612754,IND,Indiana Pacers,IND @ PHI,126,-3,Regular Season
22022,1610612747,LAL,Los Angeles Lakers,0022200574,2023-01-04T00:00:00Z,LAL vs. MIA,112,3,1610612748,MIA,Miami Heat,MIA @ LAL,109,-3,Regular Season
22022,1610612744,GSW,Golden State Warriors,0022200573,2023-01-04T00:00:00Z,GSW vs. DET,119,-3,1610612765,DET,Detroit Pistons,DET @ GSW,122,3,Regular Season
22022,1610612758,SAC,Sacramento Kings,0022200575,2023-01-04T00:00:00Z,SAC vs. ATL,117,-3,1610612737,ATL,Atlanta Hawks,ATL @ SAC,120,3,Regular Season
22022,1610612750,MIN,Minnesota Timberwolves,0022200571,2023-01-04T00:00:00Z,MIN vs. POR,113,7,1610612757,POR,Portland Trail Blazers,POR @ MIN,106,-7,Regular Season
22022,1610612741,CHI,Chicago Bulls,0022200570,2023-01-04T00:00:00Z,CHI vs. BKN,121,9,1610612751,BKN,Brooklyn Nets,BKN @ CHI,112,-9,Regular Season
22022,1610612761,TOR,Toronto Raptors,0022200569,2023-01-04T00:00:00Z,TOR vs. MIL,101,-3,1610612749,MIL,Milwaukee Bucks,MIL @ TOR,104,3,Regular Season
22022,1610612740,NOP,New Orleans Pelicans,0022200572,2023-01-04T00:00:00Z,NOP vs. HOU,119,11,1610612745,HOU,Houston Rockets,HOU @ NOP,108,-11,Regular Season
22022,1610612766,CHA,Charlotte Hornets,0022200564,2023-01-04T00:00:00Z,CHA vs. MEM,107,-24,1610612763,MEM,Memphis Grizzlies,MEM @ CHA,131,24,Regular Season
22022,1610612752,NYK,New York Knicks,0022200568,2023-01-04T00:00:00Z,NYK vs. SAS,117,3,1610612759,SAS,San Antonio Spurs,SAS @ NYK,114,-3,Regular Season
22022,1610612742,DAL,Dallas Mavericks,0022200577,2023-01-05T00:00:00Z,DAL vs. BOS,95,-29,1610612738,BOS,Boston Celtics,BOS @ DAL,124,29,Regular Season
22022,1610612745,HOU,Houston Rockets,0022200578,2023-01-05T00:00:00Z,HOU vs. UTA,114,-17,1610612762,UTA,Utah Jazz,UTA @ HOU,131,17,Regular Season
22022,1610612743,DEN,Denver Nuggets,0022200579,2023-01-05T00:00:00Z,DEN vs. LAC,122,31,1610612746,LAC,LA Clippers,LAC @ DEN,91,-31,Regular Season
22022,1610612753,ORL,Orlando Magic,0022200576,2023-01-05T00:00:00Z,ORL vs. MEM,115,-8,1610612763,MEM,Memphis Grizzlies,MEM @ ORL,123,8,Regular Season
22022,1610612759,SAS,San Antonio Spurs,0022200585,2023-01-06T00:00:00Z,SAS vs. DET,121,12,1610612765,DET,Detroit Pistons,DET @ SAS,109,-12,Regular Season
22022,1610612747,LAL,Los Angeles Lakers,0022200590,2023-01-06T00:00:00Z,LAL vs. ATL,130,16,1610612737,ATL,Atlanta Hawks,ATL @ LAL,114,-16,Regular Season
22022,1610612740,NOP,New Orleans Pelicans,0022200586,2023-01-06T00:00:00Z,NOP vs. BKN,102,-6,1610612751,BKN,Brooklyn Nets,BKN @ NOP,108,6,Regular Season
22022,1610612755,PHI,Philadelphia 76ers,0022200581,2023-01-06T00:00:00Z,PHI vs. CHI,112,-14,1610612741,CHI,Chicago Bulls,CHI @ PHI,126,14,Regular Season
22022,1610612754,IND,Indiana Pacers,0022200580,2023-01-06T00:00:00Z,IND vs. POR,108,9,1610612757,POR,Portland Trail Blazers,POR @ IND,99,-9,Regular Season
22022,1610612761,TOR,Toronto Raptors,0022200582,2023-01-06T00:00:00Z,TOR vs. NYK,108,-4,1610612752,NYK,New York Knicks,NYK @ TOR,112,4,Regular Season
22022,1610612749,MIL,Milwaukee Bucks,0022200583,2023-01-06T00:00:00Z,MIL vs. CHA,109,-29,1610612766,CHA,Charlotte Hornets,CHA @ MIL,138,29,Regular Season
22022,1610612760,OKC,Oklahoma City Thunder,0022200584,2023-01-06T00:00:00Z,OKC vs. WAS,127,17,1610612764,WAS,Washington Wizards,WAS @ OKC,110,-17,Regular Season
22022,1610612743,DEN,Denver Nuggets,0022200588,2023-01-06T00:00:00Z,DEN vs. CLE,121,13,1610612739,CLE,Cleveland Cavaliers,CLE @ DEN,108,-13,Regular Season
22022,1610612750,MIN,Minnesota Timberwolves,0022200587,2023-01-06T00:00:00Z,MIN vs. LAC,128,13,1610612746,LAC,LA Clippers,LAC @ MIN,115,-13,Regular Season
22022,1610612756,PHX,Phoenix Suns,0022200589,2023-01-06T00:00:00Z,PHX vs. MIA,96,-8,1610612748,MIA,Miami Heat,MIA @ PHX,104,8,Regular Season
22022,1610612758,SAC,Sacramento Kings,0022200595,2023-01-07T00:00:00Z,SAC vs. LAL,134,-2,1610612747,LAL,Los Angeles Lakers,LAL @ SAC,136,2,Regular Season
22022,1610612741,CHI,Chicago Bulls,0022200592,2023-01-07T00:00:00Z,CHI vs. UTA,126,8,1610612762,UTA,Utah Jazz,UTA @ CHI,118,-8,Regular Season
22022,1610612744,GSW,Golden State Warriors,0022200594,2023-01-07T00:00:00Z,GSW vs. ORL,101,-14,1610612753,ORL,Orlando Magic,ORL @ GSW,115,14,Regular Season
22022,1610612759,SAS,San Antonio Spurs,0022200591,2023-01-07T00:00:00Z,SAS vs. BOS,116,-5,1610612738,BOS,Boston Celtics,BOS @ SAS,121,5,Regular Season
22022,1610612742,DAL,Dallas Mavericks,0022200593,2023-01-07T00:00:00Z,DAL vs. NOP,127,10,1610612740,NOP,New Orleans Pelicans,NOP @ DAL,117,-10,Regular Season
22022,1610612748,MIA,Miami Heat,0022200599,2023-01-08T00:00:00Z,MIA vs. BKN,101,-1,1610612751,BKN,Brooklyn Nets,BKN @ MIA,102,1,Regular Season
22022,1610612765,DET,Detroit Pistons,0022200596,2023-01-08T00:00:00Z,DET vs. PHI,111,-12,1610612755,PHI,Philadelphia 76ers,PHI @ DET,123,12,Regular Season
22022,1610612760,OKC,Oklahoma City Thunder,0022200602,2023-01-08T00:00:00Z,OKC vs. DAL,120,11,1610612742,DAL,Dallas Mavericks,DAL @ OKC,109,-11,Regular Season
22022,1610612756,PHX,Phoenix Suns,0022200603,2023-01-08T00:00:00Z,PHX vs. CLE,98,-14,1610612739,CLE,Cleveland Cavaliers,CLE @ PHX,112,14,Regular Season
22022,1610612746,LAC,LA Clippers,0022200604,2023-01-08T00:00:00Z,LAC vs. ATL,108,-4,1610612737,ATL,Atlanta Hawks,ATL @ LAC,112,4,Regular Season
22022,1610612754,IND,Indiana Pacers,0022200598,2023-01-08T00:00:00Z,IND vs. CHA,116,5,1610612766,CHA,Charlotte Hornets,CHA @ IND,111,-5,Regular Season
22022,1610612763,MEM,Memphis Grizzlies,0022200600,2023-01-08T00:00:00Z,MEM vs. UTA,123,5,1610612762,UTA,Utah Jazz,UTA @ MEM,118,-5,Regular Season
22022,1610612761,TOR,Toronto Raptors,0022200597,2023-01-08T00:00:00Z,TOR vs. POR,117,12,1610612757,POR,Portland Trail Blazers,POR @ TOR,105,-12,Regular Season
22022,1610612745,HOU,Houston Rockets,0022200601,2023-01-08T00:00:00Z,HOU vs. MIN,96,-8,1610612750,MIN,Minnesota Timberwolves,MIN @ HOU,104,8,Regular Season
22022,1610612752,NYK,New York Knicks,0022200607,2023-01-09T00:00:00Z,NYK vs. MIL,107,-4,1610612749,MIL,Milwaukee Bucks,MIL @ NYK,111,4,Regular Season
22022,1610612763,MEM,Memphis Grizzlies,0022200608,2023-01-09T00:00:00Z,MEM vs. SAS,121,8,1610612759,SAS,San Antonio Spurs,SAS @ MEM,113,-8,Regular Season
22022,1610612743,DEN,Denver Nuggets,0022200609,2023-01-09T00:00:00Z,DEN vs. LAL,122,13,1610612747,LAL,Los Angeles Lakers,LAL @ DEN,109,-13,Regular Season
22022,1610612764,WAS,Washington Wizards,0022200605,2023-01-09T00:00:00Z,WAS vs. NOP,112,-20,1610612740,NOP,New Orleans Pelicans,NOP @ WAS,132,20,Regular Season
22022,1610612738,BOS,Boston Celtics,0022200606,2023-01-09T00:00:00Z,BOS vs. CHI,107,8,1610612741,CHI,Chicago Bulls,CHI @ BOS,99,-8,Regular Season
22022,1610612758,SAC,Sacramento Kings,0022200610,2023-01-09T00:00:00Z,SAC vs. ORL,136,25,1610612753,ORL,Orlando Magic,ORL @ SAC,111,-25,Regular Season
22022,1610612757,POR,Portland Trail Blazers,0022200616,2023-01-10T00:00:00Z,POR vs. ORL,106,-3,1610612753,ORL,Orlando Magic,ORL @ POR,109,3,Regular Season
22022,1610612744,GSW,Golden State Warriors,0022200615,2023-01-10T00:00:00Z,GSW vs. PHX,113,-12,1610612756,PHX,Phoenix Suns,PHX @ GSW,125,12,Regular Season
22022,1610612746,LAC,LA Clippers,0022200617,2023-01-10T00:00:00Z,LAC vs. DAL,113,12,1610612742,DAL,Dallas Mavericks,DAL @ LAC,101,-12,Regular Season
22022,1610612755,PHI,Philadelphia 76ers,0022200612,2023-01-10T00:00:00Z,PHI vs. DET,147,31,1610612765,DET,Detroit Pistons,DET @ PHI,116,-31,Regular Season
22022,1610612762,UTA,Utah Jazz,0022200614,2023-01-10T00:00:00Z,UTA vs. CLE,116,2,1610612739,CLE,Cleveland Cavaliers,CLE @ UTA,114,-2,Regular Season
22022,1610612761,TOR,Toronto Raptors,0022200613,2023-01-10T00:00:00Z,TOR vs. CHA,132,12,1610612766,CHA,Charlotte Hornets,CHA @ TOR,120,-12,Regular Season
22022,1610612748,MIA,Miami Heat,0022200611,2023-01-10T00:00:00Z,MIA vs. OKC,112,1,1610612760,OKC,Oklahoma City Thunder,OKC @ MIA,111,-1,Regular Season
22022,1610612758,SAC,Sacramento Kings,0022200625,2023-01-11T00:00:00Z,SAC vs. HOU,135,20,1610612745,HOU,Houston Rockets,HOU @ SAC,115,-20,Regular Season
22022,1610612743,DEN,Denver Nuggets,0022200624,2023-01-11T00:00:00Z,DEN vs. PHX,126,29,1610612756,PHX,Phoenix Suns,PHX @ DEN,97,-29,Regular Season
22022,1610612763,MEM,Memphis Grizzlies,0022200623,2023-01-11T00:00:00Z,MEM vs. SAS,135,6,1610612759,SAS,San Antonio Spurs,SAS @ MEM,129,-6,Regular Season
22022,1610612737,ATL,Atlanta Hawks,0022200620,2023-01-11T00:00:00Z,ATL vs. MIL,105,-9,1610612749,MIL,Milwaukee Bucks,MIL @ ATL,114,9,Regular Season
22022,1610612752,NYK,New York Knicks,0022200622,2023-01-11T00:00:00Z,NYK vs. IND,119,6,1610612754,IND,Indiana Pacers,IND @ NYK,113,-6,Regular Season
22022,1610612738,BOS,Boston Celtics,0022200621,2023-01-11T00:00:00Z,BOS vs. NOP,125,11,1610612740,NOP,New Orleans Pelicans,NOP @ BOS,114,-11,Regular Season
22022,1610612764,WAS,Washington Wizards,0022200619,2023-01-11T00:00:00Z,WAS vs. CHI,100,3,1610612741,CHI,Chicago Bulls,CHI @ WAS,97,-3,Regular Season
22022,1610612765,DET,Detroit Pistons,0022200618,2023-01-11T00:00:00Z,DET vs. MIN,135,17,1610612750,MIN,Minnesota Timberwolves,MIN @ DET,118,-17,Regular Season
22022,1610612748,MIA,Miami Heat,0022200628,2023-01-12T00:00:00Z,MIA vs. MIL,108,6,1610612749,MIL,Milwaukee Bucks,MIL @ MIA,102,-6,Regular Season
22022,1610612751,BKN,Brooklyn Nets,0022200627,2023-01-12T00:00:00Z,BKN vs. BOS,98,-11,1610612738,BOS,Boston Celtics,BOS @ BKN,109,11,Regular Season
22022,1610612761,TOR,Toronto Raptors,0022200629,2023-01-12T00:00:00Z,TOR vs. CHA,124,10,1610612766,CHA,Charlotte Hornets,CHA @ TOR,114,-10,Regular Season
22022,1610612757,POR,Portland Trail Blazers,0022200631,2023-01-12T00:00:00Z,POR vs. CLE,113,-6,1610612739,CLE,Cleveland Cavaliers,CLE @ POR,119,6,Regular Season
22022,1610612747,LAL,Los Angeles Lakers,0022200630,2023-01-12T00:00:00Z,LAL vs. DAL,115,-4,1610612742,DAL,Dallas Mavericks,DAL @ LAL,119,4,Regular Season
22022,1610612755,PHI,Philadelphia 76ers,0022200626,2023-01-12T00:00:00Z,PHI vs. OKC,114,-19,1610612760,OKC,Oklahoma City Thunder,OKC @ PHI,133,19,Regular Season
22022,1610612765,DET,Detroit Pistons,0022200632,2023-01-13T00:00:00Z,DET vs. NOP,110,-6,1610612740,NOP,New Orleans Pelicans,NOP @ DET,116,6,Regular Season
22022,1610612764,WAS,Washington Wizards,0022200634,2023-01-13T00:00:00Z,WAS vs. NYK,108,-4,1610612752,NYK,New York Knicks,NYK @ WAS,112,4,Regular Season
22022,1610612754,IND,Indiana Pacers,0022200633,2023-01-13T00:00:00Z,IND vs. ATL,111,-2,1610612737,ATL,Atlanta Hawks,ATL @ IND,113,2,Regular Season
22022,1610612759,SAS,San Antonio Spurs,0022200635,2023-01-13T00:00:00Z,SAS vs. GSW,113,-31,1610612744,GSW,Golden State Warriors,GSW @ SAS,144,31,Regular Season
22022,1610612750,MIN,Minnesota Timberwolves,0022200637,2023-01-13T00:00:00Z,MIN vs. PHX,121,5,1610612756,PHX,Phoenix Suns,PHX @ MIN,116,-5,Regular Season
22022,1610612741,CHI,Chicago Bulls,0022200636,2023-01-13T00:00:00Z,CHI vs. OKC,110,-14,1610612760,OKC,Oklahoma City Thunder,OKC @ CHI,124,14,Regular Season
22022,1610612762,UTA,Utah Jazz,0022200638,2023-01-13T00:00:00Z,UTA vs. ORL,112,4,1610612753,ORL,Orlando Magic,ORL @ UTA,108,-4,Regular Season
22022,1610612746,LAC,LA Clippers,0022200639,2023-01-13T00:00:00Z,LAC vs. DEN,103,-12,1610612743,DEN,Denver Nuggets,DEN @ LAC,115,12,Regular Season
22022,1610612758,SAC,Sacramento Kings,0022200640,2023-01-13T00:00:00Z,SAC vs. HOU,139,25,1610612745,HOU,Houston Rockets,HOU @ SAC,114,-25,Regular Season
22022,1610612766,CHA,Charlotte Hornets,0022200642,2023-01-14T00:00:00Z,CHA vs. BOS,106,-16,1610612738,BOS,Boston Celtics,BOS @ CHA,122,16,Regular Season
22022,1610612748,MIA,Miami Heat,0022200641,2023-01-14T00:00:00Z,MIA vs. MIL,111,16,1610612749,MIL,Milwaukee Bucks,MIL @ MIA,95,-16,Regular Season
22022,1610612761,TOR,Toronto Raptors,0022200644,2023-01-14T00:00:00Z,TOR vs. ATL,103,-11,1610612737,ATL,Atlanta Hawks,ATL @ TOR,114,11,Regular Season
22022,1610612754,IND,Indiana Pacers,0022200643,2023-01-14T00:00:00Z,IND vs. MEM,112,-18,1610612763,MEM,Memphis Grizzlies,MEM @ IND,130,18,Regular Season
22022,1610612757,POR,Portland Trail Blazers,0022200647,2023-01-14T00:00:00Z,POR vs. DAL,136,17,1610612742,DAL,Dallas Mavericks,DAL @ POR,119,-17,Regular Season
22022,1610612750,MIN,Minnesota Timberwolves,0022200645,2023-01-14T00:00:00Z,MIN vs. CLE,110,8,1610612739,CLE,Cleveland Cavaliers,CLE @ MIN,102,-8,Regular Season
22022,1610612762,UTA,Utah Jazz,0022200646,2023-01-14T00:00:00Z,UTA vs. PHI,117,-1,1610612755,PHI,Philadelphia 76ers,PHI @ UTA,118,1,Regular Season
22022,1610612741,CHI,Chicago Bulls,0022200650,2023-01-15T00:00:00Z,CHI vs. GSW,132,14,1610612744,GSW,Golden State Warriors,GSW @ CHI,118,-14,Regular Season
22022,1610612747,LAL,Los Angeles Lakers,0022200655,2023-01-15T00:00:00Z,LAL vs. PHI,112,-1,1610612755,PHI,Philadelphia 76ers,PHI @ LAL,113,1,Regular Season
22022,1610612751,BKN,Brooklyn Nets,0022200651,2023-01-15T00:00:00Z,BKN vs. OKC,102,-10,1610612760,OKC,Oklahoma City Thunder,OKC @ BKN,112,10,Regular Season
22022,1610612757,POR,Portland Trail Blazers,0022200654,2023-01-15T00:00:00Z,POR vs. DAL,140,17,1610612742,DAL,Dallas Mavericks,DAL @ POR,123,-17,Regular Season
22022,1610612746,LAC,LA Clippers,0022200649,2023-01-15T00:00:00Z,LAC vs. HOU,121,21,1610612745,HOU,Houston Rockets,HOU @ LAC,100,-21,Regular Season
22022,1610612743,DEN,Denver Nuggets,0022200653,2023-01-15T00:00:00Z,DEN vs. ORL,119,3,1610612753,ORL,Orlando Magic,ORL @ DEN,116,-3,Regular Season
22022,1610612759,SAS,San Antonio Spurs,0022200652,2023-01-15T00:00:00Z,SAS vs. SAC,119,-13,1610612758,SAC,Sacramento Kings,SAC @ SAS,132,13,Regular Season
22022,1610612765,DET,Detroit Pistons,0022200648,2023-01-15T00:00:00Z,DET vs. NYK,104,-13,1610612752,NYK,New York Knicks,NYK @ DET,117,13,Regular Season
22022,1610612750,MIN,Minnesota Timberwolves,0022200662,2023-01-16T00:00:00Z,MIN vs. UTA,125,-1,1610612762,UTA,Utah Jazz,UTA @ MIN,126,1,Regular Season
22022,1610612752,NYK,New York Knicks,0022200659,2023-01-16T00:00:00Z,NYK vs. TOR,121,-2,1610612761,TOR,Toronto Raptors,TOR @ NYK,123,2,Regular Season
22022,1610612747,LAL,Los Angeles Lakers,0022200664,2023-01-16T00:00:00Z,LAL vs. HOU,140,8,1610612745,HOU,Houston Rockets,HOU @ LAL,132,-8,Regular Season
22022,1610612737,ATL,Atlanta Hawks,0022200661,2023-01-16T00:00:00Z,ATL vs. MIA,121,8,1610612748,MIA,Miami Heat,MIA @ ATL,113,-8,Regular Season
22022,1610612739,CLE,Cleveland Cavaliers,0022200658,2023-01-16T00:00:00Z,CLE vs. NOP,113,10,1610612740,NOP,New Orleans Pelicans,NOP @ CLE,103,-10,Regular Season
22022,1610612763,MEM,Memphis Grizzlies,0022200663,2023-01-16T00:00:00Z,MEM vs. PHX,136,30,1610612756,PHX,Phoenix Suns,PHX @ MEM,106,-30,Regular Season
22022,1610612749,MIL,Milwaukee Bucks,0022200657,2023-01-16T00:00:00Z,MIL vs. IND,132,13,1610612754,IND,Indiana Pacers,IND @ MIL,119,-13,Regular Season
22022,1610612764,WAS,Washington Wizards,0022200660,2023-01-16T00:00:00Z,WAS vs. GSW,118,-9,1610612744,GSW,Golden State Warriors,GSW @ WAS,127,9,Regular Season
22022,1610612766,CHA,Charlotte Hornets,0022200656,2023-01-16T00:00:00Z,CHA vs. BOS,118,-12,1610612738,BOS,Boston Celtics,BOS @ CHA,130,12,Regular Season
22022,1610612749,MIL,Milwaukee Bucks,0022200665,2023-01-17T00:00:00Z,MIL vs. TOR,130,8,1610612761,TOR,Toronto Raptors,TOR @ MIL,122,-8,Regular Season
22022,1610612759,SAS,San Antonio Spurs,0022200666,2023-01-17T00:00:00Z,SAS vs. BKN,106,8,1610612751,BKN,Brooklyn Nets,BKN @ SAS,98,-8,Regular Season
22022,1610612743,DEN,Denver Nuggets,0022200667,2023-01-17T00:00:00Z,DEN vs. POR,122,9,1610612757,POR,Portland Trail Blazers,POR @ DEN,113,-9,Regular Season
22022,1610612746,LAC,LA Clippers,0022200668,2023-01-17T00:00:00Z,LAC vs. PHI,110,-10,1610612755,PHI,Philadelphia 76ers,PHI @ LAC,120,10,Regular Season
22022,1610612763,MEM,Memphis Grizzlies,0022200672,2023-01-18T00:00:00Z,MEM vs. CLE,115,1,1610612739,CLE,Cleveland Cavaliers,CLE @ MEM,114,-1,Regular Season
22022,1610612752,NYK,New York Knicks,0022200669,2023-01-18T00:00:00Z,NYK vs. WAS,105,-11,1610612764,WAS,Washington Wizards,WAS @ NYK,116,11,Regular Season
22022,1610612742,DAL,Dallas Mavericks,0022200670,2023-01-18T00:00:00Z,DAL vs. ATL,122,-8,1610612737,ATL,Atlanta Hawks,ATL @ DAL,130,8,Regular Season
22022,1610612747,LAL,Los Angeles Lakers,0022200677,2023-01-18T00:00:00Z,LAL vs. SAC,111,-5,1610612758,SAC,Sacramento Kings,SAC @ LAL,116,5,Regular Season
22022,1610612743,DEN,Denver Nuggets,0022200676,2023-01-18T00:00:00Z,DEN vs. MIN,122,4,1610612750,MIN,Minnesota Timberwolves,MIN @ DEN,118,-4,Regular Season
22022,1610612745,HOU,Houston Rockets,0022200671,2023-01-18T00:00:00Z,HOU vs. CHA,117,-5,1610612766,CHA,Charlotte Hornets,CHA @ HOU,122,5,Regular Season
22022,1610612740,NOP,New Orleans Pelicans,0022200673,2023-01-18T00:00:00Z,NOP vs. MIA,98,-26,1610612748,MIA,Miami Heat,MIA @ NOP,124,26,Regular Season
22022,1610612760,OKC,Oklahoma City Thunder,0022200674,2023-01-18T00:00:00Z,OKC vs. IND,126,20,1610612754,IND,Indiana Pacers,IND @ OKC,106,-20,Regular Season
22022,1610612762,UTA,Utah Jazz,0022200675,2023-01-18T00:00:00Z,UTA vs. LAC,126,23,1610612746,LAC,LA Clippers,LAC @ UTA,103,-23,Regular Season
22022,1610612738,BOS,Boston Celtics,0022200679,2023-01-19T00:00:00Z,BOS vs. GSW,121,3,1610612744,GSW,Golden State Warriors,GSW @ BOS,118,-3,Regular Season
22022,1610612750,MIN,Minnesota Timberwolves,0022200680,2023-01-19T00:00:00Z,MIN vs. TOR,128,2,1610612761,TOR,Toronto Raptors,TOR @ MIN,126,-2,Regular Season
22022,1610612757,POR,Portland Trail Blazers,0022200682,2023-01-19T00:00:00Z,POR vs. PHI,95,-10,1610612755,PHI,Philadelphia 76ers,PHI @ POR,105,10,Regular Season
22022,1610612756,PHX,Phoenix Suns,0022200681,2023-01-19T00:00:00Z,PHX vs. BKN,117,5,1610612751,BKN,Brooklyn Nets,BKN @ PHX,112,-5,Regular Season
22022,1610612765,DET,Detroit Pistons,0022200678,2023-01-19T00:00:00Z,DET vs. CHI,108,-18,1610612741,CHI,Chicago Bulls,CHI @ DET,126,18,Regular Season
22022,1610612739,CLE,Cleveland Cavaliers,0022200685,2023-01-20T00:00:00Z,CLE vs. GSW,114,-6,1610612744,GSW,Golden State Warriors,GSW @ CLE,120,6,Regular Season
22022,1610612758,SAC,Sacramento Kings,0022200691,2023-01-20T00:00:00Z,SAC vs. OKC,118,5,1610612760,OKC,Oklahoma City Thunder,OKC @ SAC,113,-5,Regular Season
22022,1610612747,LAL,Los Angeles Lakers,0022200690,2023-01-20T00:00:00Z,LAL vs. MEM,122,1,1610612763,MEM,Memphis Grizzlies,MEM @ LAL,121,-1,Regular Season
22022,1610612743,DEN,Denver Nuggets,0022200688,2023-01-20T00:00:00Z,DEN vs. IND,134,23,1610612754,IND,Indiana Pacers,IND @ DEN,111,-23,Regular Season
22022,1610612762,UTA,Utah Jazz,0022200689,2023-01-20T00:00:00Z,UTA vs. BKN,106,-11,1610612751,BKN,Brooklyn Nets,BKN @ UTA,117,11,Regular Season
22022,1610612742,DAL,Dallas Mavericks,0022200686,2023-01-20T00:00:00Z,DAL vs. MIA,115,25,1610612748,MIA,Miami Heat,MIA @ DAL,90,-25,Regular Season
22022,1610612759,SAS,San Antonio Spurs,0022200687,2023-01-20T00:00:00Z,SAS vs. LAC,126,-5,1610612746,LAC,LA Clippers,LAC @ SAS,131,5,Regular Season
22022,1610612737,ATL,Atlanta Hawks,0022200684,2023-01-20T00:00:00Z,ATL vs. NYK,139,15,1610612752,NYK,New York Knicks,NYK @ ATL,124,-15,Regular Season
22022,1610612753,ORL,Orlando Magic,0022200683,2023-01-20T00:00:00Z,ORL vs. NOP,123,13,1610612740,NOP,New Orleans Pelicans,NOP @ ORL,110,-13,Regular Season
22022,1610612737,ATL,Atlanta Hawks,0022200694,2023-01-21T00:00:00Z,ATL vs. CHA,118,-4,1610612766,CHA,Charlotte Hornets,CHA @ ATL,122,4,Regular Season
22022,1610612761,TOR,Toronto Raptors,0022200692,2023-01-21T00:00:00Z,TOR vs. BOS,104,-2,1610612738,BOS,Boston Celtics,BOS @ TOR,106,2,Regular Season
22022,1610612758,SAC,Sacramento Kings,0022200698,2023-01-21T00:00:00Z,SAC vs. PHI,127,-2,1610612755,PHI,Philadelphia 76ers,PHI @ SAC,129,2,Regular Season
22022,1610612756,PHX,Phoenix Suns,0022200697,2023-01-21T00:00:00Z,PHX vs. IND,112,5,1610612754,IND,Indiana Pacers,IND @ PHX,107,-5,Regular Season
22022,1610612750,MIN,Minnesota Timberwolves,0022200696,2023-01-21T00:00:00Z,MIN vs. HOU,113,9,1610612745,HOU,Houston Rockets,HOU @ MIN,104,-9,Regular Season
22022,1610612739,CLE,Cleveland Cavaliers,0022200695,2023-01-21T00:00:00Z,CLE vs. MIL,114,12,1610612749,MIL,Milwaukee Bucks,MIL @ CLE,102,-12,Regular Season
22022,1610612764,WAS,Washington Wizards,0022200693,2023-01-21T00:00:00Z,WAS vs. ORL,138,20,1610612753,ORL,Orlando Magic,ORL @ WAS,118,-20,Regular Season
22022,1610612761,TOR,Toronto Raptors,0022200700,2023-01-22T00:00:00Z,TOR vs. NYK,125,9,1610612752,NYK,New York Knicks,NYK @ TOR,116,-9,Regular Season
22022,1610612742,DAL,Dallas Mavericks,0022200701,2023-01-22T00:00:00Z,DAL vs. LAC,98,-14,1610612746,LAC,LA Clippers,LAC @ DAL,112,14,Regular Season
22022,1610612743,DEN,Denver Nuggets,0022200702,2023-01-22T00:00:00Z,DEN vs. OKC,99,-2,1610612760,OKC,Oklahoma City Thunder,OKC @ DEN,101,2,Regular Season
22022,1610612744,GSW,Golden State Warriors,0022200704,2023-01-22T00:00:00Z,GSW vs. BKN,116,-4,1610612751,BKN,Brooklyn Nets,BKN @ GSW,120,4,Regular Season
22022,1610612757,POR,Portland Trail Blazers,0022200705,2023-01-22T00:00:00Z,POR vs. LAL,112,-9,1610612747,LAL,Los Angeles Lakers,LAL @ POR,121,9,Regular Season
22022,1610612748,MIA,Miami Heat,0022200699,2023-01-22T00:00:00Z,MIA vs. NOP,100,4,1610612740,NOP,New Orleans Pelicans,NOP @ MIA,96,-4,Regular Season
22022,1610612756,PHX,Phoenix Suns,0022200703,2023-01-22T00:00:00Z,PHX vs. MEM,112,2,1610612763,MEM,Memphis Grizzlies,MEM @ PHX,110,-2,Regular Season
22022,1610612765,DET,Detroit Pistons,0022200706,2023-01-23T00:00:00Z,DET vs. MIL,130,-20,1610612749,MIL,Milwaukee Bucks,MIL @ DET,150,20,Regular Season
22022,1610612758,SAC,Sacramento Kings,0022200712,2023-01-23T00:00:00Z,SAC vs. MEM,133,33,1610612763,MEM,Memphis Grizzlies,MEM @ SAC,100,-33,Regular Season
22022,1610612753,ORL,Orlando Magic,0022200707,2023-01-23T00:00:00Z,ORL vs. BOS,113,15,1610612738,BOS,Boston Celtics,BOS @ ORL,98,-15,Regular Season
22022,1610612757,POR,Portland Trail Blazers,0022200711,2023-01-23T00:00:00Z,POR vs. SAS,147,20,1610612759,SAS,San Antonio Spurs,SAS @ POR,127,-20,Regular Season
22022,1610612745,HOU,Houston Rockets,0022200709,2023-01-23T00:00:00Z,HOU vs. MIN,119,5,1610612750,MIN,Minnesota Timberwolves,MIN @ HOU,114,-5,Regular Season
22022,1610612762,UTA,Utah Jazz,0022200710,2023-01-23T00:00:00Z,UTA vs. CHA,120,18,1610612766,CHA,Charlotte Hornets,CHA @ UTA,102,-18,Regular Season
22022,1610612741,CHI,Chicago Bulls,0022200708,2023-01-23T00:00:00Z,CHI vs. ATL,111,11,1610612737,ATL,Atlanta Hawks,ATL @ CHI,100,-11,Regular Season
22022,1610612754,IND,Indiana Pacers,0022200713,2023-01-24T00:00:00Z,IND vs. CHI,116,6,1610612741,CHI,Chicago Bulls,CHI @ IND,110,-6,Regular Season
22022,1610612756,PHX,Phoenix Suns,0022200718,2023-01-24T00:00:00Z,PHX vs. CHA,128,31,1610612766,CHA,Charlotte Hornets,CHA @ PHX,97,-31,Regular Season
22022,1610612747,LAL,Los Angeles Lakers,0022200719,2023-01-24T00:00:00Z,LAL vs. LAC,115,-18,1610612746,LAC,LA Clippers,LAC @ LAL,133,18,Regular Season
22022,1610612752,NYK,New York Knicks,0022200715,2023-01-24T00:00:00Z,NYK vs. CLE,105,2,1610612739,CLE,Cleveland Cavaliers,CLE @ NYK,103,-2,Regular Season
22022,1610612740,NOP,New Orleans Pelicans,0022200716,2023-01-24T00:00:00Z,NOP vs. DEN,98,-1,1610612743,DEN,Denver Nuggets,DEN @ NOP,99,1,Regular Season
22022,1610612742,DAL,Dallas Mavericks,0022200717,2023-01-24T00:00:00Z,DAL vs. WAS,126,-1,1610612764,WAS,Washington Wizards,WAS @ DAL,127,1,Regular Season
22022,1610612748,MIA,Miami Heat,0022200714,2023-01-24T00:00:00Z,MIA vs. BOS,98,3,1610612738,BOS,Boston Celtics,BOS @ MIA,95,-3,Regular Season
22022,1610612755,PHI,Philadelphia 76ers,0022200721,2023-01-25T00:00:00Z,PHI vs. BKN,137,4,1610612751,BKN,Brooklyn Nets,BKN @ PHI,133,-4,Regular Season
22022,1610612760,OKC,Oklahoma City Thunder,0022200725,2023-01-25T00:00:00Z,OKC vs. ATL,132,-5,1610612737,ATL,Atlanta Hawks,ATL @ OKC,137,5,Regular Season
22022,1610612753,ORL,Orlando Magic,0022200720,2023-01-25T00:00:00Z,ORL vs. IND,126,6,1610612754,IND,Indiana Pacers,IND @ ORL,120,-6,Regular Season
22022,1610612749,MIL,Milwaukee Bucks,0022200723,2023-01-25T00:00:00Z,MIL vs. DEN,107,8,1610612743,DEN,Denver Nuggets,DEN @ MIL,99,-8,Regular Season
22022,1610612740,NOP,New Orleans Pelicans,0022200724,2023-01-25T00:00:00Z,NOP vs. MIN,102,-9,1610612750,MIN,Minnesota Timberwolves,MIN @ NOP,111,9,Regular Season
22022,1610612747,LAL,Los Angeles Lakers,0022200729,2023-01-25T00:00:00Z,LAL vs. SAS,113,9,1610612759,SAS,San Antonio Spurs,SAS @ LAL,104,-9,Regular Season
22022,1610612745,HOU,Houston Rockets,0022200722,2023-01-25T00:00:00Z,HOU vs. WAS,103,-5,1610612764,WAS,Washington Wizards,WAS @ HOU,108,5,Regular Season
22022,1610612757,POR,Portland Trail Blazers,0022200727,2023-01-25T00:00:00Z,POR vs. UTA,134,10,1610612762,UTA,Utah Jazz,UTA @ POR,124,-10,Regular Season
22022,1610612744,GSW,Golden State Warriors,0022200726,2023-01-25T00:00:00Z,GSW vs. MEM,122,2,1610612763,MEM,Memphis Grizzlies,MEM @ GSW,120,-2,Regular Season
22022,1610612758,SAC,Sacramento Kings,0022200728,2023-01-25T00:00:00Z,SAC vs. TOR,95,-18,1610612761,TOR,Toronto Raptors,TOR @ SAC,113,18,Regular Season
22022,1610612738,BOS,Boston Celtics,0022200730,2023-01-26T00:00:00Z,BOS vs. NYK,117,-3,1610612752,NYK,New York Knicks,NYK @ BOS,120,3,Regular Season
22022,1610612756,PHX,Phoenix Suns,0022200734,2023-01-26T00:00:00Z,PHX vs. DAL,95,-4,1610612742,DAL,Dallas Mavericks,DAL @ PHX,99,4,Regular Season
22022,1610612746,LAC,LA Clippers,0022200735,2023-01-26T00:00:00Z,LAC vs. SAS,138,38,1610612759,SAS,San Antonio Spurs,SAS @ LAC,100,-38,Regular Season
22022,1610612745,HOU,Houston Rockets,0022200733,2023-01-26T00:00:00Z,HOU vs. CLE,95,-18,1610612739,CLE,Cleveland Cavaliers,CLE @ HOU,113,18,Regular Season
22022,1610612766,CHA,Charlotte Hornets,0022200732,2023-01-26T00:00:00Z,CHA vs. CHI,111,15,1610612741,CHI,Chicago Bulls,CHI @ CHA,96,-15,Regular Season
22022,1610612751,BKN,Brooklyn Nets,0022200731,2023-01-26T00:00:00Z,BKN vs. DET,122,-8,1610612765,DET,Detroit Pistons,DET @ BKN,130,8,Regular Season
22022,1610612760,OKC,Oklahoma City Thunder,0022200739,2023-01-27T00:00:00Z,OKC vs. CLE,112,12,1610612739,CLE,Cleveland Cavaliers,CLE @ OKC,100,-12,Regular Season
22022,1610612754,IND,Indiana Pacers,0022200736,2023-01-27T00:00:00Z,IND vs. MIL,131,-10,1610612749,MIL,Milwaukee Bucks,MIL @ IND,141,10,Regular Season
22022,1610612750,MIN,Minnesota Timberwolves,0022200737,2023-01-27T00:00:00Z,MIN vs. MEM,111,11,1610612763,MEM,Memphis Grizzlies,MEM @ MIN,100,-11,Regular Season
22022,1610612748,MIA,Miami Heat,0022200738,2023-01-27T00:00:00Z,MIA vs. ORL,110,5,1610612753,ORL,Orlando Magic,ORL @ MIA,105,-5,Regular Season
22022,1610612744,GSW,Golden State Warriors,0022200740,2023-01-27T00:00:00Z,GSW vs. TOR,129,12,1610612761,TOR,Toronto Raptors,TOR @ GSW,117,-12,Regular Season
22022,1610612755,PHI,Philadelphia 76ers,0022200741,2023-01-28T00:00:00Z,PHI vs. DEN,126,7,1610612743,DEN,Denver Nuggets,DEN @ PHI,119,-7,Regular Season
22022,1610612751,BKN,Brooklyn Nets,0022200742,2023-01-28T00:00:00Z,BKN vs. NYK,122,7,1610612752,NYK,New York Knicks,NYK @ BKN,115,-7,Regular Season
22022,1610612753,ORL,Orlando Magic,0022200744,2023-01-28T00:00:00Z,ORL vs. CHI,109,-19,1610612741,CHI,Chicago Bulls,CHI @ ORL,128,19,Regular Season
22022,1610612740,NOP,New Orleans Pelicans,0022200747,2023-01-28T00:00:00Z,NOP vs. WAS,103,-10,1610612764,WAS,Washington Wizards,WAS @ NOP,113,10,Regular Season
22022,1610612750,MIN,Minnesota Timberwolves,0022200746,2023-01-28T00:00:00Z,MIN vs. SAC,117,7,1610612758,SAC,Sacramento Kings,SAC @ MIN,110,-7,Regular Season
22022,1610612759,SAS,San Antonio Spurs,0022200748,2023-01-28T00:00:00Z,SAS vs. PHX,118,-10,1610612756,PHX,Phoenix Suns,PHX @ SAS,128,10,Regular Season
22022,1610612762,UTA,Utah Jazz,0022200750,2023-01-28T00:00:00Z,UTA vs. DAL,108,8,1610612742,DAL,Dallas Mavericks,DAL @ UTA,100,-8,Regular Season
22022,1610612765,DET,Detroit Pistons,0022200743,2023-01-28T00:00:00Z,DET vs. HOU,114,-3,1610612745,HOU,Houston Rockets,HOU @ DET,117,3,Regular Season
22022,1610612738,BOS,Boston Celtics,0022200749,2023-01-28T00:00:00Z,BOS vs. LAL,125,4,1610612747,LAL,Los Angeles Lakers,LAL @ BOS,121,-4,Regular Season
22022,1610612737,ATL,Atlanta Hawks,0022200745,2023-01-28T00:00:00Z,ATL vs. LAC,113,-7,1610612746,LAC,LA Clippers,LAC @ ATL,120,7,Regular Season
22022,1610612757,POR,Portland Trail Blazers,0022200751,2023-01-28T00:00:00Z,POR vs. TOR,105,-18,1610612761,TOR,Toronto Raptors,TOR @ POR,123,18,Regular Season
22022,1610612763,MEM,Memphis Grizzlies,0022200753,2023-01-29T00:00:00Z,MEM vs. IND,112,12,1610612754,IND,Indiana Pacers,IND @ MEM,100,-12,Regular Season
22022,1610612766,CHA,Charlotte Hornets,0022200752,2023-01-29T00:00:00Z,CHA vs. MIA,122,5,1610612748,MIA,Miami Heat,MIA @ CHA,117,-5,Regular Season
22022,1610612739,CLE,Cleveland Cavaliers,0022200754,2023-01-29T00:00:00Z,CLE vs. LAC,122,23,1610612746,LAC,LA Clippers,LAC @ CLE,99,-23,Regular Season
22022,1610612749,MIL,Milwaukee Bucks,0022200755,2023-01-29T00:00:00Z,MIL vs. NOP,135,25,1610612740,NOP,New Orleans Pelicans,NOP @ MIL,110,-25,Regular Season
22022,1610612760,OKC,Oklahoma City Thunder,0022200759,2023-01-30T00:00:00Z,OKC vs. GSW,120,-8,1610612744,GSW,Golden State Warriors,GSW @ OKC,128,8,Regular Season
22022,1610612759,SAS,San Antonio Spurs,0022200760,2023-01-30T00:00:00Z,SAS vs. WAS,106,-21,1610612764,WAS,Washington Wizards,WAS @ SAS,127,21,Regular Season
22022,1610612750,MIN,Minnesota Timberwolves,0022200758,2023-01-30T00:00:00Z,MIN vs. SAC,111,-7,1610612758,SAC,Sacramento Kings,SAC @ MIN,118,7,Regular Season
22022,1610612755,PHI,Philadelphia 76ers,0022200756,2023-01-30T00:00:00Z,PHI vs. ORL,109,-10,1610612753,ORL,Orlando Magic,ORL @ PHI,119,10,Regular Season
22022,1610612742,DAL,Dallas Mavericks,0022200761,2023-01-30T00:00:00Z,DAL vs. DET,111,6,1610612765,DET,Detroit Pistons,DET @ DAL,105,-6,Regular Season
22022,1610612756,PHX,Phoenix Suns,0022200762,2023-01-30T00:00:00Z,PHX vs. TOR,114,8,1610612761,TOR,Toronto Raptors,TOR @ PHX,106,-8,Regular Season
22022,1610612757,POR,Portland Trail Blazers,0022200763,2023-01-30T00:00:00Z,POR vs. ATL,129,4,1610612737,ATL,Atlanta Hawks,ATL @ POR,125,-4,Regular Season
22022,1610612751,BKN,Brooklyn Nets,0022200757,2023-01-30T00:00:00Z,BKN vs. LAL,121,17,1610612747,LAL,Los Angeles Lakers,LAL @ BKN,104,-17,Regular Season
22022,1610612739,CLE,Cleveland Cavaliers,0022200764,2023-01-31T00:00:00Z,CLE vs. MIA,97,-3,1610612748,MIA,Miami Heat,MIA @ CLE,100,3,Regular Season
22022,1610612752,NYK,New York Knicks,0022200765,2023-01-31T00:00:00Z,NYK vs. LAL,123,-6,1610612747,LAL,Los Angeles Lakers,LAL @ NYK,129,6,Regular Season
22022,1610612749,MIL,Milwaukee Bucks,0022200767,2023-01-31T00:00:00Z,MIL vs. CHA,124,9,1610612766,CHA,Charlotte Hornets,CHA @ MIL,115,-9,Regular Season
22022,1610612741,CHI,Chicago Bulls,0022200766,2023-01-31T00:00:00Z,CHI vs. LAC,103,-5,1610612746,LAC,LA Clippers,LAC @ CHI,108,5,Regular Season
22022,1610612743,DEN,Denver Nuggets,0022200768,2023-01-31T00:00:00Z,DEN vs. NOP,122,9,1610612740,NOP,New Orleans Pelicans,NOP @ DEN,113,-9,Regular Season
22022,1610612750,MIN,Minnesota Timberwolves,0022200774,2023-02-01T00:00:00Z,MIN vs. GSW,119,5,1610612744,GSW,Golden State Warriors,GSW @ MIN,114,-5,Regular Season
22022,1610612759,SAS,San Antonio Spurs,0022200775,2023-02-01T00:00:00Z,SAS vs. SAC,109,-10,1610612758,SAC,Sacramento Kings,SAC @ SAS,119,10,Regular Season
22022,1610612755,PHI,Philadelphia 76ers,0022200770,2023-02-01T00:00:00Z,PHI vs. ORL,105,11,1610612753,ORL,Orlando Magic,ORL @ PHI,94,-11,Regular Season
22022,1610612763,MEM,Memphis Grizzlies,0022200771,2023-02-01T00:00:00Z,MEM vs. POR,112,-10,1610612757,POR,Portland Trail Blazers,POR @ MEM,122,10,Regular Season
22022,1610612738,BOS,Boston Celtics,0022200772,2023-02-01T00:00:00Z,BOS vs. BKN,139,43,1610612751,BKN,Brooklyn Nets,BKN @ BOS,96,-43,Regular Season
22022,1610612745,HOU,Houston Rockets,0022200773,2023-02-01T00:00:00Z,HOU vs. OKC,112,6,1610612760,OKC,Oklahoma City Thunder,OKC @ HOU,106,-6,Regular Season
22022,1610612762,UTA,Utah Jazz,0022200776,2023-02-01T00:00:00Z,UTA vs. TOR,131,3,1610612761,TOR,Toronto Raptors,TOR @ UTA,128,-3,Regular Season
22022,1610612756,PHX,Phoenix Suns,0022200777,2023-02-01T00:00:00Z,PHX vs. ATL,100,-32,1610612737,ATL,Atlanta Hawks,ATL @ PHX,132,32,Regular Season
22022,1610612739,CLE,Cleveland Cavaliers,0022200779,2023-02-02T00:00:00Z,CLE vs. MEM,128,15,1610612763,MEM,Memphis Grizzlies,MEM @ CLE,113,-15,Regular Season
22022,1610612742,DAL,Dallas Mavericks,0022200782,2023-02-02T00:00:00Z,DAL vs. NOP,111,5,1610612740,NOP,New Orleans Pelicans,NOP @ DAL,106,-5,Regular Season
22022,1610612743,DEN,Denver Nuggets,0022200783,2023-02-02T00:00:00Z,DEN vs. GSW,134,17,1610612744,GSW,Golden State Warriors,GSW @ DEN,117,-17,Regular Season
22022,1610612754,IND,Indiana Pacers,0022200778,2023-02-02T00:00:00Z,IND vs. LAL,111,-1,1610612747,LAL,Los Angeles Lakers,LAL @ IND,112,1,Regular Season
22022,1610612752,NYK,New York Knicks,0022200780,2023-02-02T00:00:00Z,NYK vs. MIA,106,2,1610612748,MIA,Miami Heat,MIA @ NYK,104,-2,Regular Season
22022,1610612749,MIL,Milwaukee Bucks,0022200784,2023-02-02T00:00:00Z,MIL vs. LAC,106,1,1610612746,LAC,LA Clippers,LAC @ MIL,105,-1,Regular Season
22022,1610612741,CHI,Chicago Bulls,0022200781,2023-02-02T00:00:00Z,CHI vs. CHA,114,16,1610612766,CHA,Charlotte Hornets,CHA @ CHI,98,-16,Regular Season
22022,1610612750,MIN,Minnesota Timberwolves,0022200790,2023-02-03T00:00:00Z,MIN vs. ORL,120,-7,1610612753,ORL,Orlando Magic,ORL @ MIN,127,7,Regular Season
22022,1610612765,DET,Detroit Pistons,0022200785,2023-02-03T00:00:00Z,DET vs. CHA,118,6,1610612766,CHA,Charlotte Hornets,CHA @ DET,112,-6,Regular Season
22022,1610612759,SAS,San Antonio Spurs,0022200791,2023-02-03T00:00:00Z,SAS vs. PHI,125,-12,1610612755,PHI,Philadelphia 76ers,PHI @ SAS,137,12,Regular Season
22022,1610612745,HOU,Houston Rockets,0022200789,2023-02-03T00:00:00Z,HOU vs. TOR,111,-6,1610612761,TOR,Toronto Raptors,TOR @ HOU,117,6,Regular Season
22022,1610612738,BOS,Boston Celtics,0022200788,2023-02-03T00:00:00Z,BOS vs. PHX,94,-12,1610612756,PHX,Phoenix Suns,PHX @ BOS,106,12,Regular Season
22022,1610612764,WAS,Washington Wizards,0022200787,2023-02-03T00:00:00Z,WAS vs. POR,116,-8,1610612757,POR,Portland Trail Blazers,POR @ WAS,124,8,Regular Season
22022,1610612754,IND,Indiana Pacers,0022200786,2023-02-03T00:00:00Z,IND vs. SAC,107,3,1610612758,SAC,Sacramento Kings,SAC @ IND,104,-3,Regular Season
22022,1610612762,UTA,Utah Jazz,0022200792,2023-02-03T00:00:00Z,UTA vs. ATL,108,-7,1610612737,ATL,Atlanta Hawks,ATL @ UTA,115,7,Regular Season
22022,1610612765,DET,Detroit Pistons,0022200794,2023-02-04T00:00:00Z,DET vs. PHX,100,-16,1610612756,PHX,Phoenix Suns,PHX @ DET,116,16,Regular Season
22022,1610612752,NYK,New York Knicks,0022200795,2023-02-04T00:00:00Z,NYK vs. LAC,128,-6,1610612746,LAC,LA Clippers,LAC @ NYK,134,6,Regular Season
22022,1610612751,BKN,Brooklyn Nets,0022200793,2023-02-04T00:00:00Z,BKN vs. WAS,125,2,1610612764,WAS,Washington Wizards,WAS @ BKN,123,-2,Regular Season
22022,1610612741,CHI,Chicago Bulls,0022200796,2023-02-04T00:00:00Z,CHI vs. POR,129,8,1610612757,POR,Portland Trail Blazers,POR @ CHI,121,-8,Regular Season
22022,1610612749,MIL,Milwaukee Bucks,0022200797,2023-02-04T00:00:00Z,MIL vs. MIA,123,8,1610612748,MIA,Miami Heat,MIA @ MIL,115,-8,Regular Season
22022,1610612760,OKC,Oklahoma City Thunder,0022200799,2023-02-04T00:00:00Z,OKC vs. HOU,153,32,1610612745,HOU,Houston Rockets,HOU @ OKC,121,-32,Regular Season
22022,1610612744,GSW,Golden State Warriors,0022200800,2023-02-04T00:00:00Z,GSW vs. DAL,119,6,1610612742,DAL,Dallas Mavericks,DAL @ GSW,113,-6,Regular Season
22022,1610612743,DEN,Denver Nuggets,0022200801,2023-02-04T00:00:00Z,DEN vs. ATL,128,20,1610612737,ATL,Atlanta Hawks,ATL @ DEN,108,-20,Regular Season
22022,1610612740,NOP,New Orleans Pelicans,0022200798,2023-02-04T00:00:00Z,NOP vs. LAL,131,5,1610612747,LAL,Los Angeles Lakers,LAL @ NOP,126,-5,Regular Season
22022,1610612766,CHA,Charlotte Hornets,0022200802,2023-02-05T00:00:00Z,CHA vs. ORL,113,-6,1610612753,ORL,Orlando Magic,ORL @ CHA,119,6,Regular Season
22022,1610612754,IND,Indiana Pacers,0022200803,2023-02-05T00:00:00Z,IND vs. CLE,103,-19,1610612739,CLE,Cleveland Cavaliers,CLE @ IND,122,19,Regular Season
22022,1610612763,MEM,Memphis Grizzlies,0022200805,2023-02-05T00:00:00Z,MEM vs. TOR,103,-3,1610612761,TOR,Toronto Raptors,TOR @ MEM,106,3,Regular Season
22022,1610612750,MIN,Minnesota Timberwolves,0022200806,2023-02-05T00:00:00Z,MIN vs. DEN,128,30,1610612743,DEN,Denver Nuggets,DEN @ MIN,98,-30,Regular Season
22022,1610612740,NOP,New Orleans Pelicans,0022200807,2023-02-05T00:00:00Z,NOP vs. SAC,136,32,1610612758,SAC,Sacramento Kings,SAC @ NOP,104,-32,Regular Season
22022,1610612752,NYK,New York Knicks,0022200804,2023-02-05T00:00:00Z,NYK vs. PHI,108,11,1610612755,PHI,Philadelphia 76ers,PHI @ NYK,97,-11,Regular Season
22022,1610612745,HOU,Houston Rockets,0022200812,2023-02-06T00:00:00Z,HOU vs. SAC,120,-20,1610612758,SAC,Sacramento Kings,SAC @ HOU,140,20,Regular Season
22022,1610612762,UTA,Utah Jazz,0022200813,2023-02-06T00:00:00Z,UTA vs. DAL,111,-13,1610612742,DAL,Dallas Mavericks,DAL @ UTA,124,13,Regular Season
22022,1610612757,POR,Portland Trail Blazers,0022200815,2023-02-06T00:00:00Z,POR vs. MIL,108,-19,1610612749,MIL,Milwaukee Bucks,MIL @ POR,127,19,Regular Season
22022,1610612765,DET,Detroit Pistons,0022200808,2023-02-06T00:00:00Z,DET vs. BOS,99,-12,1610612738,BOS,Boston Celtics,BOS @ DET,111,12,Regular Season
22022,1610612744,GSW,Golden State Warriors,0022200814,2023-02-06T00:00:00Z,GSW vs. OKC,141,27,1610612760,OKC,Oklahoma City Thunder,OKC @ GSW,114,-27,Regular Season
22022,1610612751,BKN,Brooklyn Nets,0022200810,2023-02-06T00:00:00Z,BKN vs. LAC,116,-8,1610612746,LAC,LA Clippers,LAC @ BKN,124,8,Regular Season
22022,1610612741,CHI,Chicago Bulls,0022200811,2023-02-06T00:00:00Z,CHI vs. SAS,128,24,1610612759,SAS,San Antonio Spurs,SAS @ CHI,104,-24,Regular Season
22022,1610612764,WAS,Washington Wizards,0022200809,2023-02-06T00:00:00Z,WAS vs. CLE,91,-23,1610612739,CLE,Cleveland Cavaliers,CLE @ WAS,114,23,Regular Season
22022,1610612747,LAL,Los Angeles Lakers,0022200821,2023-02-07T00:00:00Z,LAL vs. OKC,130,-3,1610612760,OKC,Oklahoma City Thunder,OKC @ LAL,133,3,Regular Season
22022,1610612740,NOP,New Orleans Pelicans,0022200818,2023-02-07T00:00:00Z,NOP vs. ATL,116,9,1610612737,ATL,Atlanta Hawks,ATL @ NOP,107,-9,Regular Season
22022,1610612753,ORL,Orlando Magic,0022200816,2023-02-07T00:00:00Z,ORL vs. NYK,98,-4,1610612752,NYK,New York Knicks,NYK @ ORL,102,4,Regular Season
22022,1610612751,BKN,Brooklyn Nets,0022200817,2023-02-07T00:00:00Z,BKN vs. PHX,112,-4,1610612756,PHX,Phoenix Suns,PHX @ BKN,116,4,Regular Season
22022,1610612763,MEM,Memphis Grizzlies,0022200819,2023-02-07T00:00:00Z,MEM vs. CHI,104,15,1610612741,CHI,Chicago Bulls,CHI @ MEM,89,-15,Regular Season
22022,1610612743,DEN,Denver Nuggets,0022200820,2023-02-07T00:00:00Z,DEN vs. MIN,146,34,1610612750,MIN,Minnesota Timberwolves,MIN @ DEN,112,-34,Regular Season
22022,1610612764,WAS,Washington Wizards,0022200823,2023-02-08T00:00:00Z,WAS vs. CHA,118,14,1610612766,CHA,Charlotte Hornets,CHA @ WAS,104,-14,Regular Season
22022,1610612746,LAC,LA Clippers,0022200829,2023-02-08T00:00:00Z,LAC vs. DAL,104,-6,1610612742,DAL,Dallas Mavericks,DAL @ LAC,110,6,Regular Season
22022,1610612757,POR,Portland Trail Blazers,0022200830,2023-02-08T00:00:00Z,POR vs. GSW,125,3,1610612744,GSW,Golden State Warriors,GSW @ POR,122,-3,Regular Season
22022,1610612739,CLE,Cleveland Cavaliers,0022200822,2023-02-08T00:00:00Z,CLE vs. DET,113,28,1610612765,DET,Detroit Pistons,DET @ CLE,85,-28,Regular Season
22022,1610612762,UTA,Utah Jazz,0022200828,2023-02-08T00:00:00Z,UTA vs. MIN,118,-25,1610612750,MIN,Minnesota Timberwolves,MIN @ UTA,143,25,Regular Season
22022,1610612748,MIA,Miami Heat,0022200825,2023-02-08T00:00:00Z,MIA vs. IND,116,5,1610612754,IND,Indiana Pacers,IND @ MIA,111,-5,Regular Season
22022,1610612738,BOS,Boston Celtics,0022200824,2023-02-08T00:00:00Z,BOS vs. PHI,106,7,1610612755,PHI,Philadelphia 76ers,PHI @ BOS,99,-7,Regular Season
22022,1610612761,TOR,Toronto Raptors,0022200826,2023-02-08T00:00:00Z,TOR vs. SAS,112,14,1610612759,SAS,San Antonio Spurs,SAS @ TOR,98,-14,Regular Season
22022,1610612745,HOU,Houston Rockets,0022200827,2023-02-08T00:00:00Z,HOU vs. SAC,128,-2,1610612758,SAC,Sacramento Kings,SAC @ HOU,130,2,Regular Season
22022,1610612753,ORL,Orlando Magic,0022200831,2023-02-09T00:00:00Z,ORL vs. DEN,115,11,1610612743,DEN,Denver Nuggets,DEN @ ORL,104,-11,Regular Season
22022,1610612751,BKN,Brooklyn Nets,0022200833,2023-02-09T00:00:00Z,BKN vs. CHI,116,11,1610612741,CHI,Chicago Bulls,CHI @ BKN,105,-11,Regular Season
22022,1610612737,ATL,Atlanta Hawks,0022200832,2023-02-09T00:00:00Z,ATL vs. PHX,116,9,1610612756,PHX,Phoenix Suns,PHX @ ATL,107,-9,Regular Season
22022,1610612747,LAL,Los Angeles Lakers,0022200834,2023-02-09T00:00:00Z,LAL vs. MIL,106,-9,1610612749,MIL,Milwaukee Bucks,MIL @ LAL,115,9,Regular Season
22022,1610612746,LAC,LA Clippers,0022200845,2023-02-10T00:00:00Z,LAC vs. MIL,106,-13,1610612749,MIL,Milwaukee Bucks,MIL @ LAC,119,13,Regular Season
22022,1610612765,DET,Detroit Pistons,0022200835,2023-02-10T00:00:00Z,DET vs. SAS,138,7,1610612759,SAS,San Antonio Spurs,SAS @ DET,131,-7,Regular Season
22022,1610612740,NOP,New Orleans Pelicans,0022200842,2023-02-10T00:00:00Z,NOP vs. CLE,107,-11,1610612739,CLE,Cleveland Cavaliers,CLE @ NOP,118,11,Regular Season
22022,1610612755,PHI,Philadelphia 76ers,0022200837,2023-02-10T00:00:00Z,PHI vs. NYK,119,11,1610612752,NYK,New York Knicks,NYK @ PHI,108,-11,Regular Season
22022,1610612757,POR,Portland Trail Blazers,0022200843,2023-02-10T00:00:00Z,POR vs. OKC,129,-9,1610612760,OKC,Oklahoma City Thunder,OKC @ POR,138,9,Regular Season
22022,1610612758,SAC,Sacramento Kings,0022200844,2023-02-10T00:00:00Z,SAC vs. DAL,114,-8,1610612742,DAL,Dallas Mavericks,DAL @ SAC,122,8,Regular Season
22022,1610612763,MEM,Memphis Grizzlies,0022200841,2023-02-10T00:00:00Z,MEM vs. MIN,128,21,1610612750,MIN,Minnesota Timberwolves,MIN @ MEM,107,-21,Regular Season
22022,1610612754,IND,Indiana Pacers,0022200836,2023-02-10T00:00:00Z,IND vs. PHX,104,-13,1610612756,PHX,Phoenix Suns,PHX @ IND,117,13,Regular Season
22022,1610612748,MIA,Miami Heat,0022200840,2023-02-10T00:00:00Z,MIA vs. HOU,97,2,1610612745,HOU,Houston Rockets,HOU @ MIA,95,-2,Regular Season
22022,1610612738,BOS,Boston Celtics,0022200838,2023-02-10T00:00:00Z,BOS vs. CHA,127,11,1610612766,CHA,Charlotte Hornets,CHA @ BOS,116,-11,Regular Season
22022,1610612761,TOR,Toronto Raptors,0022200839,2023-02-10T00:00:00Z,TOR vs. UTA,116,-6,1610612762,UTA,Utah Jazz,UTA @ TOR,122,6,Regular Season
22022,1610612744,GSW,Golden State Warriors,0022200853,2023-02-11T00:00:00Z,GSW vs. LAL,103,-6,1610612747,LAL,Los Angeles Lakers,LAL @ GSW,109,6,Regular Season
22022,1610612739,CLE,Cleveland Cavaliers,0022200852,2023-02-11T00:00:00Z,CLE vs. CHI,97,8,1610612741,CHI,Chicago Bulls,CHI @ CLE,89,-8,Regular Season
22022,1610612752,NYK,New York Knicks,0022200851,2023-02-11T00:00:00Z,NYK vs. UTA,126,6,1610612762,UTA,Utah Jazz,UTA @ NYK,120,-6,Regular Season
22022,1610612753,ORL,Orlando Magic,0022200848,2023-02-11T00:00:00Z,ORL vs. MIA,103,-4,1610612748,MIA,Miami Heat,MIA @ ORL,107,4,Regular Season
22022,1610612737,ATL,Atlanta Hawks,0022200850,2023-02-11T00:00:00Z,ATL vs. SAS,125,19,1610612759,SAS,San Antonio Spurs,SAS @ ATL,106,-19,Regular Season
22022,1610612764,WAS,Washington Wizards,0022200849,2023-02-11T00:00:00Z,WAS vs. IND,127,14,1610612754,IND,Indiana Pacers,IND @ WAS,113,-14,Regular Season
22022,1610612766,CHA,Charlotte Hornets,0022200847,2023-02-11T00:00:00Z,CHA vs. DEN,105,-14,1610612743,DEN,Denver Nuggets,DEN @ CHA,119,14,Regular Season
22022,1610612758,SAC,Sacramento Kings,0022200854,2023-02-11T00:00:00Z,SAC vs. DAL,133,5,1610612742,DAL,Dallas Mavericks,DAL @ SAC,128,-5,Regular Season
22022,1610612751,BKN,Brooklyn Nets,0022200846,2023-02-11T00:00:00Z,BKN vs. PHI,98,-3,1610612755,PHI,Philadelphia 76ers,PHI @ BKN,101,3,Regular Season
22022,1610612761,TOR,Toronto Raptors,0022200856,2023-02-12T00:00:00Z,TOR vs. DET,119,1,1610612765,DET,Detroit Pistons,DET @ TOR,118,-1,Regular Season
22022,1610612738,BOS,Boston Celtics,0022200855,2023-02-12T00:00:00Z,BOS vs. MEM,119,10,1610612763,MEM,Memphis Grizzlies,MEM @ BOS,109,-10,Regular Season
22022,1610612744,GSW,Golden State Warriors,0022200866,2023-02-13T00:00:00Z,GSW vs. WAS,135,9,1610612764,WAS,Washington Wizards,WAS @ GSW,126,-9,Regular Season
22022,1610612757,POR,Portland Trail Blazers,0022200867,2023-02-13T00:00:00Z,POR vs. LAL,127,12,1610612747,LAL,Los Angeles Lakers,LAL @ POR,115,-12,Regular Season
22022,1610612742,DAL,Dallas Mavericks,0022200865,2023-02-13T00:00:00Z,DAL vs. MIN,121,-3,1610612750,MIN,Minnesota Timberwolves,MIN @ DAL,124,3,Regular Season
22022,1610612739,CLE,Cleveland Cavaliers,0022200858,2023-02-13T00:00:00Z,CLE vs. SAS,117,8,1610612759,SAS,San Antonio Spurs,SAS @ CLE,109,-8,Regular Season
22022,1610612741,CHI,Chicago Bulls,0022200863,2023-02-13T00:00:00Z,CHI vs. ORL,91,-9,1610612753,ORL,Orlando Magic,ORL @ CHI,100,9,Regular Season
22022,1610612760,OKC,Oklahoma City Thunder,0022200864,2023-02-13T00:00:00Z,OKC vs. NOP,100,-3,1610612740,NOP,New Orleans Pelicans,NOP @ OKC,103,3,Regular Season
22022,1610612752,NYK,New York Knicks,0022200862,2023-02-13T00:00:00Z,NYK vs. BKN,124,18,1610612751,BKN,Brooklyn Nets,BKN @ NYK,106,-18,Regular Season
22022,1610612748,MIA,Miami Heat,0022200861,2023-02-13T00:00:00Z,MIA vs. DEN,108,-4,1610612743,DEN,Denver Nuggets,DEN @ MIA,112,4,Regular Season
22022,1610612766,CHA,Charlotte Hornets,0022200857,2023-02-13T00:00:00Z,CHA vs. ATL,144,6,1610612737,ATL,Atlanta Hawks,ATL @ CHA,138,-6,Regular Season
22022,1610612754,IND,Indiana Pacers,0022200859,2023-02-13T00:00:00Z,IND vs. UTA,117,-6,1610612762,UTA,Utah Jazz,UTA @ IND,123,6,Regular Season
22022,1610612755,PHI,Philadelphia 76ers,0022200860,2023-02-13T00:00:00Z,PHI vs. HOU,123,19,1610612745,HOU,Houston Rockets,HOU @ PHI,104,-19,Regular Season
22022,1610612756,PHX,Phoenix Suns,0022200870,2023-02-14T00:00:00Z,PHX vs. SAC,120,11,1610612758,SAC,Sacramento Kings,SAC @ PHX,109,-11,Regular Season
22022,1610612749,MIL,Milwaukee Bucks,0022200869,2023-02-14T00:00:00Z,MIL vs. BOS,131,6,1610612738,BOS,Boston Celtics,BOS @ MIL,125,-6,Regular Season
22022,1610612757,POR,Portland Trail Blazers,0022200872,2023-02-14T00:00:00Z,POR vs. WAS,101,-25,1610612764,WAS,Washington Wizards,WAS @ POR,126,25,Regular Season
22022,1610612746,LAC,LA Clippers,0022200871,2023-02-14T00:00:00Z,LAC vs. GSW,134,10,1610612744,GSW,Golden State Warriors,GSW @ LAC,124,-10,Regular Season
22022,1610612761,TOR,Toronto Raptors,0022200868,2023-02-14T00:00:00Z,TOR vs. ORL,123,10,1610612753,ORL,Orlando Magic,ORL @ TOR,113,-10,Regular Season
22022,1610612747,LAL,Los Angeles Lakers,0022200882,2023-02-15T00:00:00Z,LAL vs. NOP,120,18,1610612740,NOP,New Orleans Pelicans,NOP @ LAL,102,-18,Regular Season
22022,1610612766,CHA,Charlotte Hornets,0022200873,2023-02-15T00:00:00Z,CHA vs. SAS,120,10,1610612759,SAS,San Antonio Spurs,SAS @ CHA,110,-10,Regular Season
22022,1610612743,DEN,Denver Nuggets,0022200881,2023-02-15T00:00:00Z,DEN vs. DAL,118,9,1610612742,DAL,Dallas Mavericks,DAL @ DEN,109,-9,Regular Season
22022,1610612760,OKC,Oklahoma City Thunder,0022200880,2023-02-15T00:00:00Z,OKC vs. HOU,133,37,1610612745,HOU,Houston Rockets,HOU @ OKC,96,-37,Regular Season
22022,1610612754,IND,Indiana Pacers,0022200874,2023-02-15T00:00:00Z,IND vs. CHI,117,4,1610612741,CHI,Chicago Bulls,CHI @ IND,113,-4,Regular Season
22022,1610612763,MEM,Memphis Grizzlies,0022200879,2023-02-15T00:00:00Z,MEM vs. UTA,117,6,1610612762,UTA,Utah Jazz,UTA @ MEM,111,-6,Regular Season
22022,1610612755,PHI,Philadelphia 76ers,0022200875,2023-02-15T00:00:00Z,PHI vs. CLE,118,6,1610612739,CLE,Cleveland Cavaliers,CLE @ PHI,112,-6,Regular Season
22022,1610612737,ATL,Atlanta Hawks,0022200876,2023-02-15T00:00:00Z,ATL vs. NYK,101,-21,1610612752,NYK,New York Knicks,NYK @ ATL,122,21,Regular Season
22022,1610612751,BKN,Brooklyn Nets,0022200878,2023-02-15T00:00:00Z,BKN vs. MIA,116,11,1610612748,MIA,Miami Heat,MIA @ BKN,105,-11,Regular Season
22022,1610612738,BOS,Boston Celtics,0022200877,2023-02-15T00:00:00Z,BOS vs. DET,127,18,1610612765,DET,Detroit Pistons,DET @ BOS,109,-18,Regular Season
22022,1610612741,CHI,Chicago Bulls,0022200883,2023-02-16T00:00:00Z,CHI vs. MIL,100,-12,1610612749,MIL,Milwaukee Bucks,MIL @ CHI,112,12,Regular Season
22022,1610612756,PHX,Phoenix Suns,0022200885,2023-02-16T00:00:00Z,PHX vs. LAC,107,-9,1610612746,LAC,LA Clippers,LAC @ PHX,116,9,Regular Season
22022,1610612750,MIN,Minnesota Timberwolves,0022200884,2023-02-16T00:00:00Z,MIN vs. WAS,106,-8,1610612764,WAS,Washington Wizards,WAS @ MIN,114,8,Regular Season
22022,1610612761,TOR,Toronto Raptors,0022200890,2023-02-23T00:00:00Z,TOR vs. NOP,115,5,1610612740,NOP,New Orleans Pelicans,NOP @ TOR,110,-5,Regular Season
22022,1610612762,UTA,Utah Jazz,0022200892,2023-02-23T00:00:00Z,UTA vs. OKC,120,1,1610612760,OKC,Oklahoma City Thunder,OKC @ UTA,119,-1,Regular Season
22022,1610612755,PHI,Philadelphia 76ers,0022200889,2023-02-23T00:00:00Z,PHI vs. MEM,110,5,1610612763,MEM,Memphis Grizzlies,MEM @ PHI,105,-5,Regular Season
22022,1610612753,ORL,Orlando Magic,0022200888,2023-02-23T00:00:00Z,ORL vs. DET,108,2,1610612765,DET,Detroit Pistons,DET @ ORL,106,-2,Regular Season
22022,1610612758,SAC,Sacramento Kings,0022200894,2023-02-23T00:00:00Z,SAC vs. POR,133,17,1610612757,POR,Portland Trail Blazers,POR @ SAC,116,-17,Regular Season
22022,1610612747,LAL,Los Angeles Lakers,0022200893,2023-02-23T00:00:00Z,LAL vs. GSW,124,13,1610612744,GSW,Golden State Warriors,GSW @ LAL,111,-13,Regular Season
22022,1610612754,IND,Indiana Pacers,0022200887,2023-02-23T00:00:00Z,IND vs. BOS,138,-4,1610612738,BOS,Boston Celtics,BOS @ IND,142,4,Regular Season
22022,1610612739,CLE,Cleveland Cavaliers,0022200886,2023-02-23T00:00:00Z,CLE vs. DEN,109,-6,1610612743,DEN,Denver Nuggets,DEN @ CLE,115,6,Regular Season
22022,1610612742,DAL,Dallas Mavericks,0022200891,2023-02-23T00:00:00Z,DAL vs. SAS,142,26,1610612759,SAS,San Antonio Spurs,SAS @ DAL,116,-26,Regular Season
22022,1610612750,MIN,Minnesota Timberwolves,0022200898,2023-02-24T00:00:00Z,MIN vs. CHA,113,-8,1610612766,CHA,Charlotte Hornets,CHA @ MIN,121,8,Regular Season
22022,1610612746,LAC,LA Clippers,0022200902,2023-02-24T00:00:00Z,LAC vs. SAC,175,-1,1610612758,SAC,Sacramento Kings,SAC @ LAC,176,1,Regular Season
22022,1610612744,GSW,Golden State Warriors,0022200901,2023-02-24T00:00:00Z,GSW vs. HOU,116,15,1610612745,HOU,Houston Rockets,HOU @ GSW,101,-15,Regular Season
22022,1610612756,PHX,Phoenix Suns,0022200899,2023-02-24T00:00:00Z,PHX vs. OKC,124,9,1610612760,OKC,Oklahoma City Thunder,OKC @ PHX,115,-9,Regular Season
22022,1610612764,WAS,Washington Wizards,0022200895,2023-02-24T00:00:00Z,WAS vs. NYK,109,-6,1610612752,NYK,New York Knicks,NYK @ WAS,115,6,Regular Season
22022,1610612737,ATL,Atlanta Hawks,0022200896,2023-02-24T00:00:00Z,ATL vs. CLE,136,17,1610612739,CLE,Cleveland Cavaliers,CLE @ ATL,119,-17,Regular Season
22022,1610612749,MIL,Milwaukee Bucks,0022200897,2023-02-24T00:00:00Z,MIL vs. MIA,128,29,1610612748,MIA,Miami Heat,MIA @ MIL,99,-29,Regular Season
22022,1610612741,CHI,Chicago Bulls,0022200900,2023-02-24T00:00:00Z,CHI vs. BKN,131,44,1610612751,BKN,Brooklyn Nets,BKN @ CHI,87,-44,Regular Season
22022,1610612755,PHI,Philadelphia 76ers,0022200908,2023-02-25T00:00:00Z,PHI vs. BOS,107,-3,1610612738,BOS,Boston Celtics,BOS @ PHI,110,3,Regular Season
22022,1610612762,UTA,Utah Jazz,0022200909,2023-02-25T00:00:00Z,UTA vs. SAS,118,16,1610612759,SAS,San Antonio Spurs,SAS @ UTA,102,-16,Regular Season
22022,1610612763,MEM,Memphis Grizzlies,0022200907,2023-02-25T00:00:00Z,MEM vs. DEN,112,18,1610612743,DEN,Denver Nuggets,DEN @ MEM,94,-18,Regular Season
22022,1610612752,NYK,New York Knicks,0022200906,2023-02-25T00:00:00Z,NYK vs. NOP,128,22,1610612740,NOP,New Orleans Pelicans,NOP @ NYK,106,-22,Regular Season
22022,1610612753,ORL,Orlando Magic,0022200905,2023-02-25T00:00:00Z,ORL vs. IND,108,-13,1610612754,IND,Indiana Pacers,IND @ ORL,121,13,Regular Season
22022,1610612766,CHA,Charlotte Hornets,0022200904,2023-02-25T00:00:00Z,CHA vs. MIA,108,5,1610612748,MIA,Miami Heat,MIA @ CHA,103,-5,Regular Season
22022,1610612765,DET,Detroit Pistons,0022200903,2023-02-25T00:00:00Z,DET vs. TOR,91,-4,1610612761,TOR,Toronto Raptors,TOR @ DET,95,4,Regular Season
22022,1610612760,OKC,Oklahoma City Thunder,0022200915,2023-02-26T00:00:00Z,OKC vs. SAC,115,-9,1610612758,SAC,Sacramento Kings,SAC @ OKC,124,9,Regular Season
22022,1610612743,DEN,Denver Nuggets,0022200918,2023-02-26T00:00:00Z,DEN vs. LAC,134,10,1610612746,LAC,LA Clippers,LAC @ DEN,124,-10,Regular Season
22022,1610612757,POR,Portland Trail Blazers,0022200917,2023-02-26T00:00:00Z,POR vs. HOU,131,17,1610612745,HOU,Houston Rockets,HOU @ POR,114,-17,Regular Season
22022,1610612744,GSW,Golden State Warriors,0022200916,2023-02-26T00:00:00Z,GSW vs. MIN,109,5,1610612750,MIN,Minnesota Timberwolves,MIN @ GSW,104,-5,Regular Season
22022,1610612749,MIL,Milwaukee Bucks,0022200910,2023-02-26T00:00:00Z,MIL vs. PHX,104,3,1610612756,PHX,Phoenix Suns,PHX @ MIL,101,-3,Regular Season
22022,1610612739,CLE,Cleveland Cavaliers,0022200914,2023-02-26T00:00:00Z,CLE vs. TOR,118,25,1610612761,TOR,Toronto Raptors,TOR @ CLE,93,-25,Regular Season
22022,1610612742,DAL,Dallas Mavericks,0022200913,2023-02-26T00:00:00Z,DAL vs. LAL,108,-3,1610612747,LAL,Los Angeles Lakers,LAL @ DAL,111,3,Regular Season
22022,1610612737,ATL,Atlanta Hawks,0022200911,2023-02-26T00:00:00Z,ATL vs. BKN,129,2,1610612751,BKN,Brooklyn Nets,BKN @ ATL,127,-2,Regular Season
22022,1610612741,CHI,Chicago Bulls,0022200912,2023-02-26T00:00:00Z,CHI vs. WAS,102,20,1610612764,WAS,Washington Wizards,WAS @ CHI,82,-20,Regular Season
22022,1610612755,PHI,Philadelphia 76ers,0022200920,2023-02-27T00:00:00Z,PHI vs. MIA,99,-2,1610612748,MIA,Miami Heat,MIA @ PHI,101,2,Regular Season
22022,1610612766,CHA,Charlotte Hornets,0022200919,2023-02-27T00:00:00Z,CHA vs. DET,117,11,1610612765,DET,Detroit Pistons,DET @ CHA,106,-11,Regular Season
22022,1610612740,NOP,New Orleans Pelicans,0022200922,2023-02-27T00:00:00Z,NOP vs. ORL,93,-8,1610612753,ORL,Orlando Magic,ORL @ NOP,101,8,Regular Season
22022,1610612752,NYK,New York Knicks,0022200921,2023-02-27T00:00:00Z,NYK vs. BOS,109,15,1610612738,BOS,Boston Celtics,BOS @ NYK,94,-15,Regular Season
22022,1610612761,TOR,Toronto Raptors,0022200925,2023-02-28T00:00:00Z,TOR vs. CHI,104,6,1610612741,CHI,Chicago Bulls,CHI @ TOR,98,-6,Regular Season
22022,1610612762,UTA,Utah Jazz,0022200930,2023-02-28T00:00:00Z,UTA vs. SAS,94,-8,1610612759,SAS,San Antonio Spurs,SAS @ UTA,102,8,Regular Season
22022,1610612737,ATL,Atlanta Hawks,0022200923,2023-02-28T00:00:00Z,ATL vs. WAS,116,-3,1610612764,WAS,Washington Wizards,WAS @ ATL,119,3,Regular Season
22022,1610612763,MEM,Memphis Grizzlies,0022200927,2023-02-28T00:00:00Z,MEM vs. LAL,121,12,1610612747,LAL,Los Angeles Lakers,LAL @ MEM,109,-12,Regular Season
22022,1610612744,GSW,Golden State Warriors,0022200931,2023-02-28T00:00:00Z,GSW vs. POR,123,18,1610612757,POR,Portland Trail Blazers,POR @ GSW,105,-18,Regular Season
22022,1610612746,LAC,LA Clippers,0022200932,2023-02-28T00:00:00Z,LAC vs. MIN,101,-7,1610612750,MIN,Minnesota Timberwolves,MIN @ LAC,108,7,Regular Season
22022,1610612742,DAL,Dallas Mavericks,0022200929,2023-02-28T00:00:00Z,DAL vs. IND,122,-2,1610612754,IND,Indiana Pacers,IND @ DAL,124,2,Regular Season
22022,1610612751,BKN,Brooklyn Nets,0022200924,2023-02-28T00:00:00Z,BKN vs. MIL,104,-14,1610612749,MIL,Milwaukee Bucks,MIL @ BKN,118,14,Regular Season
22022,1610612745,HOU,Houston Rockets,0022200926,2023-02-28T00:00:00Z,HOU vs. DEN,112,-21,1610612743,DEN,Denver Nuggets,DEN @ HOU,133,21,Regular Season
22022,1610612760,OKC,Oklahoma City Thunder,0022200928,2023-02-28T00:00:00Z,OKC vs. SAC,117,-6,1610612758,SAC,Sacramento Kings,SAC @ OKC,123,6,Regular Season
22022,1610612748,MIA,Miami Heat,0022200936,2023-03-01T00:00:00Z,MIA vs. PHI,96,-23,1610612755,PHI,Philadelphia 76ers,PHI @ MIA,119,23,Regular Season
22022,1610612752,NYK,New York Knicks,0022200937,2023-03-01T00:00:00Z,NYK vs. BKN,142,24,1610612751,BKN,Brooklyn Nets,BKN @ NYK,118,-24,Regular Season
22022,1610612738,BOS,Boston Celtics,0022200935,2023-03-01T00:00:00Z,BOS vs. CLE,117,4,1610612739,CLE,Cleveland Cavaliers,CLE @ BOS,113,-4,Regular Season
22022,1610612745,HOU,Houston Rockets,0022200938,2023-03-01T00:00:00Z,HOU vs. MEM,99,-14,1610612763,MEM,Memphis Grizzlies,MEM @ HOU,113,14,Regular Season
22022,1610612749,MIL,Milwaukee Bucks,0022200939,2023-03-01T00:00:00Z,MIL vs. ORL,139,22,1610612753,ORL,Orlando Magic,ORL @ MIL,117,-22,Regular Season
22022,1610612766,CHA,Charlotte Hornets,0022200933,2023-03-01T00:00:00Z,CHA vs. PHX,91,-14,1610612756,PHX,Phoenix Suns,PHX @ CHA,105,14,Regular Season
22022,1610612760,OKC,Oklahoma City Thunder,0022200940,2023-03-01T00:00:00Z,OKC vs. LAL,117,-6,1610612747,LAL,Los Angeles Lakers,LAL @ OKC,123,6,Regular Season
22022,1610612765,DET,Detroit Pistons,0022200934,2023-03-01T00:00:00Z,DET vs. CHI,115,-2,1610612741,CHI,Chicago Bulls,CHI @ DET,117,2,Regular Season
22022,1610612757,POR,Portland Trail Blazers,0022200941,2023-03-01T00:00:00Z,POR vs. NOP,110,-11,1610612740,NOP,New Orleans Pelicans,NOP @ POR,121,11,Regular Season
22022,1610612744,GSW,Golden State Warriors,0022200945,2023-03-02T00:00:00Z,GSW vs. LAC,115,24,1610612746,LAC,LA Clippers,LAC @ GSW,91,-24,Regular Season
22022,1610612764,WAS,Washington Wizards,0022200942,2023-03-02T00:00:00Z,WAS vs. TOR,119,11,1610612761,TOR,Toronto Raptors,TOR @ WAS,108,-11,Regular Season
22022,1610612759,SAS,San Antonio Spurs,0022200944,2023-03-02T00:00:00Z,SAS vs. IND,110,11,1610612754,IND,Indiana Pacers,IND @ SAS,99,-11,Regular Season
22022,1610612742,DAL,Dallas Mavericks,0022200943,2023-03-02T00:00:00Z,DAL vs. PHI,133,7,1610612755,PHI,Philadelphia 76ers,PHI @ DAL,126,-7,Regular Season
22022,1610612747,LAL,Los Angeles Lakers,0022200955,2023-03-03T00:00:00Z,LAL vs. MIN,102,-8,1610612750,MIN,Minnesota Timberwolves,MIN @ LAL,110,8,Regular Season
22022,1610612743,DEN,Denver Nuggets,0022200952,2023-03-03T00:00:00Z,DEN vs. MEM,113,16,1610612763,MEM,Memphis Grizzlies,MEM @ DEN,97,-16,Regular Season
22022,1610612744,GSW,Golden State Warriors,0022200953,2023-03-03T00:00:00Z,GSW vs. NOP,108,9,1610612740,NOP,New Orleans Pelicans,NOP @ GSW,99,-9,Regular Season
22022,1610612758,SAC,Sacramento Kings,0022200954,2023-03-03T00:00:00Z,SAC vs. LAC,128,1,1610612746,LAC,LA Clippers,LAC @ SAC,127,-1,Regular Season
22022,1610612738,BOS,Boston Celtics,0022200948,2023-03-03T00:00:00Z,BOS vs. BKN,105,-10,1610612751,BKN,Brooklyn Nets,BKN @ BOS,115,10,Regular Season
22022,1610612760,OKC,Oklahoma City Thunder,0022200951,2023-03-03T00:00:00Z,OKC vs. UTA,130,27,1610612762,UTA,Utah Jazz,UTA @ OKC,103,-27,Regular Season
22022,1610612741,CHI,Chicago Bulls,0022200950,2023-03-03T00:00:00Z,CHI vs. PHX,104,-21,1610612756,PHX,Phoenix Suns,PHX @ CHI,125,21,Regular Season
22022,1610612748,MIA,Miami Heat,0022200949,2023-03-03T00:00:00Z,MIA vs. NYK,120,-2,1610612752,NYK,New York Knicks,NYK @ MIA,122,2,Regular Season
22022,1610612737,ATL,Atlanta Hawks,0022200947,2023-03-03T00:00:00Z,ATL vs. POR,129,18,1610612757,POR,Portland Trail Blazers,POR @ ATL,111,-18,Regular Season
22022,1610612766,CHA,Charlotte Hornets,0022200946,2023-03-03T00:00:00Z,CHA vs. ORL,106,-11,1610612753,ORL,Orlando Magic,ORL @ CHA,117,11,Regular Season
22022,1610612764,WAS,Washington Wizards,0022200956,2023-03-04T00:00:00Z,WAS vs. TOR,109,-7,1610612761,TOR,Toronto Raptors,TOR @ WAS,116,7,Regular Season
22022,1610612739,CLE,Cleveland Cavaliers,0022200957,2023-03-04T00:00:00Z,CLE vs. DET,114,24,1610612765,DET,Detroit Pistons,DET @ CLE,90,-24,Regular Season
22022,1610612748,MIA,Miami Heat,0022200958,2023-03-04T00:00:00Z,MIA vs. ATL,117,8,1610612737,ATL,Atlanta Hawks,ATL @ MIA,109,-8,Regular Season
22022,1610612749,MIL,Milwaukee Bucks,0022200960,2023-03-04T00:00:00Z,MIL vs. PHI,130,-3,1610612755,PHI,Philadelphia 76ers,PHI @ MIL,133,3,Regular Season
22022,1610612758,SAC,Sacramento Kings,0022200961,2023-03-04T00:00:00Z,SAC vs. MIN,134,-4,1610612750,MIN,Minnesota Timberwolves,MIN @ SAC,138,4,Regular Season
22022,1610612759,SAS,San Antonio Spurs,0022200959,2023-03-04T00:00:00Z,SAS vs. HOU,110,-12,1610612745,HOU,Houston Rockets,HOU @ SAS,122,12,Regular Season
22022,1610612738,BOS,Boston Celtics,0022200969,2023-03-05T00:00:00Z,BOS vs. NYK,129,-2,1610612752,NYK,New York Knicks,NYK @ BOS,131,2,Regular Season
22022,1610612764,WAS,Washington Wizards,0022200973,2023-03-05T00:00:00Z,WAS vs. MIL,111,-6,1610612749,MIL,Milwaukee Bucks,MIL @ WAS,117,6,Regular Season
22022,1610612745,HOU,Houston Rockets,0022200967,2023-03-05T00:00:00Z,HOU vs. SAS,142,32,1610612759,SAS,San Antonio Spurs,SAS @ HOU,110,-32,Regular Season
22022,1610612760,OKC,Oklahoma City Thunder,0022200968,2023-03-05T00:00:00Z,OKC vs. UTA,129,10,1610612762,UTA,Utah Jazz,UTA @ OKC,119,-10,Regular Season
22022,1610612753,ORL,Orlando Magic,0022200966,2023-03-05T00:00:00Z,ORL vs. POR,119,-3,1610612757,POR,Portland Trail Blazers,POR @ ORL,122,3,Regular Season
22022,1610612751,BKN,Brooklyn Nets,0022200965,2023-03-05T00:00:00Z,BKN vs. CHA,102,16,1610612766,CHA,Charlotte Hornets,CHA @ BKN,86,-16,Regular Season
22022,1610612747,LAL,Los Angeles Lakers,0022200964,2023-03-05T00:00:00Z,LAL vs. GSW,113,8,1610612744,GSW,Golden State Warriors,GSW @ LAL,105,-8,Regular Season
22022,1610612741,CHI,Chicago Bulls,0022200963,2023-03-05T00:00:00Z,CHI vs. IND,122,-3,1610612754,IND,Indiana Pacers,IND @ CHI,125,3,Regular Season
22022,1610612746,LAC,LA Clippers,0022200970,2023-03-05T00:00:00Z,LAC vs. MEM,135,6,1610612763,MEM,Memphis Grizzlies,MEM @ LAC,129,-6,Regular Season
22022,1610612742,DAL,Dallas Mavericks,0022200962,2023-03-05T00:00:00Z,DAL vs. PHX,126,-4,1610612756,PHX,Phoenix Suns,PHX @ DAL,130,4,Regular Season
22022,1610612739,CLE,Cleveland Cavaliers,0022200971,2023-03-06T00:00:00Z,CLE vs. BOS,118,4,1610612738,BOS,Boston Celtics,BOS @ CLE,114,-4,Regular Season
22022,1610612758,SAC,Sacramento Kings,0022200976,2023-03-06T00:00:00Z,SAC vs. NOP,123,15,1610612740,NOP,New Orleans Pelicans,NOP @ SAC,108,-15,Regular Season
22022,1610612743,DEN,Denver Nuggets,0022200975,2023-03-06T00:00:00Z,DEN vs. TOR,118,5,1610612761,TOR,Toronto Raptors,TOR @ DEN,113,-5,Regular Season
22022,1610612748,MIA,Miami Heat,0022200974,2023-03-06T00:00:00Z,MIA vs. ATL,130,2,1610612737,ATL,Atlanta Hawks,ATL @ MIA,128,-2,Regular Season
22022,1610612765,DET,Detroit Pistons,0022200977,2023-03-06T00:00:00Z,DET vs. POR,104,-6,1610612757,POR,Portland Trail Blazers,POR @ DET,110,6,Regular Season
22022,1610612754,IND,Indiana Pacers,0022200972,2023-03-06T00:00:00Z,IND vs. PHI,143,-4,1610612755,PHI,Philadelphia 76ers,PHI @ IND,147,4,Regular Season
22022,1610612760,OKC,Oklahoma City Thunder,0022200982,2023-03-07T00:00:00Z,OKC vs. GSW,137,9,1610612744,GSW,Golden State Warriors,GSW @ OKC,128,-9,Regular Season
22022,1610612765,DET,Detroit Pistons,0022200769,2023-03-07T00:00:00Z,DET vs. WAS,117,-2,1610612764,WAS,Washington Wizards,WAS @ DET,119,2,Regular Season
22022,1610612753,ORL,Orlando Magic,0022200978,2023-03-07T00:00:00Z,ORL vs. MIL,123,-11,1610612749,MIL,Milwaukee Bucks,MIL @ ORL,134,11,Regular Season
22022,1610612750,MIN,Minnesota Timberwolves,0022200980,2023-03-07T00:00:00Z,MIN vs. PHI,94,-23,1610612755,PHI,Philadelphia 76ers,PHI @ MIN,117,23,Regular Season
22022,1610612752,NYK,New York Knicks,0022200979,2023-03-07T00:00:00Z,NYK vs. CHA,105,-7,1610612766,CHA,Charlotte Hornets,CHA @ NYK,112,7,Regular Season
22022,1610612747,LAL,Los Angeles Lakers,0022200984,2023-03-07T00:00:00Z,LAL vs. MEM,112,9,1610612763,MEM,Memphis Grizzlies,MEM @ LAL,103,-9,Regular Season
22022,1610612745,HOU,Houston Rockets,0022200981,2023-03-07T00:00:00Z,HOU vs. BKN,96,-22,1610612751,BKN,Brooklyn Nets,BKN @ HOU,118,22,Regular Season
22022,1610612742,DAL,Dallas Mavericks,0022200983,2023-03-07T00:00:00Z,DAL vs. UTA,120,4,1610612762,UTA,Utah Jazz,UTA @ DAL,116,-4,Regular Season
22022,1610612743,DEN,Denver Nuggets,0022200989,2023-03-08T00:00:00Z,DEN vs. CHI,96,-21,1610612741,CHI,Chicago Bulls,CHI @ DEN,117,21,Regular Season
22022,1610612748,MIA,Miami Heat,0022200987,2023-03-08T00:00:00Z,MIA vs. CLE,100,-4,1610612739,CLE,Cleveland Cavaliers,CLE @ MIA,104,4,Regular Season
22022,1610612740,NOP,New Orleans Pelicans,0022200988,2023-03-08T00:00:00Z,NOP vs. DAL,113,7,1610612742,DAL,Dallas Mavericks,DAL @ NOP,106,-7,Regular Season
22022,1610612764,WAS,Washington Wizards,0022200985,2023-03-08T00:00:00Z,WAS vs. ATL,120,-2,1610612737,ATL,Atlanta Hawks,ATL @ WAS,122,2,Regular Season
22022,1610612738,BOS,Boston Celtics,0022200986,2023-03-08T00:00:00Z,BOS vs. POR,115,22,1610612757,POR,Portland Trail Blazers,POR @ BOS,93,-22,Regular Season
22022,1610612746,LAC,LA Clippers,0022200991,2023-03-08T00:00:00Z,LAC vs. TOR,108,8,1610612761,TOR,Toronto Raptors,TOR @ LAC,100,-8,Regular Season
22022,1610612756,PHX,Phoenix Suns,0022200990,2023-03-08T00:00:00Z,PHX vs. OKC,132,31,1610612760,OKC,Oklahoma City Thunder,OKC @ PHX,101,-31,Regular Season
22022,1610612753,ORL,Orlando Magic,0022200994,2023-03-09T00:00:00Z,ORL vs. UTA,124,-7,1610612762,UTA,Utah Jazz,UTA @ ORL,131,7,Regular Season
22022,1610612754,IND,Indiana Pacers,0022200993,2023-03-09T00:00:00Z,IND vs. HOU,134,9,1610612745,HOU,Houston Rockets,HOU @ IND,125,-9,Regular Season
22022,1610612763,MEM,Memphis Grizzlies,0022200996,2023-03-09T00:00:00Z,MEM vs. GSW,131,21,1610612744,GSW,Golden State Warriors,GSW @ MEM,110,-21,Regular Season
22022,1610612765,DET,Detroit Pistons,0022200992,2023-03-09T00:00:00Z,DET vs. CHA,103,-10,1610612766,CHA,Charlotte Hornets,CHA @ DET,113,10,Regular Season
22022,1610612749,MIL,Milwaukee Bucks,0022200995,2023-03-09T00:00:00Z,MIL vs. BKN,118,5,1610612751,BKN,Brooklyn Nets,BKN @ MIL,113,-5,Regular Season
22022,1610612758,SAC,Sacramento Kings,0022200997,2023-03-09T00:00:00Z,SAC vs. NYK,122,5,1610612752,NYK,New York Knicks,NYK @ SAC,117,-5,Regular Season
22022,1610612750,MIN,Minnesota Timberwolves,0022201001,2023-03-10T00:00:00Z,MIN vs. BKN,123,-1,1610612751,BKN,Brooklyn Nets,BKN @ MIN,124,1,Regular Season
22022,1610612755,PHI,Philadelphia 76ers,0022200998,2023-03-10T00:00:00Z,PHI vs. POR,120,1,1610612757,POR,Portland Trail Blazers,POR @ PHI,119,-1,Regular Season
22022,1610612764,WAS,Washington Wizards,0022200999,2023-03-10T00:00:00Z,WAS vs. ATL,107,-7,1610612737,ATL,Atlanta Hawks,ATL @ WAS,114,7,Regular Season
22022,1610612759,SAS,San Antonio Spurs,0022201002,2023-03-10T00:00:00Z,SAS vs. DEN,128,8,1610612743,DEN,Denver Nuggets,DEN @ SAS,120,-8,Regular Season
22022,1610612747,LAL,Los Angeles Lakers,0022201003,2023-03-10T00:00:00Z,LAL vs. TOR,122,10,1610612761,TOR,Toronto Raptors,TOR @ LAL,112,-10,Regular Season
22022,1610612748,MIA,Miami Heat,0022201000,2023-03-10T00:00:00Z,MIA vs. CLE,119,4,1610612739,CLE,Cleveland Cavaliers,CLE @ MIA,115,-4,Regular Season
22022,1610612740,NOP,New Orleans Pelicans,0022201011,2023-03-11T00:00:00Z,NOP vs. OKC,96,-14,1610612760,OKC,Oklahoma City Thunder,OKC @ NOP,110,14,Regular Season
22022,1610612746,LAC,LA Clippers,0022201004,2023-03-11T00:00:00Z,LAC vs. NYK,106,11,1610612752,NYK,New York Knicks,NYK @ LAC,95,-11,Regular Season
22022,1610612765,DET,Detroit Pistons,0022201006,2023-03-11T00:00:00Z,DET vs. IND,115,-6,1610612754,IND,Indiana Pacers,IND @ DET,121,6,Regular Season
22022,1610612766,CHA,Charlotte Hornets,0022201005,2023-03-11T00:00:00Z,CHA vs. UTA,111,-8,1610612762,UTA,Utah Jazz,UTA @ CHA,119,8,Regular Season
22022,1610612753,ORL,Orlando Magic,0022201007,2023-03-11T00:00:00Z,ORL vs. MIA,126,12,1610612748,MIA,Miami Heat,MIA @ ORL,114,-12,Regular Season
22022,1610612737,ATL,Atlanta Hawks,0022201008,2023-03-11T00:00:00Z,ATL vs. BOS,125,-9,1610612738,BOS,Boston Celtics,BOS @ ATL,134,9,Regular Season
22022,1610612763,MEM,Memphis Grizzlies,0022201010,2023-03-11T00:00:00Z,MEM vs. DAL,112,4,1610612742,DAL,Dallas Mavericks,DAL @ MEM,108,-4,Regular Season
22022,1610612745,HOU,Houston Rockets,0022201009,2023-03-11T00:00:00Z,HOU vs. CHI,111,-8,1610612741,CHI,Chicago Bulls,CHI @ HOU,119,8,Regular Season
22022,1610612756,PHX,Phoenix Suns,0022201013,2023-03-11T00:00:00Z,PHX vs. SAC,119,-9,1610612758,SAC,Sacramento Kings,SAC @ PHX,128,9,Regular Season
22022,1610612744,GSW,Golden State Warriors,0022201012,2023-03-11T00:00:00Z,GSW vs. MIL,125,9,1610612749,MIL,Milwaukee Bucks,MIL @ GSW,116,-9,Regular Season
22022,1610612740,NOP,New Orleans Pelicans,0022201017,2023-03-12T00:00:00Z,NOP vs. POR,127,17,1610612757,POR,Portland Trail Blazers,POR @ NOP,110,-17,Regular Season
22022,1610612755,PHI,Philadelphia 76ers,0022201016,2023-03-12T00:00:00Z,PHI vs. WAS,112,19,1610612764,WAS,Washington Wizards,WAS @ PHI,93,-19,Regular Season
22022,1610612743,DEN,Denver Nuggets,0022201014,2023-03-12T00:00:00Z,DEN vs. BKN,120,-2,1610612751,BKN,Brooklyn Nets,BKN @ DEN,122,2,Regular Season
22022,1610612766,CHA,Charlotte Hornets,0022201015,2023-03-12T00:00:00Z,CHA vs. CLE,108,-6,1610612739,CLE,Cleveland Cavaliers,CLE @ CHA,114,6,Regular Season
22022,1610612759,SAS,San Antonio Spurs,0022201018,2023-03-12T00:00:00Z,SAS vs. OKC,90,-12,1610612760,OKC,Oklahoma City Thunder,OKC @ SAS,102,12,Regular Season
22022,1610612747,LAL,Los Angeles Lakers,0022201019,2023-03-12T00:00:00Z,LAL vs. NYK,108,-4,1610612752,NYK,New York Knicks,NYK @ LAL,112,4,Regular Season
22022,1610612765,DET,Detroit Pistons,0022201020,2023-03-13T00:00:00Z,DET vs. IND,117,20,1610612754,IND,Indiana Pacers,IND @ DET,97,-20,Regular Season
22022,1610612758,SAC,Sacramento Kings,0022201026,2023-03-13T00:00:00Z,SAC vs. MIL,124,-9,1610612749,MIL,Milwaukee Bucks,MIL @ SAC,133,9,Regular Season
22022,1610612744,GSW,Golden State Warriors,0022201025,2023-03-13T00:00:00Z,GSW vs. PHX,123,11,1610612756,PHX,Phoenix Suns,PHX @ GSW,112,-11,Regular Season
22022,1610612742,DAL,Dallas Mavericks,0022201023,2023-03-13T00:00:00Z,DAL vs. MEM,88,-16,1610612763,MEM,Memphis Grizzlies,MEM @ DAL,104,16,Regular Season
22022,1610612745,HOU,Houston Rockets,0022201024,2023-03-13T00:00:00Z,HOU vs. BOS,111,2,1610612738,BOS,Boston Celtics,BOS @ HOU,109,-2,Regular Season
22022,1610612748,MIA,Miami Heat,0022201022,2023-03-13T00:00:00Z,MIA vs. UTA,119,4,1610612762,UTA,Utah Jazz,UTA @ MIA,115,-4,Regular Season
22022,1610612737,ATL,Atlanta Hawks,0022201021,2023-03-13T00:00:00Z,ATL vs. MIN,115,-21,1610612750,MIN,Minnesota Timberwolves,MIN @ ATL,136,21,Regular Season
22022,1610612764,WAS,Washington Wizards,0022201028,2023-03-14T00:00:00Z,WAS vs. DET,117,20,1610612765,DET,Detroit Pistons,DET @ WAS,97,-20,Regular Season
22022,1610612756,PHX,Phoenix Suns,0022201033,2023-03-14T00:00:00Z,PHX vs. MIL,104,-12,1610612749,MIL,Milwaukee Bucks,MIL @ PHX,116,12,Regular Season
22022,1610612757,POR,Portland Trail Blazers,0022201034,2023-03-14T00:00:00Z,POR vs. NYK,107,-16,1610612752,NYK,New York Knicks,NYK @ POR,123,16,Regular Season
22022,1610612740,NOP,New Orleans Pelicans,0022201030,2023-03-14T00:00:00Z,NOP vs. LAL,108,-15,1610612747,LAL,Los Angeles Lakers,LAL @ NOP,123,15,Regular Season
22022,1610612766,CHA,Charlotte Hornets,0022201027,2023-03-14T00:00:00Z,CHA vs. CLE,104,-16,1610612739,CLE,Cleveland Cavaliers,CLE @ CHA,120,16,Regular Season
22022,1610612761,TOR,Toronto Raptors,0022201029,2023-03-14T00:00:00Z,TOR vs. DEN,125,15,1610612743,DEN,Denver Nuggets,DEN @ TOR,110,-15,Regular Season
22022,1610612759,SAS,San Antonio Spurs,0022201032,2023-03-14T00:00:00Z,SAS vs. ORL,132,18,1610612753,ORL,Orlando Magic,ORL @ SAS,114,-18,Regular Season
22022,1610612760,OKC,Oklahoma City Thunder,0022201031,2023-03-14T00:00:00Z,OKC vs. BKN,121,14,1610612751,BKN,Brooklyn Nets,BKN @ OKC,107,-14,Regular Season
22022,1610612748,MIA,Miami Heat,0022201036,2023-03-15T00:00:00Z,MIA vs. MEM,138,19,1610612763,MEM,Memphis Grizzlies,MEM @ MIA,119,-19,Regular Season
22022,1610612746,LAC,LA Clippers,0022201041,2023-03-15T00:00:00Z,LAC vs. GSW,134,8,1610612744,GSW,Golden State Warriors,GSW @ LAC,126,-8,Regular Season
22022,1610612741,CHI,Chicago Bulls,0022201037,2023-03-15T00:00:00Z,CHI vs. SAC,114,-3,1610612758,SAC,Sacramento Kings,SAC @ CHI,117,3,Regular Season
22022,1610612739,CLE,Cleveland Cavaliers,0022201035,2023-03-15T00:00:00Z,CLE vs. PHI,109,-9,1610612755,PHI,Philadelphia 76ers,PHI @ CLE,118,9,Regular Season
22022,1610612750,MIN,Minnesota Timberwolves,0022201039,2023-03-15T00:00:00Z,MIN vs. BOS,102,-2,1610612738,BOS,Boston Celtics,BOS @ MIN,104,2,Regular Season
22022,1610612745,HOU,Houston Rockets,0022201038,2023-03-15T00:00:00Z,HOU vs. LAL,114,4,1610612747,LAL,Los Angeles Lakers,LAL @ HOU,110,-4,Regular Season
22022,1610612759,SAS,San Antonio Spurs,0022201040,2023-03-15T00:00:00Z,SAS vs. DAL,128,-9,1610612742,DAL,Dallas Mavericks,DAL @ SAS,137,9,Regular Season
22022,1610612749,MIL,Milwaukee Bucks,0022201045,2023-03-16T00:00:00Z,MIL vs. IND,123,-16,1610612754,IND,Indiana Pacers,IND @ MIL,139,16,Regular Season
22022,1610612756,PHX,Phoenix Suns,0022201046,2023-03-16T00:00:00Z,PHX vs. ORL,116,3,1610612753,ORL,Orlando Magic,ORL @ PHX,113,-3,Regular Season
22022,1610612765,DET,Detroit Pistons,0022201042,2023-03-16T00:00:00Z,DET vs. DEN,100,-19,1610612743,DEN,Denver Nuggets,DEN @ DET,119,19,Regular Season
22022,1610612751,BKN,Brooklyn Nets,0022201043,2023-03-16T00:00:00Z,BKN vs. SAC,96,-5,1610612758,SAC,Sacramento Kings,SAC @ BKN,101,5,Regular Season
22022,1610612761,TOR,Toronto Raptors,0022201044,2023-03-16T00:00:00Z,TOR vs. OKC,128,17,1610612760,OKC,Oklahoma City Thunder,OKC @ TOR,111,-17,Regular Season
22022,1610612747,LAL,Los Angeles Lakers,0022201054,2023-03-17T00:00:00Z,LAL vs. DAL,110,-1,1610612742,DAL,Dallas Mavericks,DAL @ LAL,111,1,Regular Season
22022,1610612757,POR,Portland Trail Blazers,0022201053,2023-03-17T00:00:00Z,POR vs. BOS,112,-14,1610612738,BOS,Boston Celtics,BOS @ POR,126,14,Regular Season
22022,1610612741,CHI,Chicago Bulls,0022201050,2023-03-17T00:00:00Z,CHI vs. MIN,139,8,1610612750,MIN,Minnesota Timberwolves,MIN @ CHI,131,-8,Regular Season
22022,1610612759,SAS,San Antonio Spurs,0022201052,2023-03-17T00:00:00Z,SAS vs. MEM,120,-6,1610612763,MEM,Memphis Grizzlies,MEM @ SAS,126,6,Regular Season
22022,1610612745,HOU,Houston Rockets,0022201051,2023-03-17T00:00:00Z,HOU vs. NOP,114,2,1610612740,NOP,New Orleans Pelicans,NOP @ HOU,112,-2,Regular Season
22022,1610612766,CHA,Charlotte Hornets,0022201047,2023-03-17T00:00:00Z,CHA vs. PHI,82,-39,1610612755,PHI,Philadelphia 76ers,PHI @ CHA,121,39,Regular Season
22022,1610612739,CLE,Cleveland Cavaliers,0022201049,2023-03-17T00:00:00Z,CLE vs. WAS,117,23,1610612764,WAS,Washington Wizards,WAS @ CLE,94,-23,Regular Season
22022,1610612737,ATL,Atlanta Hawks,0022201048,2023-03-17T00:00:00Z,ATL vs. GSW,127,8,1610612744,GSW,Golden State Warriors,GSW @ ATL,119,-8,Regular Season
22022,1610612752,NYK,New York Knicks,0022201055,2023-03-18T00:00:00Z,NYK vs. DEN,116,6,1610612743,DEN,Denver Nuggets,DEN @ NYK,110,-6,Regular Season
22022,1610612746,LAC,LA Clippers,0022201056,2023-03-18T00:00:00Z,LAC vs. ORL,108,-5,1610612753,ORL,Orlando Magic,ORL @ LAC,113,5,Regular Season
22022,1610612741,CHI,Chicago Bulls,0022201060,2023-03-18T00:00:00Z,CHI vs. MIA,113,14,1610612748,MIA,Miami Heat,MIA @ CHI,99,-14,Regular Season
22022,1610612754,IND,Indiana Pacers,0022201057,2023-03-18T00:00:00Z,IND vs. PHI,121,-20,1610612755,PHI,Philadelphia 76ers,PHI @ IND,141,20,Regular Season
22022,1610612761,TOR,Toronto Raptors,0022201058,2023-03-18T00:00:00Z,TOR vs. MIN,122,15,1610612750,MIN,Minnesota Timberwolves,MIN @ TOR,107,-15,Regular Season
22022,1610612764,WAS,Washington Wizards,0022201059,2023-03-18T00:00:00Z,WAS vs. SAC,118,-14,1610612758,SAC,Sacramento Kings,SAC @ WAS,132,14,Regular Season
22022,1610612763,MEM,Memphis Grizzlies,0022201061,2023-03-18T00:00:00Z,MEM vs. GSW,133,14,1610612744,GSW,Golden State Warriors,GSW @ MEM,119,-14,Regular Season
22022,1610612762,UTA,Utah Jazz,0022201062,2023-03-18T00:00:00Z,UTA vs. BOS,118,1,1610612738,BOS,Boston Celtics,BOS @ UTA,117,-1,Regular Season
22022,1610612751,BKN,Brooklyn Nets,0022201063,2023-03-19T00:00:00Z,BKN vs. DEN,102,-6,1610612743,DEN,Denver Nuggets,DEN @ BKN,108,6,Regular Season
22022,1610612760,OKC,Oklahoma City Thunder,0022201064,2023-03-19T00:00:00Z,OKC vs. PHX,124,4,1610612756,PHX,Phoenix Suns,PHX @ OKC,120,-4,Regular Season
22022,1610612759,SAS,San Antonio Spurs,0022201065,2023-03-19T00:00:00Z,SAS vs. ATL,126,8,1610612737,ATL,Atlanta Hawks,ATL @ SAS,118,-8,Regular Season
22022,1610612749,MIL,Milwaukee Bucks,0022201068,2023-03-19T00:00:00Z,MIL vs. TOR,118,7,1610612761,TOR,Toronto Raptors,TOR @ MIL,111,-7,Regular Season
22022,1610612757,POR,Portland Trail Blazers,0022201069,2023-03-19T00:00:00Z,POR vs. LAC,102,-15,1610612746,LAC,LA Clippers,LAC @ POR,117,15,Regular Season
22022,1610612765,DET,Detroit Pistons,0022201066,2023-03-19T00:00:00Z,DET vs. MIA,100,-12,1610612748,MIA,Miami Heat,MIA @ DET,112,12,Regular Season
22022,1610612745,HOU,Houston Rockets,0022201067,2023-03-19T00:00:00Z,HOU vs. NOP,107,-10,1610612740,NOP,New Orleans Pelicans,NOP @ HOU,117,10,Regular Season
22022,1610612747,LAL,Los Angeles Lakers,0022201070,2023-03-19T00:00:00Z,LAL vs. ORL,111,6,1610612753,ORL,Orlando Magic,ORL @ LAL,105,-6,Regular Season
22022,1610612745,HOU,Houston Rockets,0022201074,2023-03-20T00:00:00Z,HOU vs. GSW,108,-13,1610612744,GSW,Golden State Warriors,GSW @ HOU,121,13,Regular Season
22022,1610612766,CHA,Charlotte Hornets,0022201071,2023-03-20T00:00:00Z,CHA vs. IND,115,6,1610612754,IND,Indiana Pacers,IND @ CHA,109,-6,Regular Season
22022,1610612755,PHI,Philadelphia 76ers,0022201072,2023-03-20T00:00:00Z,PHI vs. CHI,105,-4,1610612741,CHI,Chicago Bulls,CHI @ PHI,109,4,Regular Season
22022,1610612762,UTA,Utah Jazz,0022201076,2023-03-20T00:00:00Z,UTA vs. SAC,128,8,1610612758,SAC,Sacramento Kings,SAC @ UTA,120,-8,Regular Season
22022,1610612752,NYK,New York Knicks,0022201073,2023-03-20T00:00:00Z,NYK vs. MIN,134,-6,1610612750,MIN,Minnesota Timberwolves,MIN @ NYK,140,6,Regular Season
22022,1610612763,MEM,Memphis Grizzlies,0022201075,2023-03-20T00:00:00Z,MEM vs. DAL,112,4,1610612742,DAL,Dallas Mavericks,DAL @ MEM,108,-4,Regular Season
22022,1610612740,NOP,New Orleans Pelicans,0022201080,2023-03-21T00:00:00Z,NOP vs. SAS,119,35,1610612759,SAS,San Antonio Spurs,SAS @ NOP,84,-35,Regular Season
22022,1610612753,ORL,Orlando Magic,0022201077,2023-03-21T00:00:00Z,ORL vs. WAS,122,10,1610612764,WAS,Washington Wizards,WAS @ ORL,112,-10,Regular Season
22022,1610612751,BKN,Brooklyn Nets,0022201079,2023-03-21T00:00:00Z,BKN vs. CLE,109,-6,1610612739,CLE,Cleveland Cavaliers,CLE @ BKN,115,6,Regular Season
22022,1610612737,ATL,Atlanta Hawks,0022201078,2023-03-21T00:00:00Z,ATL vs. DET,129,22,1610612765,DET,Detroit Pistons,DET @ ATL,107,-22,Regular Season
22022,1610612758,SAC,Sacramento Kings,0022201081,2023-03-21T00:00:00Z,SAC vs. BOS,109,-23,1610612738,BOS,Boston Celtics,BOS @ SAC,132,23,Regular Season
22022,1610612746,LAC,LA Clippers,0022201082,2023-03-21T00:00:00Z,LAC vs. OKC,100,-1,1610612760,OKC,Oklahoma City Thunder,OKC @ LAC,101,1,Regular Season
22022,1610612761,TOR,Toronto Raptors,0022201085,2023-03-22T00:00:00Z,TOR vs. IND,114,-4,1610612754,IND,Indiana Pacers,IND @ TOR,118,4,Regular Season
22022,1610612748,MIA,Miami Heat,0022201084,2023-03-22T00:00:00Z,MIA vs. NYK,127,7,1610612752,NYK,New York Knicks,NYK @ MIA,120,-7,Regular Season
22022,1610612763,MEM,Memphis Grizzlies,0022201088,2023-03-22T00:00:00Z,MEM vs. HOU,130,5,1610612745,HOU,Houston Rockets,HOU @ MEM,125,-5,Regular Season
22022,1610612742,DAL,Dallas Mavericks,0022201086,2023-03-22T00:00:00Z,DAL vs. GSW,125,-2,1610612744,GSW,Golden State Warriors,GSW @ DAL,127,2,Regular Season
22022,1610612750,MIN,Minnesota Timberwolves,0022201090,2023-03-22T00:00:00Z,MIN vs. ATL,125,1,1610612737,ATL,Atlanta Hawks,ATL @ MIN,124,-1,Regular Season
22022,1610612749,MIL,Milwaukee Bucks,0022201089,2023-03-22T00:00:00Z,MIL vs. SAS,130,36,1610612759,SAS,San Antonio Spurs,SAS @ MIL,94,-36,Regular Season
22022,1610612741,CHI,Chicago Bulls,0022201087,2023-03-22T00:00:00Z,CHI vs. PHI,91,-25,1610612755,PHI,Philadelphia 76ers,PHI @ CHI,116,25,Regular Season
22022,1610612762,UTA,Utah Jazz,0022201091,2023-03-22T00:00:00Z,UTA vs. POR,115,-12,1610612757,POR,Portland Trail Blazers,POR @ UTA,127,12,Regular Season
22022,1610612747,LAL,Los Angeles Lakers,0022201092,2023-03-22T00:00:00Z,LAL vs. PHX,122,11,1610612756,PHX,Phoenix Suns,PHX @ LAL,111,-11,Regular Season
22022,1610612764,WAS,Washington Wizards,0022201083,2023-03-22T00:00:00Z,WAS vs. DEN,104,-14,1610612743,DEN,Denver Nuggets,DEN @ WAS,118,14,Regular Season
22022,1610612751,BKN,Brooklyn Nets,0022201094,2023-03-23T00:00:00Z,BKN vs. CLE,114,-2,1610612739,CLE,Cleveland Cavaliers,CLE @ BKN,116,2,Regular Season
22022,1610612746,LAC,LA Clippers,0022201096,2023-03-23T00:00:00Z,LAC vs. OKC,127,22,1610612760,OKC,Oklahoma City Thunder,OKC @ LAC,105,-22,Regular Season
22022,1610612740,NOP,New Orleans Pelicans,0022201095,2023-03-23T00:00:00Z,NOP vs. CHA,115,19,1610612766,CHA,Charlotte Hornets,CHA @ NOP,96,-19,Regular Season
22022,1610612753,ORL,Orlando Magic,0022201093,2023-03-23T00:00:00Z,ORL vs. NYK,111,5,1610612752,NYK,New York Knicks,NYK @ ORL,106,-5,Regular Season
22022,1610612744,GSW,Golden State Warriors,0022201103,2023-03-24T00:00:00Z,GSW vs. PHI,120,8,1610612755,PHI,Philadelphia 76ers,PHI @ GSW,112,-8,Regular Season
22022,1610612747,LAL,Los Angeles Lakers,0022201106,2023-03-24T00:00:00Z,LAL vs. OKC,116,5,1610612760,OKC,Oklahoma City Thunder,OKC @ LAL,111,-5,Regular Season
22022,1610612758,SAC,Sacramento Kings,0022201105,2023-03-24T00:00:00Z,SAC vs. PHX,135,8,1610612756,PHX,Phoenix Suns,PHX @ SAC,127,-8,Regular Season
22022,1610612757,POR,Portland Trail Blazers,0022201104,2023-03-24T00:00:00Z,POR vs. CHI,96,-28,1610612741,CHI,Chicago Bulls,CHI @ POR,124,28,Regular Season
22022,1610612764,WAS,Washington Wizards,0022201098,2023-03-24T00:00:00Z,WAS vs. SAS,136,12,1610612759,SAS,San Antonio Spurs,SAS @ WAS,124,-12,Regular Season
22022,1610612762,UTA,Utah Jazz,0022201102,2023-03-24T00:00:00Z,UTA vs. MIL,116,-28,1610612749,MIL,Milwaukee Bucks,MIL @ UTA,144,28,Regular Season
22022,1610612742,DAL,Dallas Mavericks,0022201101,2023-03-24T00:00:00Z,DAL vs. CHA,109,-8,1610612766,CHA,Charlotte Hornets,CHA @ DAL,117,8,Regular Season
22022,1610612763,MEM,Memphis Grizzlies,0022201100,2023-03-24T00:00:00Z,MEM vs. HOU,151,37,1610612745,HOU,Houston Rockets,HOU @ MEM,114,-37,Regular Season
22022,1610612761,TOR,Toronto Raptors,0022201099,2023-03-24T00:00:00Z,TOR vs. DET,118,21,1610612765,DET,Detroit Pistons,DET @ TOR,97,-21,Regular Season
22022,1610612738,BOS,Boston Celtics,0022201097,2023-03-24T00:00:00Z,BOS vs. IND,120,25,1610612754,IND,Indiana Pacers,IND @ BOS,95,-25,Regular Season
22022,1610612743,DEN,Denver Nuggets,0022201109,2023-03-25T00:00:00Z,DEN vs. MIL,129,23,1610612749,MIL,Milwaukee Bucks,MIL @ DEN,106,-23,Regular Season
22022,1610612748,MIA,Miami Heat,0022201108,2023-03-25T00:00:00Z,MIA vs. BKN,100,-29,1610612751,BKN,Brooklyn Nets,BKN @ MIA,129,29,Regular Season
22022,1610612737,ATL,Atlanta Hawks,0022201107,2023-03-25T00:00:00Z,ATL vs. IND,143,13,1610612754,IND,Indiana Pacers,IND @ ATL,130,-13,Regular Season
22022,1610612758,SAC,Sacramento Kings,0022201111,2023-03-25T00:00:00Z,SAC vs. UTA,121,8,1610612762,UTA,Utah Jazz,UTA @ SAC,113,-8,Regular Season
22022,1610612756,PHX,Phoenix Suns,0022201110,2023-03-25T00:00:00Z,PHX vs. PHI,125,20,1610612755,PHI,Philadelphia 76ers,PHI @ PHX,105,-20,Regular Season
22022,1610612746,LAC,LA Clippers,0022201112,2023-03-25T00:00:00Z,LAC vs. NOP,110,-21,1610612740,NOP,New Orleans Pelicans,NOP @ LAC,131,21,Regular Season
22022,1610612737,ATL,Atlanta Hawks,0022201115,2023-03-26T00:00:00Z,ATL vs. MEM,119,-4,1610612763,MEM,Memphis Grizzlies,MEM @ ATL,123,4,Regular Season
22022,1610612753,ORL,Orlando Magic,0022201118,2023-03-26T00:00:00Z,ORL vs. BKN,119,13,1610612751,BKN,Brooklyn Nets,BKN @ ORL,106,-13,Regular Season
22022,1610612739,CLE,Cleveland Cavaliers,0022201117,2023-03-26T00:00:00Z,CLE vs. HOU,108,17,1610612745,HOU,Houston Rockets,HOU @ CLE,91,-17,Regular Season
22022,1610612761,TOR,Toronto Raptors,0022201119,2023-03-26T00:00:00Z,TOR vs. WAS,114,10,1610612764,WAS,Washington Wizards,WAS @ TOR,104,-10,Regular Season
22022,1610612747,LAL,Los Angeles Lakers,0022201114,2023-03-26T00:00:00Z,LAL vs. CHI,108,-10,1610612741,CHI,Chicago Bulls,CHI @ LAL,118,10,Regular Season
22022,1610612766,CHA,Charlotte Hornets,0022201113,2023-03-26T00:00:00Z,CHA vs. DAL,110,6,1610612742,DAL,Dallas Mavericks,DAL @ CHA,104,-6,Regular Season
22022,1610612757,POR,Portland Trail Blazers,0022201120,2023-03-26T00:00:00Z,POR vs. OKC,112,-6,1610612760,OKC,Oklahoma City Thunder,OKC @ POR,118,6,Regular Season
22022,1610612744,GSW,Golden State Warriors,0022201121,2023-03-26T00:00:00Z,GSW vs. MIN,96,-3,1610612750,MIN,Minnesota Timberwolves,MIN @ GSW,99,3,Regular Season
22022,1610612738,BOS,Boston Celtics,0022201116,2023-03-26T00:00:00Z,BOS vs. SAS,137,44,1610612759,SAS,San Antonio Spurs,SAS @ BOS,93,-44,Regular Season
22022,1610612754,IND,Indiana Pacers,0022201123,2023-03-27T00:00:00Z,IND vs. DAL,104,-23,1610612742,DAL,Dallas Mavericks,DAL @ IND,127,23,Regular Season
22022,1610612758,SAC,Sacramento Kings,0022201128,2023-03-27T00:00:00Z,SAC vs. MIN,115,-4,1610612750,MIN,Minnesota Timberwolves,MIN @ SAC,119,4,Regular Season
22022,1610612765,DET,Detroit Pistons,0022201122,2023-03-27T00:00:00Z,DET vs. MIL,117,-9,1610612749,MIL,Milwaukee Bucks,MIL @ DET,126,9,Regular Season
22022,1610612746,LAC,LA Clippers,0022201129,2023-03-27T00:00:00Z,LAC vs. CHI,124,12,1610612741,CHI,Chicago Bulls,CHI @ LAC,112,-12,Regular Season
22022,1610612752,NYK,New York Knicks,0022201124,2023-03-27T00:00:00Z,NYK vs. HOU,137,22,1610612745,HOU,Houston Rockets,HOU @ NYK,115,-22,Regular Season
22022,1610612757,POR,Portland Trail Blazers,0022201127,2023-03-27T00:00:00Z,POR vs. NOP,90,-34,1610612740,NOP,New Orleans Pelicans,NOP @ POR,124,34,Regular Season
22022,1610612743,DEN,Denver Nuggets,0022201126,2023-03-27T00:00:00Z,DEN vs. PHI,116,5,1610612755,PHI,Philadelphia 76ers,PHI @ DEN,111,-5,Regular Season
22022,1610612762,UTA,Utah Jazz,0022201125,2023-03-27T00:00:00Z,UTA vs. PHX,103,-14,1610612756,PHX,Phoenix Suns,PHX @ UTA,117,14,Regular Season
22022,1610612760,OKC,Oklahoma City Thunder,0022201134,2023-03-28T00:00:00Z,OKC vs. CHA,134,-3,1610612766,CHA,Charlotte Hornets,CHA @ OKC,137,3,Regular Season
22022,1610612764,WAS,Washington Wizards,0022201130,2023-03-28T00:00:00Z,WAS vs. BOS,130,19,1610612738,BOS,Boston Celtics,BOS @ WAS,111,-19,Regular Season
22022,1610612761,TOR,Toronto Raptors,0022201132,2023-03-28T00:00:00Z,TOR vs. MIA,106,14,1610612748,MIA,Miami Heat,MIA @ TOR,92,-14,Regular Season
22022,1610612737,ATL,Atlanta Hawks,0022201131,2023-03-28T00:00:00Z,ATL vs. CLE,120,2,1610612739,CLE,Cleveland Cavaliers,CLE @ ATL,118,-2,Regular Season
22022,1610612744,GSW,Golden State Warriors,0022201135,2023-03-28T00:00:00Z,GSW vs. NOP,120,11,1610612740,NOP,New Orleans Pelicans,NOP @ GSW,109,-11,Regular Season
22022,1610612763,MEM,Memphis Grizzlies,0022201133,2023-03-28T00:00:00Z,MEM vs. ORL,113,5,1610612753,ORL,Orlando Magic,ORL @ MEM,108,-5,Regular Season
22022,1610612759,SAS,San Antonio Spurs,0022201143,2023-03-29T00:00:00Z,SAS vs. UTA,117,-11,1610612762,UTA,Utah Jazz,UTA @ SAS,128,11,Regular Season
22022,1610612755,PHI,Philadelphia 76ers,0022201139,2023-03-29T00:00:00Z,PHI vs. DAL,116,8,1610612742,DAL,Dallas Mavericks,DAL @ PHI,108,-8,Regular Season
22022,1610612751,BKN,Brooklyn Nets,0022201137,2023-03-29T00:00:00Z,BKN vs. HOU,123,9,1610612745,HOU,Houston Rockets,HOU @ BKN,114,-9,Regular Season
22022,1610612752,NYK,New York Knicks,0022201138,2023-03-29T00:00:00Z,NYK vs. MIA,101,9,1610612748,MIA,Miami Heat,MIA @ NYK,92,-9,Regular Season
22022,1610612754,IND,Indiana Pacers,0022201136,2023-03-29T00:00:00Z,IND vs. MIL,136,-13,1610612749,MIL,Milwaukee Bucks,MIL @ IND,149,13,Regular Season
22022,1610612741,CHI,Chicago Bulls,0022201140,2023-03-29T00:00:00Z,CHI vs. LAL,110,-11,1610612747,LAL,Los Angeles Lakers,LAL @ CHI,121,11,Regular Season
22022,1610612757,POR,Portland Trail Blazers,0022201145,2023-03-29T00:00:00Z,POR vs. SAC,80,-40,1610612758,SAC,Sacramento Kings,SAC @ POR,120,40,Regular Season
22022,1610612763,MEM,Memphis Grizzlies,0022201141,2023-03-29T00:00:00Z,MEM vs. LAC,132,-9,1610612746,LAC,LA Clippers,LAC @ MEM,141,9,Regular Season
22022,1610612760,OKC,Oklahoma City Thunder,0022201142,2023-03-29T00:00:00Z,OKC vs. DET,107,1,1610612765,DET,Detroit Pistons,DET @ OKC,106,-1,Regular Season
22022,1610612756,PHX,Phoenix Suns,0022201144,2023-03-29T00:00:00Z,PHX vs. MIN,107,7,1610612750,MIN,Minnesota Timberwolves,MIN @ PHX,100,-7,Regular Season
22022,1610612749,MIL,Milwaukee Bucks,0022201146,2023-03-30T00:00:00Z,MIL vs. BOS,99,-41,1610612738,BOS,Boston Celtics,BOS @ MIL,140,41,Regular Season
22022,1610612743,DEN,Denver Nuggets,0022201147,2023-03-30T00:00:00Z,DEN vs. NOP,88,-19,1610612740,NOP,New Orleans Pelicans,NOP @ DEN,107,19,Regular Season
22022,1610612756,PHX,Phoenix Suns,0022201160,2023-03-31T00:00:00Z,PHX vs. DEN,100,7,1610612743,DEN,Denver Nuggets,DEN @ PHX,93,-7,Regular Season
22022,1610612744,GSW,Golden State Warriors,0022201158,2023-03-31T00:00:00Z,GSW vs. SAS,130,15,1610612759,SAS,San Antonio Spurs,SAS @ GSW,115,-15,Regular Season
22022,1610612757,POR,Portland Trail Blazers,0022201159,2023-03-31T00:00:00Z,POR vs. SAC,114,-24,1610612758,SAC,Sacramento Kings,SAC @ POR,138,24,Regular Season
22022,1610612745,HOU,Houston Rockets,0022201155,2023-03-31T00:00:00Z,HOU vs. DET,121,6,1610612765,DET,Detroit Pistons,DET @ HOU,115,-6,Regular Season
22022,1610612750,MIN,Minnesota Timberwolves,0022201157,2023-03-31T00:00:00Z,MIN vs. LAL,111,-12,1610612747,LAL,Los Angeles Lakers,LAL @ MIN,123,12,Regular Season
22022,1610612763,MEM,Memphis Grizzlies,0022201156,2023-03-31T00:00:00Z,MEM vs. LAC,108,14,1610612746,LAC,LA Clippers,LAC @ MEM,94,-14,Regular Season
22022,1610612764,WAS,Washington Wizards,0022201151,2023-03-31T00:00:00Z,WAS vs. ORL,109,-7,1610612753,ORL,Orlando Magic,ORL @ WAS,116,7,Regular Season
22022,1610612751,BKN,Brooklyn Nets,0022201153,2023-03-31T00:00:00Z,BKN vs. ATL,124,17,1610612737,ATL,Atlanta Hawks,ATL @ BKN,107,-17,Regular Season
22022,1610612739,CLE,Cleveland Cavaliers,0022201154,2023-03-31T00:00:00Z,CLE vs. NYK,116,-14,1610612752,NYK,New York Knicks,NYK @ CLE,130,14,Regular Season
22022,1610612738,BOS,Boston Celtics,0022201152,2023-03-31T00:00:00Z,BOS vs. UTA,122,8,1610612762,UTA,Utah Jazz,UTA @ BOS,114,-8,Regular Season
22022,1610612754,IND,Indiana Pacers,0022201149,2023-03-31T00:00:00Z,IND vs. OKC,121,4,1610612760,OKC,Oklahoma City Thunder,OKC @ IND,117,-4,Regular Season
22022,1610612755,PHI,Philadelphia 76ers,0022201150,2023-03-31T00:00:00Z,PHI vs. TOR,117,7,1610612761,TOR,Toronto Raptors,TOR @ PHI,110,-7,Regular Season
22022,1610612766,CHA,Charlotte Hornets,0022201148,2023-03-31T00:00:00Z,CHA vs. CHI,91,-30,1610612741,CHI,Chicago Bulls,CHI @ CHA,121,30,Regular Season
22022,1610612740,NOP,New Orleans Pelicans,0022201162,2023-04-01T00:00:00Z,NOP vs. LAC,122,8,1610612746,LAC,LA Clippers,LAC @ NOP,114,-8,Regular Season
22022,1610612748,MIA,Miami Heat,0022201161,2023-04-01T00:00:00Z,MIA vs. DAL,129,7,1610612742,DAL,Dallas Mavericks,DAL @ MIA,122,-7,Regular Season
22022,1610612752,NYK,New York Knicks,0022201168,2023-04-02T00:00:00Z,NYK vs. WAS,118,9,1610612764,WAS,Washington Wizards,WAS @ NYK,109,-9,Regular Season
22022,1610612758,SAC,Sacramento Kings,0022201170,2023-04-02T00:00:00Z,SAC vs. SAS,134,-8,1610612759,SAS,San Antonio Spurs,SAS @ SAC,142,8,Regular Season
22022,1610612749,MIL,Milwaukee Bucks,0022201174,2023-04-02T00:00:00Z,MIL vs. PHI,117,13,1610612755,PHI,Philadelphia 76ers,PHI @ MIL,104,-13,Regular Season
22022,1610612751,BKN,Brooklyn Nets,0022201164,2023-04-02T00:00:00Z,BKN vs. UTA,111,1,1610612762,UTA,Utah Jazz,UTA @ BKN,110,-1,Regular Season
22022,1610612739,CLE,Cleveland Cavaliers,0022201173,2023-04-02T00:00:00Z,CLE vs. IND,115,10,1610612754,IND,Indiana Pacers,IND @ CLE,105,-10,Regular Season
22022,1610612737,ATL,Atlanta Hawks,0022201167,2023-04-02T00:00:00Z,ATL vs. DAL,132,2,1610612742,DAL,Dallas Mavericks,DAL @ ATL,130,-2,Regular Season
22022,1610612741,CHI,Chicago Bulls,0022201165,2023-04-02T00:00:00Z,CHI vs. MEM,128,21,1610612763,MEM,Memphis Grizzlies,MEM @ CHI,107,-21,Regular Season
22022,1610612753,ORL,Orlando Magic,0022201169,2023-04-02T00:00:00Z,ORL vs. DET,128,26,1610612765,DET,Detroit Pistons,DET @ ORL,102,-26,Regular Season
22022,1610612760,OKC,Oklahoma City Thunder,0022201172,2023-04-02T00:00:00Z,OKC vs. PHX,118,-10,1610612756,PHX,Phoenix Suns,PHX @ OKC,128,10,Regular Season
22022,1610612745,HOU,Houston Rockets,0022201171,2023-04-02T00:00:00Z,HOU vs. LAL,109,-25,1610612747,LAL,Los Angeles Lakers,LAL @ HOU,134,25,Regular Season
22022,1610612750,MIN,Minnesota Timberwolves,0022201166,2023-04-02T00:00:00Z,MIN vs. POR,105,-2,1610612757,POR,Portland Trail Blazers,POR @ MIN,107,2,Regular Season
22022,1610612766,CHA,Charlotte Hornets,0022201163,2023-04-02T00:00:00Z,CHA vs. TOR,108,-20,1610612761,TOR,Toronto Raptors,TOR @ CHA,128,20,Regular Season
22022,1610612743,DEN,Denver Nuggets,0022201175,2023-04-02T00:00:00Z,DEN vs. GSW,112,2,1610612744,GSW,Golden State Warriors,GSW @ DEN,110,-2,Regular Season
22022,1610612751,BKN,Brooklyn Nets,0022201180,2023-04-04T00:00:00Z,BKN vs. MIN,102,-5,1610612750,MIN,Minnesota Timberwolves,MIN @ BKN,107,5,Regular Season
22022,1610612762,UTA,Utah Jazz,0022201186,2023-04-04T00:00:00Z,UTA vs. LAL,133,-2,1610612747,LAL,Los Angeles Lakers,LAL @ UTA,135,2,Regular Season
22022,1610612756,PHX,Phoenix Suns,0022201188,2023-04-04T00:00:00Z,PHX vs. SAS,115,21,1610612759,SAS,San Antonio Spurs,SAS @ PHX,94,-21,Regular Season
22022,1610612764,WAS,Washington Wizards,0022201179,2023-04-04T00:00:00Z,WAS vs. MIL,128,-12,1610612749,MIL,Milwaukee Bucks,MIL @ WAS,140,12,Regular Season
22022,1610612741,CHI,Chicago Bulls,0022201182,2023-04-04T00:00:00Z,CHI vs. ATL,105,-18,1610612737,ATL,Atlanta Hawks,ATL @ CHI,123,18,Regular Season
22022,1610612763,MEM,Memphis Grizzlies,0022201184,2023-04-04T00:00:00Z,MEM vs. POR,119,10,1610612757,POR,Portland Trail Blazers,POR @ MEM,109,-10,Regular Season
22022,1610612740,NOP,New Orleans Pelicans,0022201185,2023-04-04T00:00:00Z,NOP vs. SAC,103,-18,1610612758,SAC,Sacramento Kings,SAC @ NOP,121,18,Regular Season
22022,1610612755,PHI,Philadelphia 76ers,0022201181,2023-04-04T00:00:00Z,PHI vs. BOS,103,2,1610612738,BOS,Boston Celtics,BOS @ PHI,101,-2,Regular Season
22022,1610612745,HOU,Houston Rockets,0022201183,2023-04-04T00:00:00Z,HOU vs. DEN,124,21,1610612743,DEN,Denver Nuggets,DEN @ HOU,103,-21,Regular Season
22022,1610612766,CHA,Charlotte Hornets,0022201176,2023-04-04T00:00:00Z,CHA vs. TOR,100,-20,1610612761,TOR,Toronto Raptors,TOR @ CHA,120,20,Regular Season
22022,1610612765,DET,Detroit Pistons,0022201177,2023-04-04T00:00:00Z,DET vs. MIA,105,-13,1610612748,MIA,Miami Heat,MIA @ DET,118,13,Regular Season
22022,1610612753,ORL,Orlando Magic,0022201178,2023-04-04T00:00:00Z,ORL vs. CLE,113,-4,1610612739,CLE,Cleveland Cavaliers,CLE @ ORL,117,4,Regular Season
22022,1610612744,GSW,Golden State Warriors,0022201187,2023-04-04T00:00:00Z,GSW vs. OKC,136,11,1610612760,OKC,Oklahoma City Thunder,OKC @ GSW,125,-11,Regular Season
22022,1610612746,LAC,LA Clippers,0022201196,2023-04-05T00:00:00Z,LAC vs. LAL,125,7,1610612747,LAL,Los Angeles Lakers,LAL @ LAC,118,-7,Regular Season
22022,1610612742,DAL,Dallas Mavericks,0022201195,2023-04-05T00:00:00Z,DAL vs. SAC,123,4,1610612758,SAC,Sacramento Kings,SAC @ DAL,119,-4,Regular Season
22022,1610612737,ATL,Atlanta Hawks,0022201191,2023-04-05T00:00:00Z,ATL vs. WAS,134,18,1610612764,WAS,Washington Wizards,WAS @ ATL,116,-18,Regular Season
22022,1610612749,MIL,Milwaukee Bucks,0022201193,2023-04-05T00:00:00Z,MIL vs. CHI,105,13,1610612741,CHI,Chicago Bulls,CHI @ MIL,92,-13,Regular Season
22022,1610612738,BOS,Boston Celtics,0022201192,2023-04-05T00:00:00Z,BOS vs. TOR,97,4,1610612761,TOR,Toronto Raptors,TOR @ BOS,93,-4,Regular Season
22022,1610612754,IND,Indiana Pacers,0022201190,2023-04-05T00:00:00Z,IND vs. NYK,129,-9,1610612752,NYK,New York Knicks,NYK @ IND,138,9,Regular Season
22022,1610612765,DET,Detroit Pistons,0022201189,2023-04-05T00:00:00Z,DET vs. BKN,108,-15,1610612751,BKN,Brooklyn Nets,BKN @ DET,123,15,Regular Season
22022,1610612740,NOP,New Orleans Pelicans,0022201194,2023-04-05T00:00:00Z,NOP vs. MEM,138,7,1610612763,MEM,Memphis Grizzlies,MEM @ NOP,131,-7,Regular Season
22022,1610612756,PHX,Phoenix Suns,0022201201,2023-04-06T00:00:00Z,PHX vs. DEN,119,4,1610612743,DEN,Denver Nuggets,DEN @ PHX,115,-4,Regular Season
22022,1610612753,ORL,Orlando Magic,0022201197,2023-04-06T00:00:00Z,ORL vs. CLE,94,-24,1610612739,CLE,Cleveland Cavaliers,CLE @ ORL,118,24,Regular Season
22022,1610612762,UTA,Utah Jazz,0022201200,2023-04-06T00:00:00Z,UTA vs. OKC,98,-16,1610612760,OKC,Oklahoma City Thunder,OKC @ UTA,114,16,Regular Season
22022,1610612759,SAS,San Antonio Spurs,0022201199,2023-04-06T00:00:00Z,SAS vs. POR,129,2,1610612757,POR,Portland Trail Blazers,POR @ SAS,127,-2,Regular Season
22022,1610612755,PHI,Philadelphia 76ers,0022201198,2023-04-06T00:00:00Z,PHI vs. MIA,101,-28,1610612748,MIA,Miami Heat,MIA @ PHI,129,28,Regular Season
22022,1610612738,BOS,Boston Celtics,0022201206,2023-04-07T00:00:00Z,BOS vs. TOR,121,19,1610612761,TOR,Toronto Raptors,TOR @ BOS,102,-19,Regular Season
22022,1610612747,LAL,Los Angeles Lakers,0022201212,2023-04-07T00:00:00Z,LAL vs. PHX,121,14,1610612756,PHX,Phoenix Suns,PHX @ LAL,107,-14,Regular Season
22022,1610612758,SAC,Sacramento Kings,0022201211,2023-04-07T00:00:00Z,SAC vs. GSW,97,-22,1610612744,GSW,Golden State Warriors,GSW @ SAC,119,22,Regular Season
22022,1610612742,DAL,Dallas Mavericks,0022201210,2023-04-07T00:00:00Z,DAL vs. CHI,112,-3,1610612741,CHI,Chicago Bulls,CHI @ DAL,115,3,Regular Season
22022,1610612740,NOP,New Orleans Pelicans,0022201209,2023-04-07T00:00:00Z,NOP vs. NYK,113,8,1610612752,NYK,New York Knicks,NYK @ NOP,105,-8,Regular Season
22022,1610612749,MIL,Milwaukee Bucks,0022201208,2023-04-07T00:00:00Z,MIL vs. MEM,114,-23,1610612763,MEM,Memphis Grizzlies,MEM @ MIL,137,23,Regular Season
22022,1610612737,ATL,Atlanta Hawks,0022201205,2023-04-07T00:00:00Z,ATL vs. PHI,131,-5,1610612755,PHI,Philadelphia 76ers,PHI @ ATL,136,5,Regular Season
22022,1610612751,BKN,Brooklyn Nets,0022201207,2023-04-07T00:00:00Z,BKN vs. ORL,101,17,1610612753,ORL,Orlando Magic,ORL @ BKN,84,-17,Regular Season
22022,1610612754,IND,Indiana Pacers,0022201203,2023-04-07T00:00:00Z,IND vs. DET,115,-7,1610612765,DET,Detroit Pistons,DET @ IND,122,7,Regular Season
22022,1610612764,WAS,Washington Wizards,0022201204,2023-04-07T00:00:00Z,WAS vs. MIA,114,6,1610612748,MIA,Miami Heat,MIA @ WAS,108,-6,Regular Season
22022,1610612766,CHA,Charlotte Hornets,0022201202,2023-04-07T00:00:00Z,CHA vs. HOU,109,-3,1610612745,HOU,Houston Rockets,HOU @ CHA,112,3,Regular Season
22022,1610612759,SAS,San Antonio Spurs,0022201214,2023-04-08T00:00:00Z,SAS vs. MIN,131,-20,1610612750,MIN,Minnesota Timberwolves,MIN @ SAS,151,20,Regular Season
22022,1610612746,LAC,LA Clippers,0022201215,2023-04-08T00:00:00Z,LAC vs. POR,136,11,1610612757,POR,Portland Trail Blazers,POR @ LAC,125,-11,Regular Season
22022,1610612762,UTA,Utah Jazz,0022201213,2023-04-08T00:00:00Z,UTA vs. DEN,118,4,1610612743,DEN,Denver Nuggets,DEN @ UTA,114,-4,Regular Season
22022,1610612750,MIN,Minnesota Timberwolves,0022201225,2023-04-09T00:00:00Z,MIN vs. NOP,113,5,1610612740,NOP,New Orleans Pelicans,NOP @ MIN,108,-5,Regular Season
22022,1610612756,PHX,Phoenix Suns,0022201229,2023-04-09T00:00:00Z,PHX vs. LAC,114,-5,1610612746,LAC,LA Clippers,LAC @ PHX,119,5,Regular Season
22022,1610612748,MIA,Miami Heat,0022201219,2023-04-09T00:00:00Z,MIA vs. ORL,123,13,1610612753,ORL,Orlando Magic,ORL @ MIA,110,-13,Regular Season
22022,1610612743,DEN,Denver Nuggets,0022201227,2023-04-09T00:00:00Z,DEN vs. SAC,109,14,1610612758,SAC,Sacramento Kings,SAC @ DEN,95,-14,Regular Season
22022,1610612738,BOS,Boston Celtics,0022201216,2023-04-09T00:00:00Z,BOS vs. ATL,120,6,1610612737,ATL,Atlanta Hawks,ATL @ BOS,114,-6,Regular Season
22022,1610612747,LAL,Los Angeles Lakers,0022201228,2023-04-09T00:00:00Z,LAL vs. UTA,128,11,1610612762,UTA,Utah Jazz,UTA @ LAL,117,-11,Regular Season
22022,1610612764,WAS,Washington Wizards,0022201222,2023-04-09T00:00:00Z,WAS vs. HOU,109,-5,1610612745,HOU,Houston Rockets,HOU @ WAS,114,5,Regular Season
22022,1610612757,POR,Portland Trail Blazers,0022201230,2023-04-09T00:00:00Z,POR vs. GSW,101,-56,1610612744,GSW,Golden State Warriors,GSW @ POR,157,56,Regular Season
22022,1610612760,OKC,Oklahoma City Thunder,0022201226,2023-04-09T00:00:00Z,OKC vs. MEM,115,15,1610612763,MEM,Memphis Grizzlies,MEM @ OKC,100,-15,Regular Season
22022,1610612742,DAL,Dallas Mavericks,0022201224,2023-04-09T00:00:00Z,DAL vs. SAS,117,-21,1610612759,SAS,San Antonio Spurs,SAS @ DAL,138,21,Regular Season
22022,1610612752,NYK,New York Knicks,0022201220,2023-04-09T00:00:00Z,NYK vs. IND,136,-5,1610612754,IND,Indiana Pacers,IND @ NYK,141,5,Regular Season
22022,1610612751,BKN,Brooklyn Nets,0022201217,2023-04-09T00:00:00Z,BKN vs. PHI,105,-29,1610612755,PHI,Philadelphia 76ers,PHI @ BKN,134,29,Regular Season
22022,1610612741,CHI,Chicago Bulls,0022201223,2023-04-09T00:00:00Z,CHI vs. DET,103,22,1610612765,DET,Detroit Pistons,DET @ CHI,81,-22,Regular Season
22022,1610612761,TOR,Toronto Raptors,0022201221,2023-04-09T00:00:00Z,TOR vs. MIL,121,16,1610612749,MIL,Milwaukee Bucks,MIL @ TOR,105,-16,Regular Season
22022,1610612739,CLE,Cleveland Cavaliers,0022201218,2023-04-09T00:00:00Z,CLE vs. CHA,95,-11,1610612766,CHA,Charlotte Hornets,CHA @ CLE,106,11,Regular Season
12022,1610612764,WAS,Washington Wizards,0012200001,2022-09-30T00:00:00Z,WAS vs. GSW,87,-9,1610612744,GSW,Golden State Warriors,GSW @ WAS,96,9,Pre Season
12022,1610612746,LAC,LA Clippers,0012200002,2022-09-30T00:00:00Z,LAC vs. MRA,121,40,50009,MRA,Ra'anana Maccabi Ra'anana,MRA @ LAC,81,-40,Pre Season
12022,1610612749,MIL,Milwaukee Bucks,0012200003,2022-10-01T00:00:00Z,MIL vs. MEM,102,-5,1610612763,MEM,Memphis Grizzlies,MEM @ MIL,107,5,Pre Season
12022,1610612756,PHX,Phoenix Suns,0012200008,2022-10-02T00:00:00Z,PHX vs. ADL,124,-10,15019,ADL,Adelaide 36ers,ADL @ PHX,134,10,Pre Season
12022,1610612745,HOU,Houston Rockets,0012200007,2022-10-02T00:00:00Z,HOU vs. SAS,134,38,1610612759,SAS,San Antonio Spurs,SAS @ HOU,96,-38,Pre Season
12022,1610612761,TOR,Toronto Raptors,0012200006,2022-10-02T00:00:00Z,TOR vs. UTA,114,32,1610612762,UTA,Utah Jazz,UTA @ TOR,82,-32,Pre Season
12022,1610612744,GSW,Golden State Warriors,0012200004,2022-10-02T00:00:00Z,GSW vs. WAS,104,9,1610612764,WAS,Washington Wizards,WAS @ GSW,95,-9,Pre Season
12022,1610612738,BOS,Boston Celtics,0012200005,2022-10-02T00:00:00Z,BOS vs. CHA,134,41,1610612766,CHA,Charlotte Hornets,CHA @ BOS,93,-41,Pre Season
12022,1610612751,BKN,Brooklyn Nets,0012200009,2022-10-03T00:00:00Z,BKN vs. PHI,108,-19,1610612755,PHI,Philadelphia 76ers,PHI @ BKN,127,19,Pre Season
12022,1610612747,LAL,Los Angeles Lakers,0012200012,2022-10-03T00:00:00Z,LAL vs. SAC,75,-30,1610612758,SAC,Sacramento Kings,SAC @ LAL,105,30,Pre Season
12022,1610612746,LAC,LA Clippers,0012200013,2022-10-03T00:00:00Z,LAC vs. POR,102,5,1610612757,POR,Portland Trail Blazers,POR @ LAC,97,-5,Pre Season
12022,1610612763,MEM,Memphis Grizzlies,0012200010,2022-10-03T00:00:00Z,MEM vs. ORL,109,12,1610612753,ORL,Orlando Magic,ORL @ MEM,97,-12,Pre Season
12022,1610612743,DEN,Denver Nuggets,0012200011,2022-10-03T00:00:00Z,DEN vs. OKC,101,-11,1610612760,OKC,Oklahoma City Thunder,OKC @ DEN,112,11,Pre Season
12022,1610612757,POR,Portland Trail Blazers,0012200017,2022-10-04T00:00:00Z,POR vs. UTA,101,-17,1610612762,UTA,Utah Jazz,UTA @ POR,118,17,Pre Season
12022,1610612752,NYK,New York Knicks,0012200014,2022-10-04T00:00:00Z,NYK vs. DET,117,21,1610612765,DET,Detroit Pistons,DET @ NYK,96,-21,Pre Season
12022,1610612748,MIA,Miami Heat,0012200015,2022-10-04T00:00:00Z,MIA vs. MIN,111,-10,1610612750,MIN,Minnesota Timberwolves,MIN @ MIA,121,10,Pre Season
12022,1610612741,CHI,Chicago Bulls,0012200016,2022-10-04T00:00:00Z,CHI vs. NOP,125,-4,1610612740,NOP,New Orleans Pelicans,NOP @ CHI,129,4,Pre Season
12022,1610612755,PHI,Philadelphia 76ers,0012200019,2022-10-05T00:00:00Z,PHI vs. CLE,113,1,1610612739,CLE,Cleveland Cavaliers,CLE @ PHI,112,-1,Pre Season
12022,1610612766,CHA,Charlotte Hornets,0012200018,2022-10-05T00:00:00Z,CHA vs. IND,97,-25,1610612754,IND,Indiana Pacers,IND @ CHA,122,25,Pre Season
12022,1610612738,BOS,Boston Celtics,0012200020,2022-10-05T00:00:00Z,BOS vs. TOR,119,-6,1610612761,TOR,Toronto Raptors,TOR @ BOS,125,6,Pre Season
12022,1610612760,OKC,Oklahoma City Thunder,0012200021,2022-10-05T00:00:00Z,OKC vs. DAL,96,-2,1610612742,DAL,Dallas Mavericks,DAL @ OKC,98,2,Pre Season
12022,1610612747,LAL,Los Angeles Lakers,0012200022,2022-10-05T00:00:00Z,LAL vs. PHX,115,-4,1610612756,PHX,Phoenix Suns,PHX @ LAL,119,4,Pre Season
12022,1610612757,POR,Portland Trail Blazers,0012200027,2022-10-06T00:00:00Z,POR vs. MRA,138,53,50009,MRA,Ra'anana Maccabi Ra'anana,MRA @ POR,85,-53,Pre Season
12022,1610612759,SAS,San Antonio Spurs,0012200026,2022-10-06T00:00:00Z,SAS vs. ORL,99,-3,1610612753,ORL,Orlando Magic,ORL @ SAS,102,3,Pre Season
12022,1610612747,LAL,Los Angeles Lakers,0012200028,2022-10-06T00:00:00Z,LAL vs. MIN,99,-15,1610612750,MIN,Minnesota Timberwolves,MIN @ LAL,114,15,Pre Season
12022,1610612760,OKC,Oklahoma City Thunder,0012200025,2022-10-06T00:00:00Z,OKC vs. ADL,131,33,15019,ADL,Adelaide 36ers,ADL @ OKC,98,-33,Pre Season
12022,1610612751,BKN,Brooklyn Nets,0012200024,2022-10-06T00:00:00Z,BKN vs. MIA,80,-29,1610612748,MIA,Miami Heat,MIA @ BKN,109,29,Pre Season
12022,1610612737,ATL,Atlanta Hawks,0012200023,2022-10-06T00:00:00Z,ATL vs. MIL,123,10,1610612749,MIL,Milwaukee Bucks,MIL @ ATL,113,-10,Pre Season
12022,1610612740,NOP,New Orleans Pelicans,0012200034,2022-10-07T00:00:00Z,NOP vs. DET,107,6,1610612765,DET,Detroit Pistons,DET @ NOP,101,-6,Pre Season
12022,1610612766,CHA,Charlotte Hornets,0012200029,2022-10-07T00:00:00Z,CHA vs. BOS,103,-9,1610612738,BOS,Boston Celtics,BOS @ CHA,112,9,Pre Season
12022,1610612741,CHI,Chicago Bulls,0012200031,2022-10-07T00:00:00Z,CHI vs. DEN,131,18,1610612743,DEN,Denver Nuggets,DEN @ CHI,113,-18,Pre Season
12022,1610612742,DAL,Dallas Mavericks,0012200035,2022-10-07T00:00:00Z,DAL vs. ORL,105,-5,1610612753,ORL,Orlando Magic,ORL @ DAL,110,5,Pre Season
12022,1610612763,MEM,Memphis Grizzlies,0012200033,2022-10-07T00:00:00Z,MEM vs. MIA,108,-3,1610612748,MIA,Miami Heat,MIA @ MEM,111,3,Pre Season
12022,1610612745,HOU,Houston Rockets,0012200032,2022-10-07T00:00:00Z,HOU vs. TOR,116,16,1610612761,TOR,Toronto Raptors,TOR @ HOU,100,-16,Pre Season
12022,1610612752,NYK,New York Knicks,0012200030,2022-10-07T00:00:00Z,NYK vs. IND,131,17,1610612754,IND,Indiana Pacers,IND @ NYK,114,-17,Pre Season
12022,1610612749,MIL,Milwaukee Bucks,0012200036,2022-10-08T00:00:00Z,MIL vs. ATL,109,-9,1610612737,ATL,Atlanta Hawks,ATL @ MIL,118,9,Pre Season
12022,1610612758,SAC,Sacramento Kings,0012200041,2022-10-09T00:00:00Z,SAC vs. POR,126,32,1610612757,POR,Portland Trail Blazers,POR @ SAC,94,-32,Pre Season
12022,1610612760,OKC,Oklahoma City Thunder,0012200038,2022-10-09T00:00:00Z,OKC vs. MRA,144,47,50009,MRA,Ra'anana Maccabi Ra'anana,MRA @ OKC,97,-47,Pre Season
12022,1610612759,SAS,San Antonio Spurs,0012200039,2022-10-09T00:00:00Z,SAS vs. NOP,97,-14,1610612740,NOP,New Orleans Pelicans,NOP @ SAS,111,14,Pre Season
12022,1610612744,GSW,Golden State Warriors,0012200040,2022-10-09T00:00:00Z,GSW vs. LAL,121,-3,1610612747,LAL,Los Angeles Lakers,LAL @ GSW,124,3,Pre Season
12022,1610612746,LAC,LA Clippers,0012200042,2022-10-09T00:00:00Z,LAC vs. MIN,117,-2,1610612750,MIN,Minnesota Timberwolves,MIN @ LAC,119,2,Pre Season
12022,1610612761,TOR,Toronto Raptors,0012200037,2022-10-09T00:00:00Z,TOR vs. CHI,98,-17,1610612741,CHI,Chicago Bulls,CHI @ TOR,115,17,Pre Season
12022,1610612766,CHA,Charlotte Hornets,0012200043,2022-10-10T00:00:00Z,CHA vs. WAS,107,-9,1610612764,WAS,Washington Wizards,WAS @ CHA,116,9,Pre Season
12022,1610612743,DEN,Denver Nuggets,0012200046,2022-10-10T00:00:00Z,DEN vs. PHX,107,2,1610612756,PHX,Phoenix Suns,PHX @ DEN,105,-2,Pre Season
12022,1610612748,MIA,Miami Heat,0012200045,2022-10-10T00:00:00Z,MIA vs. HOU,118,8,1610612745,HOU,Houston Rockets,HOU @ MIA,110,-8,Pre Season
12022,1610612739,CLE,Cleveland Cavaliers,0012200044,2022-10-10T00:00:00Z,CLE vs. PHI,97,-16,1610612755,PHI,Philadelphia 76ers,PHI @ CLE,113,16,Pre Season
12022,1610612765,DET,Detroit Pistons,0012200047,2022-10-11T00:00:00Z,DET vs. OKC,99,-16,1610612760,OKC,Oklahoma City Thunder,OKC @ DET,115,16,Pre Season
12022,1610612753,ORL,Orlando Magic,0012200048,2022-10-11T00:00:00Z,ORL vs. MEM,109,4,1610612763,MEM,Memphis Grizzlies,MEM @ ORL,105,-4,Pre Season
12022,1610612741,CHI,Chicago Bulls,0012200049,2022-10-11T00:00:00Z,CHI vs. MIL,127,23,1610612749,MIL,Milwaukee Bucks,MIL @ CHI,104,-23,Pre Season
12022,1610612762,UTA,Utah Jazz,0012200050,2022-10-11T00:00:00Z,UTA vs. SAS,104,-7,1610612759,SAS,San Antonio Spurs,SAS @ UTA,111,7,Pre Season
12022,1610612744,GSW,Golden State Warriors,0012200051,2022-10-11T00:00:00Z,GSW vs. POR,131,33,1610612757,POR,Portland Trail Blazers,POR @ GSW,98,-33,Pre Season
12022,1610612746,LAC,LA Clippers,0012200059,2022-10-12T00:00:00Z,LAC vs. DEN,115,-11,1610612743,DEN,Denver Nuggets,DEN @ LAC,126,11,Pre Season
12022,1610612747,LAL,Los Angeles Lakers,0012200057,2022-10-12T00:00:00Z,LAL vs. MIN,113,-5,1610612750,MIN,Minnesota Timberwolves,MIN @ LAL,118,5,Pre Season
12022,1610612756,PHX,Phoenix Suns,0012200058,2022-10-12T00:00:00Z,PHX vs. SAC,104,-1,1610612758,SAC,Sacramento Kings,SAC @ PHX,105,1,Pre Season
12022,1610612739,CLE,Cleveland Cavaliers,0012200052,2022-10-12T00:00:00Z,CLE vs. ATL,105,6,1610612737,ATL,Atlanta Hawks,ATL @ CLE,99,-6,Pre Season
12022,1610612749,MIL,Milwaukee Bucks,0012200056,2022-10-12T00:00:00Z,MIL vs. BKN,97,-10,1610612751,BKN,Brooklyn Nets,BKN @ MIL,107,10,Pre Season
12022,1610612748,MIA,Miami Heat,0012200055,2022-10-12T00:00:00Z,MIA vs. NOP,120,17,1610612740,NOP,New Orleans Pelicans,NOP @ MIA,103,-17,Pre Season
12022,1610612754,IND,Indiana Pacers,0012200053,2022-10-12T00:00:00Z,IND vs. NYK,109,9,1610612752,NYK,New York Knicks,NYK @ IND,100,-9,Pre Season
12022,1610612755,PHI,Philadelphia 76ers,0012200054,2022-10-12T00:00:00Z,PHI vs. CHA,99,5,1610612766,CHA,Charlotte Hornets,CHA @ PHI,94,-5,Pre Season
12022,1610612765,DET,Detroit Pistons,0012200060,2022-10-13T00:00:00Z,DET vs. MEM,111,-15,1610612763,MEM,Memphis Grizzlies,MEM @ DET,126,15,Pre Season
12022,1610612759,SAS,San Antonio Spurs,0012200061,2022-10-13T00:00:00Z,SAS vs. OKC,112,-6,1610612760,OKC,Oklahoma City Thunder,OKC @ SAS,118,6,Pre Season
12022,1610612758,SAC,Sacramento Kings,0012200070,2022-10-14T00:00:00Z,SAC vs. LAL,133,47,1610612747,LAL,Los Angeles Lakers,LAL @ SAC,86,-47,Pre Season
12022,1610612744,GSW,Golden State Warriors,0012200069,2022-10-14T00:00:00Z,GSW vs. DEN,112,-7,1610612743,DEN,Denver Nuggets,DEN @ GSW,119,7,Pre Season
12022,1610612740,NOP,New Orleans Pelicans,0012200067,2022-10-14T00:00:00Z,NOP vs. ATL,120,9,1610612737,ATL,Atlanta Hawks,ATL @ NOP,111,-9,Pre Season
12022,1610612762,UTA,Utah Jazz,0012200068,2022-10-14T00:00:00Z,UTA vs. DAL,101,-14,1610612742,DAL,Dallas Mavericks,DAL @ UTA,115,14,Pre Season
12022,1610612750,MIN,Minnesota Timberwolves,0012200066,2022-10-14T00:00:00Z,MIN vs. BKN,102,-10,1610612751,BKN,Brooklyn Nets,BKN @ MIN,112,10,Pre Season
12022,1610612761,TOR,Toronto Raptors,0012200064,2022-10-14T00:00:00Z,TOR vs. BOS,137,3,1610612738,BOS,Boston Celtics,BOS @ TOR,134,-3,Pre Season
12022,1610612754,IND,Indiana Pacers,0012200062,2022-10-14T00:00:00Z,IND vs. HOU,114,-8,1610612745,HOU,Houston Rockets,HOU @ IND,122,8,Pre Season
12022,1610612752,NYK,New York Knicks,0012200065,2022-10-14T00:00:00Z,NYK vs. WAS,105,16,1610612764,WAS,Washington Wizards,WAS @ NYK,89,-16,Pre Season
12022,1610612753,ORL,Orlando Magic,0012200063,2022-10-14T00:00:00Z,ORL vs. CLE,114,6,1610612739,CLE,Cleveland Cavaliers,CLE @ ORL,108,-6,Pre Season
42022,1610612758,SAC,Sacramento Kings,0042200161,2023-04-15T00:00:00Z,SAC vs. GSW,126,3,1610612744,GSW,Golden State Warriors,GSW @ SAC,123,-3,Playoffs
42022,1610612738,BOS,Boston Celtics,0042200111,2023-04-15T00:00:00Z,BOS vs. ATL,112,13,1610612737,ATL,Atlanta Hawks,ATL @ BOS,99,-13,Playoffs
42022,1610612739,CLE,Cleveland Cavaliers,0042200131,2023-04-15T00:00:00Z,CLE vs. NYK,97,-4,1610612752,NYK,New York Knicks,NYK @ CLE,101,4,Playoffs
42022,1610612755,PHI,Philadelphia 76ers,0042200121,2023-04-15T00:00:00Z,PHI vs. BKN,121,20,1610612751,BKN,Brooklyn Nets,BKN @ PHI,101,-20,Playoffs
42022,1610612749,MIL,Milwaukee Bucks,0042200101,2023-04-16T00:00:00Z,MIL vs. MIA,117,-13,1610612748,MIA,Miami Heat,MIA @ MIL,130,13,Playoffs
42022,1610612756,PHX,Phoenix Suns,0042200171,2023-04-16T00:00:00Z,PHX vs. LAC,110,-5,1610612746,LAC,LA Clippers,LAC @ PHX,115,5,Playoffs
42022,1610612763,MEM,Memphis Grizzlies,0042200151,2023-04-16T00:00:00Z,MEM vs. LAL,112,-16,1610612747,LAL,Los Angeles Lakers,LAL @ MEM,128,16,Playoffs
42022,1610612743,DEN,Denver Nuggets,0042200141,2023-04-16T00:00:00Z,DEN vs. MIN,109,29,1610612750,MIN,Minnesota Timberwolves,MIN @ DEN,80,-29,Playoffs
42022,1610612758,SAC,Sacramento Kings,0042200162,2023-04-17T00:00:00Z,SAC vs. GSW,114,8,1610612744,GSW,Golden State Warriors,GSW @ SAC,106,-8,Playoffs
42022,1610612755,PHI,Philadelphia 76ers,0042200122,2023-04-17T00:00:00Z,PHI vs. BKN,96,12,1610612751,BKN,Brooklyn Nets,BKN @ PHI,84,-12,Playoffs
42022,1610612739,CLE,Cleveland Cavaliers,0042200132,2023-04-18T00:00:00Z,CLE vs. NYK,107,17,1610612752,NYK,New York Knicks,NYK @ CLE,90,-17,Playoffs
42022,1610612738,BOS,Boston Celtics,0042200112,2023-04-18T00:00:00Z,BOS vs. ATL,119,13,1610612737,ATL,Atlanta Hawks,ATL @ BOS,106,-13,Playoffs
42022,1610612756,PHX,Phoenix Suns,0042200172,2023-04-18T00:00:00Z,PHX vs. LAC,123,14,1610612746,LAC,LA Clippers,LAC @ PHX,109,-14,Playoffs
42022,1610612743,DEN,Denver Nuggets,0042200142,2023-04-19T00:00:00Z,DEN vs. MIN,122,9,1610612750,MIN,Minnesota Timberwolves,MIN @ DEN,113,-9,Playoffs
42022,1610612749,MIL,Milwaukee Bucks,0042200102,2023-04-19T00:00:00Z,MIL vs. MIA,138,16,1610612748,MIA,Miami Heat,MIA @ MIL,122,-16,Playoffs
42022,1610612763,MEM,Memphis Grizzlies,0042200152,2023-04-19T00:00:00Z,MEM vs. LAL,103,10,1610612747,LAL,Los Angeles Lakers,LAL @ MEM,93,-10,Playoffs
42022,1610612751,BKN,Brooklyn Nets,0042200123,2023-04-20T00:00:00Z,BKN vs. PHI,97,-5,1610612755,PHI,Philadelphia 76ers,PHI @ BKN,102,5,Playoffs
42022,1610612744,GSW,Golden State Warriors,0042200163,2023-04-20T00:00:00Z,GSW vs. SAC,114,17,1610612758,SAC,Sacramento Kings,SAC @ GSW,97,-17,Playoffs
42022,1610612746,LAC,LA Clippers,0042200173,2023-04-20T00:00:00Z,LAC vs. PHX,124,-5,1610612756,PHX,Phoenix Suns,PHX @ LAC,129,5,Playoffs
42022,1610612737,ATL,Atlanta Hawks,0042200113,2023-04-21T00:00:00Z,ATL vs. BOS,130,8,1610612738,BOS,Boston Celtics,BOS @ ATL,122,-8,Playoffs
42022,1610612750,MIN,Minnesota Timberwolves,0042200143,2023-04-21T00:00:00Z,MIN vs. DEN,111,-9,1610612743,DEN,Denver Nuggets,DEN @ MIN,120,9,Playoffs
42022,1610612752,NYK,New York Knicks,0042200133,2023-04-21T00:00:00Z,NYK vs. CLE,99,20,1610612739,CLE,Cleveland Cavaliers,CLE @ NYK,79,-20,Playoffs
42022,1610612746,LAC,LA Clippers,0042200174,2023-04-22T00:00:00Z,LAC vs. PHX,100,-12,1610612756,PHX,Phoenix Suns,PHX @ LAC,112,12,Playoffs
42022,1610612747,LAL,Los Angeles Lakers,0042200153,2023-04-22T00:00:00Z,LAL vs. MEM,111,10,1610612763,MEM,Memphis Grizzlies,MEM @ LAL,101,-10,Playoffs
42022,1610612748,MIA,Miami Heat,0042200103,2023-04-22T00:00:00Z,MIA vs. MIL,121,22,1610612749,MIL,Milwaukee Bucks,MIL @ MIA,99,-22,Playoffs
42022,1610612751,BKN,Brooklyn Nets,0042200124,2023-04-22T00:00:00Z,BKN vs. PHI,88,-8,1610612755,PHI,Philadelphia 76ers,PHI @ BKN,96,8,Playoffs
42022,1610612752,NYK,New York Knicks,0042200134,2023-04-23T00:00:00Z,NYK vs. CLE,102,9,1610612739,CLE,Cleveland Cavaliers,CLE @ NYK,93,-9,Playoffs
42022,1610612737,ATL,Atlanta Hawks,0042200114,2023-04-23T00:00:00Z,ATL vs. BOS,121,-8,1610612738,BOS,Boston Celtics,BOS @ ATL,129,8,Playoffs
42022,1610612750,MIN,Minnesota Timberwolves,0042200144,2023-04-23T00:00:00Z,MIN vs. DEN,114,6,1610612743,DEN,Denver Nuggets,DEN @ MIN,108,-6,Playoffs
42022,1610612744,GSW,Golden State Warriors,0042200164,2023-04-23T00:00:00Z,GSW vs. SAC,126,1,1610612758,SAC,Sacramento Kings,SAC @ GSW,125,-1,Playoffs
42022,1610612748,MIA,Miami Heat,0042200104,2023-04-24T00:00:00Z,MIA vs. MIL,119,5,1610612749,MIL,Milwaukee Bucks,MIL @ MIA,114,-5,Playoffs
42022,1610612747,LAL,Los Angeles Lakers,0042200154,2023-04-24T00:00:00Z,LAL vs. MEM,117,6,1610612763,MEM,Memphis Grizzlies,MEM @ LAL,111,-6,Playoffs
42022,1610612743,DEN,Denver Nuggets,0042200145,2023-04-25T00:00:00Z,DEN vs. MIN,112,3,1610612750,MIN,Minnesota Timberwolves,MIN @ DEN,109,-3,Playoffs
42022,1610612756,PHX,Phoenix Suns,0042200175,2023-04-25T00:00:00Z,PHX vs. LAC,136,6,1610612746,LAC,LA Clippers,LAC @ PHX,130,-6,Playoffs
42022,1610612738,BOS,Boston Celtics,0042200115,2023-04-25T00:00:00Z,BOS vs. ATL,117,-2,1610612737,ATL,Atlanta Hawks,ATL @ BOS,119,2,Playoffs
42022,1610612758,SAC,Sacramento Kings,0042200165,2023-04-26T00:00:00Z,SAC vs. GSW,116,-7,1610612744,GSW,Golden State Warriors,GSW @ SAC,123,7,Playoffs
42022,1610612749,MIL,Milwaukee Bucks,0042200105,2023-04-26T00:00:00Z,MIL vs. MIA,126,-2,1610612748,MIA,Miami Heat,MIA @ MIL,128,2,Playoffs
42022,1610612763,MEM,Memphis Grizzlies,0042200155,2023-04-26T00:00:00Z,MEM vs. LAL,116,17,1610612747,LAL,Los Angeles Lakers,LAL @ MEM,99,-17,Playoffs
42022,1610612739,CLE,Cleveland Cavaliers,0042200135,2023-04-26T00:00:00Z,CLE vs. NYK,95,-11,1610612752,NYK,New York Knicks,NYK @ CLE,106,11,Playoffs
42022,1610612737,ATL,Atlanta Hawks,0042200116,2023-04-27T00:00:00Z,ATL vs. BOS,120,-8,1610612738,BOS,Boston Celtics,BOS @ ATL,128,8,Playoffs
42022,1610612744,GSW,Golden State Warriors,0042200166,2023-04-28T00:00:00Z,GSW vs. SAC,99,-19,1610612758,SAC,Sacramento Kings,SAC @ GSW,118,19,Playoffs
42022,1610612747,LAL,Los Angeles Lakers,0042200156,2023-04-28T00:00:00Z,LAL vs. MEM,125,40,1610612763,MEM,Memphis Grizzlies,MEM @ LAL,85,-40,Playoffs
42022,1610612743,DEN,Denver Nuggets,0042200221,2023-04-29T00:00:00Z,DEN vs. PHX,125,18,1610612756,PHX,Phoenix Suns,PHX @ DEN,107,-18,Playoffs
42022,1610612752,NYK,New York Knicks,0042200201,2023-04-30T00:00:00Z,NYK vs. MIA,101,-7,1610612748,MIA,Miami Heat,MIA @ NYK,108,7,Playoffs
42022,1610612758,SAC,Sacramento Kings,0042200167,2023-04-30T00:00:00Z,SAC vs. GSW,100,-20,1610612744,GSW,Golden State Warriors,GSW @ SAC,120,20,Playoffs
42022,1610612738,BOS,Boston Celtics,0042200211,2023-05-01T00:00:00Z,BOS vs. PHI,115,-4,1610612755,PHI,Philadelphia 76ers,PHI @ BOS,119,4,Playoffs
42022,1610612743,DEN,Denver Nuggets,0042200222,2023-05-01T00:00:00Z,DEN vs. PHX,97,10,1610612756,PHX,Phoenix Suns,PHX @ DEN,87,-10,Playoffs
42022,1610612744,GSW,Golden State Warriors,0042200231,2023-05-02T00:00:00Z,GSW vs. LAL,112,-5,1610612747,LAL,Los Angeles Lakers,LAL @ GSW,117,5,Playoffs
42022,1610612752,NYK,New York Knicks,0042200202,2023-05-02T00:00:00Z,NYK vs. MIA,111,6,1610612748,MIA,Miami Heat,MIA @ NYK,105,-6,Playoffs
42022,1610612738,BOS,Boston Celtics,0042200212,2023-05-03T00:00:00Z,BOS vs. PHI,121,34,1610612755,PHI,Philadelphia 76ers,PHI @ BOS,87,-34,Playoffs
42022,1610612744,GSW,Golden State Warriors,0042200232,2023-05-04T00:00:00Z,GSW vs. LAL,127,27,1610612747,LAL,Los Angeles Lakers,LAL @ GSW,100,-27,Playoffs
42022,1610612756,PHX,Phoenix Suns,0042200223,2023-05-05T00:00:00Z,PHX vs. DEN,121,7,1610612743,DEN,Denver Nuggets,DEN @ PHX,114,-7,Playoffs
42022,1610612755,PHI,Philadelphia 76ers,0042200213,2023-05-05T00:00:00Z,PHI vs. BOS,102,-12,1610612738,BOS,Boston Celtics,BOS @ PHI,114,12,Playoffs
42022,1610612747,LAL,Los Angeles Lakers,0042200233,2023-05-06T00:00:00Z,LAL vs. GSW,127,30,1610612744,GSW,Golden State Warriors,GSW @ LAL,97,-30,Playoffs
42022,1610612748,MIA,Miami Heat,0042200203,2023-05-06T00:00:00Z,MIA vs. NYK,105,19,1610612752,NYK,New York Knicks,NYK @ MIA,86,-19,Playoffs
42022,1610612755,PHI,Philadelphia 76ers,0042200214,2023-05-07T00:00:00Z,PHI vs. BOS,116,1,1610612738,BOS,Boston Celtics,BOS @ PHI,115,-1,Playoffs
42022,1610612756,PHX,Phoenix Suns,0042200224,2023-05-07T00:00:00Z,PHX vs. DEN,129,5,1610612743,DEN,Denver Nuggets,DEN @ PHX,124,-5,Playoffs
42022,1610612747,LAL,Los Angeles Lakers,0042200234,2023-05-08T00:00:00Z,LAL vs. GSW,104,3,1610612744,GSW,Golden State Warriors,GSW @ LAL,101,-3,Playoffs
42022,1610612748,MIA,Miami Heat,0042200204,2023-05-08T00:00:00Z,MIA vs. NYK,109,8,1610612752,NYK,New York Knicks,NYK @ MIA,101,-8,Playoffs
42022,1610612738,BOS,Boston Celtics,0042200215,2023-05-09T00:00:00Z,BOS vs. PHI,103,-12,1610612755,PHI,Philadelphia 76ers,PHI @ BOS,115,12,Playoffs
42022,1610612743,DEN,Denver Nuggets,0042200225,2023-05-09T00:00:00Z,DEN vs. PHX,118,16,1610612756,PHX,Phoenix Suns,PHX @ DEN,102,-16,Playoffs
42022,1610612752,NYK,New York Knicks,0042200205,2023-05-10T00:00:00Z,NYK vs. MIA,112,9,1610612748,MIA,Miami Heat,MIA @ NYK,103,-9,Playoffs
42022,1610612744,GSW,Golden State Warriors,0042200235,2023-05-10T00:00:00Z,GSW vs. LAL,121,15,1610612747,LAL,Los Angeles Lakers,LAL @ GSW,106,-15,Playoffs
42022,1610612755,PHI,Philadelphia 76ers,0042200216,2023-05-11T00:00:00Z,PHI vs. BOS,86,-9,1610612738,BOS,Boston Celtics,BOS @ PHI,95,9,Playoffs
42022,1610612756,PHX,Phoenix Suns,0042200226,2023-05-11T00:00:00Z,PHX vs. DEN,100,-25,1610612743,DEN,Denver Nuggets,DEN @ PHX,125,25,Playoffs
42022,1610612747,LAL,Los Angeles Lakers,0042200236,2023-05-12T00:00:00Z,LAL vs. GSW,122,21,1610612744,GSW,Golden State Warriors,GSW @ LAL,101,-21,Playoffs
42022,1610612748,MIA,Miami Heat,0042200206,2023-05-12T00:00:00Z,MIA vs. NYK,96,4,1610612752,NYK,New York Knicks,NYK @ MIA,92,-4,Playoffs
42022,1610612738,BOS,Boston Celtics,0042200217,2023-05-14T00:00:00Z,BOS vs. PHI,112,24,1610612755,PHI,Philadelphia 76ers,PHI @ BOS,88,-24,Playoffs
42022,1610612743,DEN,Denver Nuggets,0042200311,2023-05-16T00:00:00Z,DEN vs. LAL,132,6,1610612747,LAL,Los Angeles Lakers,LAL @ DEN,126,-6,Playoffs
42022,1610612738,BOS,Boston Celtics,0042200301,2023-05-17T00:00:00Z,BOS vs. MIA,116,-7,1610612748,MIA,Miami Heat,MIA @ BOS,123,7,Playoffs
42022,1610612743,DEN,Denver Nuggets,0042200312,2023-05-18T00:00:00Z,DEN vs. LAL,108,5,1610612747,LAL,Los Angeles Lakers,LAL @ DEN,103,-5,Playoffs
42022,1610612738,BOS,Boston Celtics,0042200302,2023-05-19T00:00:00Z,BOS vs. MIA,105,-6,1610612748,MIA,Miami Heat,MIA @ BOS,111,6,Playoffs
42022,1610612747,LAL,Los Angeles Lakers,0042200313,2023-05-20T00:00:00Z,LAL vs. DEN,108,-11,1610612743,DEN,Denver Nuggets,DEN @ LAL,119,11,Playoffs
42022,1610612748,MIA,Miami Heat,0042200303,2023-05-21T00:00:00Z,MIA vs. BOS,128,26,1610612738,BOS,Boston Celtics,BOS @ MIA,102,-26,Playoffs
42022,1610612747,LAL,Los Angeles Lakers,0042200314,2023-05-22T00:00:00Z,LAL vs. DEN,111,-2,1610612743,DEN,Denver Nuggets,DEN @ LAL,113,2,Playoffs
42022,1610612748,MIA,Miami Heat,0042200304,2023-05-23T00:00:00Z,MIA vs. BOS,99,-17,1610612738,BOS,Boston Celtics,BOS @ MIA,116,17,Playoffs
42022,1610612738,BOS,Boston Celtics,0042200305,2023-05-25T00:00:00Z,BOS vs. MIA,110,13,1610612748,MIA,Miami Heat,MIA @ BOS,97,-13,Playoffs
42022,1610612748,MIA,Miami Heat,0042200306,2023-05-27T00:00:00Z,MIA vs. BOS,103,-1,1610612738,BOS,Boston Celtics,BOS @ MIA,104,1,Playoffs
42022,1610612738,BOS,Boston Celtics,0042200307,2023-05-29T00:00:00Z,BOS vs. MIA,84,-19,1610612748,MIA,Miami Heat,MIA @ BOS,103,19,Playoffs
42022,1610612743,DEN,Denver Nuggets,0042200401,2023-06-01T00:00:00Z,DEN vs. MIA,104,11,1610612748,MIA,Miami Heat,MIA @ DEN,93,-11,Playoffs
42022,1610612743,DEN,Denver Nuggets,0042200402,2023-06-04T00:00:00Z,DEN vs. MIA,108,-3,1610612748,MIA,Miami Heat,MIA @ DEN,111,3,Playoffs
42022,1610612748,MIA,Miami Heat,0042200403,2023-06-07T00:00:00Z,MIA vs. DEN,94,-15,1610612743,DEN,Denver Nuggets,DEN @ MIA,109,15,Playoffs
42022,1610612748,MIA,Miami Heat,0042200404,2023-06-09T00:00:00Z,MIA vs. DEN,95,-13,1610612743,DEN,Denver Nuggets,DEN @ MIA,108,13,Playoffs
42022,1610612743,DEN,Denver Nuggets,0042200405,2023-06-12T00:00:00Z,DEN vs. MIA,94,5,1610612748,MIA,Miami Heat,MIA @ DEN,89,-5,Playoffs
32022,1610616834,LBN,Team LeBron,0032200001,2023-02-19T00:00:00Z,LBN vs. GNS,175,-9,1610616833,GNS,Team Giannis,GNS @ LBN,184,9,All-Star
32022,1610616834,LBN,Team LeBron,0032200001,2023-02-19T00:00:00Z,LBN vs. GNS,175,-9,1610616833,GNS,Team Giannis,GNS @ LBN,184,9,All Star
